File,WordCount,NumPara,AvgParaSize,Nouns,Verbs,Adjectives,Adverbs,Total
1000245_TheJodimars.txt,822,13,63,371,84,36,18,509
1001027_ListOfPostalCodesInAustria.txt,630,10,63,205,18,23,3,249
1001476_Tercio.txt,657,10,65,226,79,56,27,388
1002122_UssArcherfishss311.txt,2045,32,63,848,222,115,37,1222
1002126_HighCrimesAndMisdemeanours.txt,587,11,53,205,73,39,11,328
1002128_GiantMagnetoresistiveEffect.txt,701,22,31,278,68,89,23,458
1002502_FreedomTowerSilverDollar.txt,977,17,57,418,121,56,30,625
1002560_RockyMountainArsenal.txt,889,14,63,347,119,44,22,532
1003230_RichardPatrick.txt,649,10,64,200,101,52,26,379
1003234_BattleOfImphal.txt,2498,43,58,862,367,219,86,1534
100340_Millipede.txt,722,17,42,249,104,66,46,465
100345_Venevisin.txt,796,19,41,284,97,87,17,485
100347_VctorRalHayaDeLaTorre.txt,652,17,38,237,87,45,20,389
100350_TheWildTheInnocentTheEStreetShuffle.txt,1364,28,48,546,189,109,51,895
100355_ListOfChinesePeople.txt,1658,41,40,1317,24,86,27,1454
1003663_AmonGCarter.txt,666,13,51,285,67,49,12,413
100374_BalanceSheet.txt,1019,28,36,403,120,73,40,636
100381_SammoHung.txt,1865,29,64,811,176,91,51,1129
100383_MadridBarajasInternationalAirport.txt,1400,19,73,853,91,81,20,1045
100384_WillemalexanderPrinceOfOrange.txt,883,24,36,380,85,65,14,544
100385_TsuiHark.txt,2409,37,65,1207,168,172,62,1609
100390_OpusDei.txt,3718,63,59,1433,523,281,134,2371
100393_MortificationOfTheFlesh.txt,4709,83,56,1477,686,379,180,2722
100394_EthelMerman.txt,1890,27,70,805,229,81,45,1160
1004311_SolomonKane.txt,985,20,49,454,102,65,36,657
1004325_HorstPHorst.txt,969,23,42,371,121,53,30,575
1005294_Kentrosaurus.txt,599,12,49,201,80,45,28,354
1005302_Chasmosaurus.txt,635,12,52,198,105,52,35,390
1005304_NigerUraniumForgeries.txt,4131,59,70,1572,641,237,129,2579
1005314_Hypsilophodon.txt,685,15,45,206,112,70,41,429
1005384_MartinFeldstein.txt,622,8,77,266,65,46,13,390
1005415_LieutenantKijprokofiev.txt,725,24,30,289,92,48,27,456
1005416_LearningStyles.txt,1223,18,67,557,171,92,33,853
1005769_PeterSchilling.txt,569,7,81,319,36,20,6,381
1006385_Sirensfilm.txt,541,5,108,212,53,28,15,308
1006396_ChristianPeacemakerTeams.txt,1571,30,52,626,222,86,34,968
1006487_AlbanianPartyOfLabour.txt,656,10,65,307,59,59,15,440
100735_ListOfRussians.txt,4989,44,113,3449,80,255,33,3817
1007499_ClintDempsey.txt,1068,15,71,415,142,47,30,634
1007642_ThebesTablets.txt,659,8,82,275,71,45,21,412
1007645_NativeTitle.txt,1872,57,32,748,235,156,41,1180
100791_JervisBayTerritory.txt,745,24,31,332,83,52,16,483
100796_GuinnessWorldRecords.txt,1547,25,61,558,244,129,60,991
100801_ClaytonAlabama.txt,652,10,65,271,58,20,6,355
1008028_Sudo.txt,564,11,51,223,86,29,15,353
1008031_Chemistryband.txt,716,25,28,330,32,32,1,395
1009187_ListOfPeopleByNameShfshz.txt,807,9,89,565,5,62,4,636
1009736_12thManfootball.txt,1652,29,56,625,227,92,66,1010
1009832_Sandmnnchen.txt,683,21,32,306,80,42,27,455
1010216_Retu.txt,589,14,42,170,90,62,29,351
1010217_LuisTiant.txt,1170,17,68,424,125,72,22,643
1010815_RadeonR420.txt,1767,23,76,644,258,164,79,1145
1010829_HaradaSanosuke.txt,616,16,38,228,85,32,21,366
1010831_BestBakeryCase.txt,800,10,80,295,140,29,16,480
1010850_LomanaLualua.txt,577,14,41,210,77,22,18,327
1010923_Geneon.txt,651,6,108,442,29,22,3,496
1010930_KennethMckellar.txt,641,8,80,232,85,41,23,381
1010933_KoratalaSatyanarayana.txt,1026,13,78,368,142,43,30,583
1011302_Passingjuggling.txt,1097,9,121,320,186,102,57,665
1011307_VSAchuthanandan.txt,880,13,67,333,111,61,23,528
1011379_MultilevelSecurity.txt,2269,24,94,857,358,169,104,1488
1011899_PresidentTheodoreRooseveltHighSchool.txt,843,19,44,478,69,52,19,618
1011900_GoOfBalhae.txt,704,15,46,278,93,43,12,426
1011941_Semicolony.txt,725,19,38,259,69,94,28,450
1012020_JamieCarragher.txt,1645,31,53,578,210,121,42,951
1012403_DavidGilmouralbum.txt,935,17,55,391,87,51,36,565
1013002_UndergraduateMedicineAndHealthSciencesAdmissionTest.txt,830,33,25,337,97,57,29,520
1013014_WilliamHuntingtonRussell.txt,644,9,71,227,91,42,16,376
1013558_VandaMissJoaquim.txt,1196,16,74,436,206,80,42,764
1014079_ThomasWatsonbishop.txt,3241,41,79,1126,533,152,114,1925
1014087_CenturyRadio.txt,665,13,51,232,102,42,30,406
1014110_StAloysiusCollege.txt,1000,21,47,468,93,48,9,618
1014113_PaulMerson.txt,1130,16,70,420,155,67,34,676
101448_Mars3.txt,1009,22,45,387,126,69,19,601
101460_CannesFilmFestival.txt,890,21,42,433,76,52,16,577
101483_StreamOfConsciousness.txt,679,8,84,309,74,44,19,446
1015269_BristolHarbour.txt,1734,30,57,738,239,97,43,1117
1015276_ShoeSize.txt,1375,44,31,488,175,111,54,828
1016371_Starquakegame.txt,719,41,17,289,84,24,21,418
1016379_NoobSaibot.txt,3396,44,77,1221,524,205,134,2084
1016706_GoDaddy.txt,1103,17,64,474,144,64,37,719
1016766_ThrsaTallien.txt,608,9,67,212,74,35,19,340
1017349_ElSalvadorNationalFootballTeam.txt,814,27,30,373,70,46,17,506
1017426_YunafinalFantasy.txt,2107,23,91,729,300,111,87,1227
1017436_SenegalNationalFootballTeam.txt,684,15,45,331,60,32,27,450
1017743_TennantCreekNorthernTerritory.txt,720,12,60,297,95,39,19,450
101825_EarnedRunAverage.txt,1056,10,105,321,156,86,49,612
101827_JoschkaFischer.txt,1718,28,61,648,216,114,49,1027
101830_AccretionDisc.txt,1001,20,50,334,136,113,34,617
1018445_SecondBattleOfKharkov.txt,4217,42,100,1415,569,405,163,2552
101882_Pluna.txt,593,24,24,246,60,26,14,346
101883_AbdAlmalik.txt,795,10,79,255,121,35,28,439
101893_Thurrock.txt,977,23,42,436,111,66,20,633
1019536_Norrkping.txt,750,19,39,272,100,70,20,462
1019617_PanEuropeanGameInformation.txt,527,15,35,241,61,31,22,355
1019618_MizenHead.txt,1417,6,236,980,27,26,9,1042
1019627_HowardTOdum.txt,734,9,81,321,61,40,17,439
1019647_GimmeGimmeGimme.txt,645,17,37,351,52,33,17,453
1021141_AyaMatsuura.txt,829,23,36,368,82,48,18,516
1021817_ListOfCancerClusters.txt,761,2,380,458,14,18,2,492
1022904_CharlesBridgeman.txt,681,7,97,302,72,43,12,429
1023911_Dosaaf.txt,464,11,42,171,43,37,8,259
1023955_AngelsEgg.txt,2048,46,44,654,300,164,83,1201
1023979_ElmerBatters.txt,625,12,52,220,93,50,28,391
1024055_MichaelIanBlack.txt,887,11,80,343,109,52,26,530
1024425_JoeShea.txt,1066,15,71,465,115,57,14,651
1024493_RotherhamRufc.txt,577,10,57,212,80,39,18,349
1025059_JabiruAircraft.txt,546,20,27,217,63,52,16,348
102505_ProteinDataBank.txt,1079,25,43,499,126,82,32,739
102513_VanessaLWilliams.txt,2097,37,56,1061,169,90,39,1359
1025150_Sawfilm.txt,2566,31,82,854,460,104,88,1506
102518_InducteesOfTheRockAndRollHallOfFame.txt,1575,36,43,766,158,24,25,973
102519_Dolomite.txt,1042,16,65,350,137,143,47,677
102538_DanRather.txt,5163,70,73,1858,782,305,245,3190
102539_MeikoScientific.txt,633,10,63,258,94,65,9,426
102554_Lauenburgdistrict.txt,946,26,36,325,91,81,33,530
102556_HyoJinMoon.txt,1115,17,65,415,146,81,35,677
102562_MormonTabernacleChoir.txt,682,14,48,287,82,42,11,422
102567_JohnForbesNash.txt,1675,30,55,663,205,102,55,1025
102605_RampMeter.txt,1556,25,62,582,257,110,60,1009
102607_MinneapolisstPaul.txt,5823,75,77,2249,706,502,220,3677
1026248_IslamiaCollegepeshawar.txt,920,14,65,393,103,43,24,563
1027263_TheRehearsalplay.txt,586,5,117,190,79,58,33,360
1027771_Cheetos.txt,1252,39,32,552,172,75,42,841
1027773_AldermastonCourt.txt,600,15,40,229,78,31,12,350
1028356_ZinaGarrison.txt,806,21,38,348,81,45,10,484
1028437_2mceFmBathurst.txt,1000,19,52,384,123,72,33,612
1028797_SteveTrevor.txt,1232,14,88,444,176,83,59,762
1028862_SevenSoldiersOfVictory.txt,2828,41,68,1149,379,156,97,1781
102908_SystemCall.txt,1102,21,52,388,181,89,41,699
102920_Ritual.txt,1055,31,34,419,117,118,42,696
1029403_Ikpeople.txt,778,15,51,258,126,51,34,469
1029409_NicolaeBlcescu.txt,1134,17,66,476,116,65,22,679
1029423_Megastructure.txt,750,23,32,310,99,50,31,490
1029446_ConscriptionInTheUnitedStates.txt,4427,53,83,1553,637,316,158,2664
1029456_MargaretOliphantOliphant.txt,764,10,76,269,86,35,27,417
1029527_YeShengtao.txt,3265,45,72,1345,371,209,90,2015
1029529_SarkisZeitlian.txt,608,9,67,252,76,34,11,373
102964_ScoutingInFlorida.txt,1310,49,26,775,118,58,20,971
102967_ScoutingInKansas.txt,704,46,15,428,59,29,7,523
102973_ChevyChase.txt,2857,27,105,1180,344,164,88,1776
1030497_PirateRadioInNorthAmerica.txt,2367,28,84,892,309,188,102,1491
1030541_ListOfJapanesePowCampsDuringWorldWarIi.txt,624,27,23,466,8,10,2,486
1030617_GyulaHorn.txt,686,14,49,216,98,44,23,381
1030995_VehicleExtrication.txt,1152,16,72,409,160,97,52,718
1031055_ManitobaGeneralElection1969.txt,1165,133,8,841,31,26,7,905
1031588_FleshBloodfilm.txt,1033,15,68,344,175,55,54,628
1031602_StphanieDeBeauharnais.txt,982,13,75,343,125,63,28,559
1031607_Squidgygate.txt,6720,130,51,2211,1088,405,284,3988
1031612_FillmoreEastJune1971.txt,553,11,50,264,56,24,11,355
1031662_HedKandi.txt,1927,29,66,836,184,122,63,1205
1031666_HighwayOfDeath.txt,1172,25,46,384,179,68,46,677
1032766_LittleRoundTop.txt,2655,32,82,1057,368,152,85,1662
1033237_KamiyaKaoru.txt,1047,13,80,327,157,70,67,621
1033243_MyjinYahiko.txt,1140,12,95,386,163,68,60,677
1033846_AlanGilbert.txt,939,19,49,345,100,65,28,538
1033852_HitlersPoliticalBeliefs.txt,1344,24,56,496,192,111,42,841
1034339_MostRecentCommonAncestor.txt,1519,27,56,504,189,155,81,929
1034858_VasileAlecsandri.txt,1043,19,54,404,119,68,24,615
1036054_PsychoRealm.txt,816,10,81,331,111,38,26,506
1036067_PeterLalor.txt,591,15,39,194,87,27,28,336
1036508_TheSystemOfNature.txt,789,5,157,227,112,85,58,482
1036579_WhitStillman.txt,805,13,61,311,99,47,24,481
1036581_MediaLabEurope.txt,933,12,77,364,123,75,30,592
103695_MasterRace.txt,1269,18,70,445,181,119,40,785
1037034_ShaneLeslie.txt,873,17,51,350,111,48,27,536
103705_ScoutingInMaryland.txt,648,42,15,377,61,22,8,468
1037120_TheHandThatRocksTheCradlefilm.txt,1271,19,66,506,216,56,34,812
1037122_PortugalInTheGreatWar.txt,1063,8,132,431,120,65,22,638
1037124_CrownhillFort.txt,931,19,49,335,141,65,25,566
1037138_PeterVermes.txt,777,22,35,310,81,39,17,447
1037139_KingdaKa.txt,2520,24,105,836,347,192,128,1503
1037148_ToeLoopJump.txt,818,20,40,297,103,42,49,491
1037161_GonzagaCollegeHighSchool.txt,2106,13,162,911,239,131,63,1344
1038224_MarinaMniszech.txt,734,10,73,279,94,33,22,428
1038242_LithiaFlorida.txt,1564,17,92,646,218,83,53,1000
1039311_AHeroOfOurTime.txt,1078,14,77,299,159,82,54,594
1039379_Kurnool.txt,1137,22,51,644,78,51,16,789
1039392_Offroading.txt,2247,42,53,850,320,211,73,1454
1039406_Arranmore.txt,614,11,55,213,72,50,27,362
1039667_AdministrativeDivisionsOfRussiaIn17271728.txt,512,3,170,213,54,15,8,290
1039669_HolographicMemory.txt,841,12,70,294,121,78,19,512
1040368_BoukmanEksperyans.txt,686,9,76,240,95,60,17,412
1040371_PitchforkMedia.txt,2657,52,51,1159,266,186,93,1704
1040374_BabbittMetal.txt,742,12,61,235,131,67,32,465
1040387_DatabaseDesign.txt,746,17,43,222,123,54,42,441
104066_Rhinovirus.txt,636,18,35,239,82,58,23,402
1041843_SteveMills.txt,685,12,57,264,92,41,16,413
1041853_ArmyOfTheCumberland.txt,609,8,76,251,72,15,18,356
1042563_BodMainAirStation.txt,606,11,55,234,79,44,16,373
1042564_HmcsChicoutimissk879.txt,1182,18,65,389,185,93,27,694
1043012_Uveitis.txt,584,14,41,247,66,58,22,393
1043016_JanHenrykDbrowski.txt,1077,12,89,339,153,90,31,613
1043650_FinancialSystem.txt,1413,31,45,526,211,109,41,887
1043760_1986AmericanLeagueChampionshipSeries.txt,1172,31,37,455,149,72,26,702
1044108_ScecgsRedlands.txt,923,21,43,395,95,74,22,586
1044750_Brettanomyces.txt,736,11,66,241,126,77,41,485
1044754_DogCommunication.txt,1699,36,47,538,288,147,98,1071
1044856_ShotgunShell.txt,1647,17,96,508,267,151,94,1020
1045819_Sa58.txt,691,10,69,287,73,94,20,474
1045845_BreastFetishism.txt,666,27,24,315,69,77,31,492
1045854_TheCambridgeDeclaration.txt,2294,24,95,835,302,127,95,1359
1046291_HampdensydneyCollege.txt,3124,34,91,1631,231,172,34,2068
1046919_DenzilKobbekaduwa.txt,1183,18,65,393,221,59,42,715
1046939_ThomasWeelkes.txt,897,15,59,308,142,49,31,530
1046943_VijayaWimalaratne.txt,858,13,66,302,141,44,16,503
1046949_IndianaInstituteOfTechnology.txt,591,19,31,327,51,29,7,414
104743_CarlXviGustafOfSweden.txt,1418,27,52,595,162,71,44,872
104765_BessemerAlabama.txt,1620,33,49,671,200,95,28,994
104777_FairfieldAlabama.txt,644,16,40,216,86,43,15,360
104786_HooverAlabama.txt,1129,23,49,438,131,65,23,657
104794_LipscombAlabama.txt,601,12,50,180,86,45,21,332
1048027_EricForman.txt,2241,19,117,728,378,114,106,1326
104803_MountainBrookAlabama.txt,695,14,49,278,77,44,7,406
1048084_Sunwise.txt,607,7,86,173,101,40,27,341
1048090_BoeingBirdOfPrey.txt,652,14,46,251,79,60,34,424
1048095_Orthokeratology.txt,754,16,47,310,95,67,30,502
1049195_TheArizonaRepublic.txt,780,22,35,311,89,60,31,491
1049644_MohammedDahlan.txt,858,17,50,323,131,43,30,527
1050664_RecesstvSeries.txt,875,17,51,318,149,57,34,558
1050727_ListOfKashmiris.txt,1622,22,73,1212,50,58,11,1331
1051472_FrancoBash.txt,804,14,57,267,135,57,36,495
1051684_Citynews.txt,913,17,53,458,84,66,28,636
105200_Cancerconstellation.txt,1008,27,37,381,117,65,27,590
105201_AkutanAlaska.txt,1464,25,58,608,171,111,21,911
105202_ColdBayAlaska.txt,924,22,42,340,112,56,18,526
105213_UnalaskaAlaska.txt,822,18,45,283,96,54,16,449
1054043_ToeiAsakusaLine.txt,648,19,34,288,65,43,18,414
1054045_CristinaScabbia.txt,570,8,71,209,88,38,18,353
1054714_IntrospectionRundown.txt,706,19,37,253,108,35,29,425
1054716_ChrisBangle.txt,708,11,64,286,98,51,21,456
1054721_PrestonSchoolOfIndustry.txt,599,7,85,268,77,33,14,392
1054723_ChristyHemme.txt,1260,21,60,561,149,39,19,768
1054800_TanithLee.txt,691,8,86,320,29,19,5,373
1054817_SuwonSamsungBluewings.txt,936,43,21,599,38,47,6,690
1055001_ContrarotatingPropellers.txt,836,13,64,309,110,99,28,546
1055075_IndianaJonesAdventure.txt,3140,52,60,1186,415,194,102,1897
10553_Flute.txt,3230,43,75,1184,424,318,144,2070
1055855_HeartshapedBox.txt,1839,41,44,725,216,159,48,1148
1055880_CheatCommandos.txt,983,21,46,369,135,69,51,624
1056847_Qashqai.txt,688,15,45,276,78,57,31,442
10568_Footballsoccer.txt,4788,65,73,1656,676,387,154,2873
10571_Film.txt,4115,64,64,1533,579,369,188,2669
10576_FrancisFordCoppola.txt,2055,28,73,856,259,112,66,1293
105832_JamesTyrrell.txt,786,14,56,255,137,34,27,453
1058398_UssTigroness419.txt,2080,27,77,769,291,104,50,1214
105841_NigelTranter.txt,1155,27,42,550,100,56,19,725
105846_ListOfCatalans.txt,623,4,155,360,12,55,3,430
105856_ThreeMileIslandAccident.txt,4122,49,84,1487,635,295,140,2557
105862_AnneMurray.txt,4060,41,99,1890,319,192,90,2491
105865_ClassConflict.txt,925,17,54,341,98,83,31,553
105868_InternationalMobileSubscriberIdentity.txt,1237,36,34,473,173,74,54,774
105872_Clueless.txt,2058,29,70,758,281,153,76,1268
105883_JulieBrown.txt,966,18,53,411,112,58,28,609
105891_SamuelPHuntington.txt,1830,23,79,721,192,152,61,1126
1059018_Azerothworld.txt,2126,20,106,897,213,135,77,1322
1059407_PlantTissueCulture.txt,1253,19,65,451,186,119,71,827
1060227_Mineriad.txt,1248,26,48,453,194,70,27,744
1060236_SimplicialHomology.txt,806,15,53,259,113,77,31,480
1060572_Trnveni.txt,933,21,44,352,109,82,14,557
1060628_Superresolution.txt,550,12,45,269,49,38,16,372
1060630_RoverSd1.txt,1604,23,69,575,211,125,80,991
1061157_DualcodingTheory.txt,906,11,82,342,122,77,34,575
1061167_VerseDramaAndDramaticVerse.txt,581,13,44,207,75,65,30,377
106238_Cognition.txt,1712,32,53,641,216,174,69,1100
1062410_BrooksAlberta.txt,767,14,54,283,102,63,16,464
1062803_TheFortyDaysOfMusaDagh.txt,2621,29,90,945,354,182,78,1559
106289_EtTheExtraterrestrialatari2600.txt,2639,29,91,842,431,211,129,1613
106291_Ultracentrifuge.txt,768,10,76,281,104,83,16,484
1063370_PiecesOfMe.txt,2016,27,74,713,201,155,54,1123
1063371_JosephMassino.txt,598,16,37,249,84,32,12,377
1063385_NotablePhrasesFromTheHitchhikersGuideToTheGalaxy.txt,813,17,47,299,100,46,38,483
1063521_OxygenSensor.txt,2108,27,78,731,295,186,78,1290
1063524_OpenUniversityMalaysia.txt,1074,23,46,518,117,67,20,722
1063761_JonathanClements.txt,580,11,52,277,49,30,9,365
1063762_EugenDhring.txt,788,13,60,300,85,62,19,466
1064506_UssGambledd123.txt,1192,17,70,499,137,63,18,717
1064519_Soyuzmultfilm.txt,716,21,34,284,63,49,20,416
1064790_PhoneLosersOfAmerica.txt,1870,37,50,658,301,115,70,1144
1064972_ListOfStateLeadersIn1503.txt,1094,6,182,608,0,53,0,661
1064975_ListOfStateLeadersIn1502.txt,1079,8,134,600,0,55,0,655
1064977_ListOfStateLeadersIn1501.txt,1116,6,186,620,0,56,0,676
1064979_ListOfStateLeadersIn1500.txt,723,6,120,428,1,18,0,447
1065732_MontgomeryCanal.txt,686,12,57,207,110,53,23,393
1065733_GuanDao.txt,1080,9,120,358,163,117,48,686
1065748_FridayNightLightsfilm.txt,4187,36,116,1441,597,265,197,2500
1066136_BertConvy.txt,714,13,54,266,100,34,24,424
1067746_StillNotGettingAny.txt,1139,19,59,401,114,133,45,693
1067891_AHardDaysNightsong.txt,2963,42,70,1029,394,210,96,1729
1067911_CentreCollege.txt,2113,39,54,991,237,109,57,1394
1067915_EscapeFromAtlantis.txt,1369,33,41,471,198,96,55,820
1068310_RingOfHonor.txt,1928,27,71,744,290,117,54,1205
1068849_LeimertParkLosAngelesCalifornia.txt,613,13,47,280,69,41,11,401
106925_JonesboroArkansas.txt,1124,28,40,461,121,61,13,656
106928_AlmaArkansas.txt,1028,22,46,351,139,62,24,576
1069328_GoodNewsWeek.txt,1846,27,68,654,279,106,76,1115
106936_VanBurenArkansas.txt,1096,20,54,446,117,69,18,650
106968_ConwayArkansas.txt,895,19,47,355,91,61,10,517
1070063_Unitalbum.txt,629,12,52,271,75,46,18,410
1070081_AstrosatelliteTv.txt,2217,55,40,1091,200,132,43,1466
1070084_JeanDieudonn.txt,651,14,46,212,77,70,22,381
1070086_HermitageCastle.txt,886,24,36,345,109,34,24,512
1070476_GrammarChecker.txt,967,18,53,359,136,96,37,628
1070488_RoyWilkins.txt,694,19,36,334,64,30,6,434
1071029_GlenbrookNewSouthWales.txt,712,9,79,304,76,49,23,452
1071050_31stUnitedStatesCongress.txt,2818,25,112,1715,169,45,22,1951
1071139_MightyJack.txt,571,15,38,206,58,53,29,346
1071219_ShallWeDance2004Film.txt,646,11,58,254,85,30,33,402
1071235_Chrismukkah.txt,858,14,61,321,121,64,26,532
1072105_Warmachine.txt,1577,28,56,604,224,129,73,1030
1072273_Bathurst1000.txt,1623,20,81,591,208,114,44,957
107316_SearcyArkansas.txt,772,17,45,304,81,48,10,443
1073403_No14SquadronRaf.txt,621,6,103,256,90,20,12,378
1073414_GreatMorava.txt,1271,26,48,493,161,85,65,804
1073676_AnitaDesai.txt,610,14,43,307,45,26,6,384
107373_MokelumneHillCalifornia.txt,759,14,54,232,108,51,16,407
107375_MurphysCalifornia.txt,912,18,50,312,110,62,29,513
107377_SanAndreasCalifornia.txt,608,10,60,195,83,28,14,320
1074447_Burberry.txt,772,15,51,325,103,46,24,498
1074448_BeijingDialect.txt,1043,22,47,394,145,105,55,699
1074464_WellTest.txt,750,19,39,251,117,51,37,456
1074750_ListOfCatholicConverts.txt,2150,12,179,1282,101,267,19,1669
1075399_FreemasonryAndTheLatterDaySaintMovement.txt,1402,19,73,556,178,69,39,842
1075401_MysticTowers.txt,2250,40,56,790,338,142,78,1348
1075422_IntelligenceInTheAmericanRevolutionaryWar.txt,6732,81,83,2391,1006,412,182,3991
1075586_BaronsDiBaccari.txt,1047,15,69,459,116,37,30,642
1075974_EasternUniversity.txt,1540,49,31,730,186,74,45,1035
1076639_JanWong.txt,710,12,59,310,73,43,17,443
1076642_36Crazyfists.txt,603,17,35,279,68,23,9,379
1076662_WirelessSensorNetwork.txt,1994,32,62,929,235,165,62,1391
1077580_Apostrophe.txt,543,10,54,284,60,36,16,396
1078144_3rdCanadianParliament.txt,721,21,34,291,126,18,6,441
1078149_KayleeFrye.txt,592,11,53,185,97,36,33,351
1078791_BlackAthena.txt,1215,26,46,608,82,74,18,782
1078828_Dextropropoxyphene.txt,835,23,36,266,141,91,40,538
1079103_RealGoneTour.txt,909,27,33,671,43,21,19,754
1079111_Atlantic252.txt,1314,11,119,636,141,65,40,882
1079944_Peacekeeperfarscape.txt,2197,37,59,751,351,190,98,1390
1079951_AdaEverleigh.txt,670,18,37,217,113,34,25,389
108005_MorongoValleyCalifornia.txt,626,14,44,219,75,36,13,343
108009_NeedlesCalifornia.txt,919,24,38,333,110,60,23,526
108010_OntarioCalifornia.txt,1886,27,69,729,227,125,43,1124
108013_RialtoCalifornia.txt,2051,38,53,761,288,106,44,1199
108014_RunningSpringsCalifornia.txt,710,14,50,252,93,36,12,393
108016_SanBernardinoCalifornia.txt,6156,72,85,2901,628,381,127,4037
1080188_PoliceRiot.txt,585,12,48,244,81,40,17,382
108018_MarineCorpsAirGroundCombatCenterTwentyninePalms.txt,941,19,49,359,118,59,14,550
108027_BostoniaCalifornia.txt,589,10,58,198,72,28,12,310
1080319_AirportNovel.txt,871,13,67,351,120,70,43,584
108032_ChulaVistaCalifornia.txt,1906,26,73,763,234,107,37,1141
108033_CoronadoCalifornia.txt,849,19,44,326,94,57,18,495
108036_ElCajonCalifornia.txt,559,18,31,253,50,25,3,331
108042_HarbisonCanyonCalifornia.txt,962,14,68,358,114,53,13,538
108044_ImperialBeachCalifornia.txt,871,15,58,321,101,64,14,500
108045_JamulCalifornia.txt,677,11,61,209,88,40,7,344
108046_JulianCalifornia.txt,1088,23,47,377,144,86,37,644
108052_NationalCityCalifornia.txt,782,20,39,331,74,41,9,455
108055_PowayCalifornia.txt,3628,50,72,1290,501,238,144,2173
108058_RanchoSantaFeCalifornia.txt,1726,25,69,751,169,131,30,1081
108064_ValleyCenterCalifornia.txt,795,14,56,332,92,55,19,498
1080945_TerryMatthews.txt,1036,19,54,422,138,66,21,647
1081281_ClifEvans.txt,574,9,63,207,82,42,19,350
1081402_Freebox.txt,571,11,51,217,65,45,11,338
1081473_CombeDown.txt,1414,26,54,544,186,107,37,874
1081474_Compute.txt,606,11,55,284,68,31,13,396
1082156_RodneyRude.txt,870,17,51,350,121,51,16,538
1082312_AvalanchePress.txt,644,30,21,353,28,30,7,418
1082559_PanafricanParliament.txt,603,10,60,240,51,43,15,349
1083113_The69Eyes.txt,768,18,42,315,75,57,17,464
1083196_LulufinalFantasyX.txt,799,6,133,284,110,47,31,472
1083588_CyprusBroadcastingCorporation.txt,1820,38,47,729,185,165,45,1124
108404_LafayetteColorado.txt,1117,20,55,408,136,63,22,629
108405_LongmontColorado.txt,860,18,47,324,97,53,12,486
108419_GeorgetownColorado.txt,980,14,70,354,100,54,11,519
1084332_AndyBellmusician.txt,1289,19,67,491,182,85,45,803
1084335_ManitobaGeneralElection1966.txt,1118,136,8,839,19,18,3,879
108470_RedCliffColorado.txt,637,12,53,209,74,42,8,333
108471_VailColorado.txt,805,22,36,298,102,48,16,464
1085284_AjayDevgan.txt,842,31,27,491,33,9,11,544
1085285_EmainMacha.txt,840,12,70,320,107,76,23,526
1085364_TheSmokeRing.txt,767,12,63,264,108,54,26,452
1085370_JulioFranco.txt,1788,25,71,675,210,121,45,1051
1085373_VirginiaAbernethy.txt,749,11,68,280,105,50,15,450
1085382_MarcusGiles.txt,669,11,60,234,87,39,22,382
1085704_LightMyFire.txt,686,14,49,258,88,56,26,428
1085764_BeaconHillBostonMassachusetts.txt,1512,31,48,827,101,80,33,1041
1086503_RonanPoint.txt,1077,22,48,351,178,83,30,642
1086719_SmsSeydlitz.txt,651,10,65,226,84,39,32,381
1086725_MordantsNeed.txt,626,14,44,223,83,47,26,379
1086918_EmailFraud.txt,854,14,61,257,139,77,38,511
1087449_BraulioAlonsoHighSchool.txt,857,17,50,444,86,34,13,577
1087457_Nidoran.txt,578,11,52,236,59,67,10,372
1087465_GeorgeSteele.txt,721,12,60,292,102,43,25,462
1087644_MissionZamora.txt,681,8,85,258,89,56,13,416
1088597_OrganisingModel.txt,2909,37,78,1046,383,224,115,1768
1089076_RosarioMarin.txt,791,16,49,350,72,40,15,477
1089079_MillerIndex.txt,859,22,39,281,105,79,34,499
1089648_HarryGant.txt,601,13,46,266,60,37,10,373
1089817_KnightBanneret.txt,579,6,96,175,82,44,19,320
1090228_PeteMccloskey.txt,771,18,42,330,78,27,11,446
1090860_StourbridgeLion.txt,903,17,53,298,146,51,31,526
109088_WiltonManorsFlorida.txt,826,17,48,319,98,49,13,479
109117_GreenCoveSpringsFlorida.txt,664,15,44,232,83,25,9,349
1091190_MuhammadAldurrah.txt,3250,35,92,1219,501,147,109,1976
109120_OrangeParkFlorida.txt,675,15,45,238,87,30,8,363
109131_MarcoIslandFlorida.txt,729,17,42,274,79,44,9,406
109132_NaplesFlorida.txt,961,25,38,416,90,54,11,571
109142_LakeCityFlorida.txt,703,15,46,258,84,38,5,385
109149_BaldwinFlorida.txt,583,13,44,194,73,30,5,302
1091845_2004OfcNationsCup.txt,513,61,8,276,28,30,5,339
1092405_SegaSuperstars.txt,800,9,88,302,100,50,20,472
1092407_BarenakedForTheHolidays.txt,658,10,65,333,59,43,17,452
1093037_CentenaryCollegeOfLouisiana.txt,1325,25,53,616,147,92,31,886
1093045_PardotKynes.txt,595,7,85,194,106,31,16,347
1093059_BorisIiOfBulgaria.txt,711,8,88,273,109,30,21,433
1093073_Xiphosura.txt,575,28,20,285,55,49,12,401
1093428_GovernmentOfMaryland.txt,3647,71,51,1510,380,261,82,2233
1093429_RadioNewyorkInternational.txt,2565,23,111,1014,352,120,91,1577
1094021_BunnieRabbot.txt,2718,34,79,883,419,212,125,1639
1094034_CharlesSinger.txt,680,10,68,262,70,35,10,377
1094392_HuiShi.txt,755,23,32,254,117,51,32,454
1095208_TripGeneration.txt,912,21,43,363,152,73,21,609
1095219_333421998Wt24.txt,827,8,103,240,125,78,46,489
1095237_CharlesDavenant.txt,2430,62,39,890,311,121,58,1380
1095538_ElizabethInchbald.txt,850,15,56,386,65,52,20,523
109561_UnionParkFlorida.txt,656,22,29,272,54,33,7,366
109564_WindermereFlorida.txt,1079,19,56,396,124,72,30,622
109565_WinterGardenFlorida.txt,714,13,54,258,84,44,13,399
109574_BelleGladeFlorida.txt,807,15,53,348,71,42,14,475
10958_Fossil.txt,3035,46,65,1001,463,322,148,1934
1096167_ReportOnBusinessTelevision.txt,564,12,47,305,49,32,12,398
1096220_47thRegimentOfFoot.txt,1584,25,63,527,192,101,42,862
1096354_TripDistribution.txt,2874,62,46,1107,380,181,85,1753
1096387_FutureOfFormulaOne.txt,3136,45,69,1066,483,219,117,1885
1096564_CpaAustralia.txt,713,19,37,315,81,54,15,465
10965_FayWray.txt,1097,16,68,501,86,57,21,665
1096747_WilliamPoole.txt,1426,21,67,699,121,42,18,880
10969_FieldprogrammableGateArray.txt,2206,35,63,860,286,249,72,1467
1097333_HighFive.txt,592,14,42,181,79,58,26,344
1097370_JuliusBRichmond.txt,1333,11,121,559,159,89,20,827
1097438_CommunicationMoonRelay.txt,810,11,73,348,113,49,22,532
1097916_ManlyNewSouthWales.txt,595,14,42,265,60,57,25,407
1098538_Sukiyakisong.txt,1157,13,89,640,94,73,20,827
1098542_SevenSeas.txt,705,14,50,296,70,42,22,430
1098933_PovertyPoint.txt,590,7,84,241,66,42,24,373
1099502_WolfInTheFold.txt,1479,24,61,539,228,89,47,903
1099515_SquallLeonhart.txt,2070,18,115,775,276,119,86,1256
1100734_AbsoluteIdealism.txt,2084,29,71,702,276,188,99,1265
1101672_HoldenKingswood.txt,1038,11,94,394,147,81,34,656
1101673_StreetFootball.txt,3304,97,34,1036,509,211,171,1927
1101681_HabonimDror.txt,2269,45,50,1034,219,148,56,1457
110212_DublinGeorgia.txt,937,21,44,349,97,66,20,532
110221_FortStewart.txt,2650,42,63,971,377,182,71,1601
110224_MidwayGeorgia.txt,933,18,51,333,109,57,18,517
11022_FrancisHopkinson.txt,590,11,53,217,64,35,4,320
110238_MontezumaGeorgia.txt,1550,25,62,605,203,96,28,932
11023_Honoriusemperor.txt,1293,33,39,464,184,71,43,762
11024_Formant.txt,579,10,57,178,82,59,34,353
11025_February20.txt,2023,6,337,1120,72,82,4,1278
1102756_UniversalVReimerdes.txt,751,10,75,269,104,49,28,450
11028_FilmStock.txt,2719,29,93,970,391,255,133,1749
1102900_Notostraca.txt,807,17,47,285,105,70,52,512
1103213_FinchAvenue.txt,1012,23,44,547,78,47,22,694
1103864_FerdinandRies.txt,611,11,55,240,54,41,16,351
1103866_HistoryOfChicago.txt,2236,37,60,857,290,170,56,1373
1103868_RoslindaleBostonMassachusetts.txt,603,11,54,258,66,40,14,378
1103959_SonyaBlade.txt,2614,35,74,982,388,134,79,1583
1104070_ClaudeFarrre.txt,597,6,99,301,44,48,6,399
1104363_ChicagoAndNorthWesternRailway.txt,1208,19,63,524,140,58,29,751
1105120_The5678s.txt,606,11,55,232,58,42,24,356
1105123_SuperFx.txt,595,11,54,254,83,42,17,396
1105129_OrionstarTrek.txt,621,18,34,231,96,56,19,402
1105391_CheadleukParliamentConstituency.txt,649,28,23,256,61,34,11,362
110577_LhainHawaii.txt,821,17,48,286,89,49,17,441
1106074_SereneHighness.txt,611,16,38,267,67,49,21,404
1106087_KarakDistrict.txt,310,5,62,140,33,15,5,193
1106093_ChewValleyLake.txt,2752,43,64,1089,378,220,76,1763
1106230_GeorgesDanths.txt,723,10,72,242,105,53,23,423
1106233_BrianCurtin.txt,554,9,61,183,104,37,13,337
110642_RirieIdaho.txt,669,13,51,241,76,46,8,371
1106477_Lumbee.txt,5425,46,117,2523,523,331,130,3507
110655_NampaIdaho.txt,1572,39,40,625,208,101,29,963
110663_BurleyIdaho.txt,590,16,36,246,57,26,2,331
1107194_TheOutlaws.txt,700,11,63,291,76,58,31,456
1107288_SongOfSolomonnovel.txt,950,14,67,325,143,52,35,555
1107293_NewberryCollege.txt,622,18,34,278,61,32,11,382
1107299_TokenBucket.txt,588,13,45,205,107,47,16,375
1107307_GlossaryOfCanadianFootball.txt,848,2,424,269,110,90,36,505
1107313_WagnerCollege.txt,691,15,46,362,67,37,12,478
1107500_StratfordStMary.txt,1234,23,53,470,132,81,30,713
1108830_Nihonjinron.txt,2357,23,102,1004,163,247,74,1488
1108837_BeraCountOfBarcelona.txt,1128,26,43,419,168,44,23,654
1109481_CastletonGreaterManchester.txt,734,13,56,283,94,51,28,456
1109483_MarioPowerTennis.txt,1264,25,50,534,154,74,29,791
1109484_Telemachy.txt,1584,25,63,484,255,74,69,882
1109490_AssociatedBoardOfTheRoyalSchoolsOfMusic.txt,1074,13,82,373,157,78,27,635
1109862_ChieftainTank.txt,1085,21,51,424,154,79,24,681
1110432_JavonWalker.txt,784,13,60,273,130,35,26,464
1110452_FoxChasePhiladelphiaPennsylvania.txt,697,12,58,293,91,45,19,448
1110822_TurnerAustralianCapitalTerritory.txt,1016,14,72,387,137,93,42,659
1111646_DanielBrodhead.txt,803,14,57,322,110,46,16,494
1111654_WighamRichardson.txt,1266,24,52,453,178,61,21,713
1112590_TerryFrancona.txt,815,13,62,335,77,38,13,463
111283_CambridgeIllinois.txt,1363,26,52,555,160,90,34,839
111291_KewaneeIllinois.txt,764,28,27,300,82,53,17,452
1113125_Cognac.txt,698,25,27,282,94,52,17,445
111338_MountVernonIllinois.txt,1600,30,53,577,208,86,39,910
111339_NasonIllinois.txt,585,13,45,192,85,27,9,313
111340_WaltonvilleIllinois.txt,796,17,46,281,103,38,17,439
111342_BrightonIllinois.txt,623,14,44,197,75,40,17,329
1113496_SudAviationVautour.txt,712,15,47,266,88,69,13,436
1113503_Spectrumband.txt,1375,23,59,496,186,130,56,868
111350_EastDubuqueIllinois.txt,639,14,45,209,86,39,9,343
111352_GalenaIllinois.txt,1059,22,48,404,135,63,23,625
111366_AlgonquinIllinois.txt,1824,25,72,846,171,145,30,1192
111368_CarpentersvilleIllinois.txt,798,20,39,299,97,41,12,449
111369_ElburnIllinois.txt,591,14,42,189,76,28,16,309
111373_HuntleyIllinois.txt,4405,46,95,2002,422,316,107,2847
111382_WestDundeeIllinois.txt,741,13,57,245,100,33,10,388
1114702_OodgerooNoonuccal.txt,611,10,61,236,64,32,5,337
1114732_Palestine.txt,7357,108,68,2819,864,501,232,4416
1114737_PhiSigmaKappa.txt,3729,46,81,2182,259,176,51,2668
1114743_CaveCreekDisaster.txt,993,16,62,343,159,56,30,588
1115299_SafetyTestingOfExplosives.txt,873,11,79,250,168,90,22,530
1115483_282.txt,1367,30,45,472,182,113,50,817
1115859_ListOfArmenianKings.txt,1023,18,56,598,12,60,5,675
1115867_284.txt,1022,21,48,368,131,89,27,615
1115874_RoyalCollegeOfNursing.txt,731,23,31,312,101,32,11,456
1116817_ThisTimeAround.txt,607,8,75,286,57,38,26,407
1116822_CenterForInternationalForestryResearch.txt,688,24,28,289,59,62,8,418
1116826_KeeneStateCollege.txt,819,17,48,417,77,49,19,562
1116847_Cknwam.txt,1023,19,53,456,128,50,25,659
111737_JacksonvilleIllinois.txt,813,19,42,332,82,45,17,476
111742_WaverlyIllinois.txt,689,13,53,207,100,42,14,363
1117473_HigherSelf.txt,1062,9,118,334,150,122,42,648
1117_GeographyOfAustralia.txt,1408,35,40,621,128,159,37,945
1118039_Jaisalmer.txt,1792,38,47,741,215,123,36,1115
1118041_DentalImplant.txt,1831,34,53,641,288,183,54,1166
1118047_PalermoBuenosAires.txt,815,20,40,355,76,74,24,529
1118060_Kc85.txt,927,12,77,308,120,79,46,553
1118623_CultureOfSarajevo.txt,776,12,64,298,89,76,32,495
1118689_Reichsfhrerss.txt,540,16,33,178,73,45,12,308
1118988_MegaMancharacter.txt,3520,39,90,1400,510,265,88,2263
1119645_JohnRobinsonPierce.txt,562,13,43,240,67,35,11,353
1120207_LawEnforcementInAustralia.txt,643,17,37,305,67,64,16,452
1120226_JapaneseWarCrimes.txt,7447,103,72,2659,972,724,229,4584
1120233_PercynevilleFeud.txt,1014,16,63,343,163,65,43,614
1121167_Barn.txt,685,9,76,250,66,58,26,400
1121168_AndronicNikolsky.txt,831,13,63,302,114,30,15,461
1121188_PalilulaBelgrade.txt,1482,30,49,608,154,82,50,894
1121205_IndianGeneralElections2004regionalScenarios.txt,1462,41,35,628,197,87,32,944
1122396_1968UnitedStatesGrandPrix.txt,983,15,65,354,133,66,44,597
1123160_GreggVGeorgia.txt,4226,61,69,1482,635,271,167,2555
1123369_DeclineOfTheRomanEmpire.txt,4224,51,82,1415,518,394,180,2507
1123371_1999EuropeanGrandPrix.txt,876,9,97,263,151,55,41,510
1123444_2002MalaysianGrandPrix.txt,1093,22,49,416,143,81,25,665
112416_HighlandLakeCountyIndiana.txt,1064,26,40,390,127,72,20,609
112421_LowellIndiana.txt,590,15,39,233,68,27,6,334
112422_MerrillvilleIndiana.txt,1040,22,47,400,129,63,15,607
112423_MunsterIndiana.txt,1046,23,45,434,118,62,18,632
112433_LaPorteIndiana.txt,728,14,52,316,72,52,6,446
112436_MichiganCityIndiana.txt,1163,27,43,497,120,91,17,725
112441_BedfordIndiana.txt,857,25,34,334,110,53,9,506
112444_AndersonIndiana.txt,1606,25,64,672,195,84,26,977
112457_BeechGroveIndiana.txt,2932,54,54,1282,308,199,43,1832
112465_SouthportIndiana.txt,1821,37,49,646,109,110,15,880
1126794_ApolloApplicationsProgram.txt,908,16,56,341,150,54,25,570
1126798_GoodbyeMrChips1939Film.txt,751,10,75,273,107,33,29,442
1127372_VitriaSc.txt,603,21,28,262,72,48,14,396
1127442_MohammedBurhanuddin.txt,1154,38,30,517,129,58,20,724
1128603_DanielDeniehy.txt,793,13,61,278,111,59,15,463
112882_Videotex.txt,2200,31,70,714,315,223,115,1367
1128865_BulelaniNgcuka.txt,1134,15,75,458,135,64,30,687
112889_OsceolaIowa.txt,577,14,41,187,81,29,6,303
1128955_TayeDiggs.txt,678,10,67,345,51,32,12,440
1129902_BradyBonds.txt,876,13,67,350,120,68,23,561
1129919_Metallicity.txt,1487,20,74,473,209,142,88,912
1129_August13.txt,1699,6,283,959,65,61,7,1092
1130769_TheMessengerTheStoryOfJoanOfArc.txt,2263,22,102,700,374,146,93,1313
1130770_KamenRiderRyuki.txt,2100,35,60,1124,143,69,31,1367
1132268_LondonUndergroundStandardStock.txt,670,17,39,229,118,42,18,407
1132285_TheBestOfBothWorldsvanHalenAlbum.txt,681,7,97,499,12,15,7,533
1133223_ListOfWordsCensoredBySearchEnginesInMainlandChina.txt,960,23,41,493,104,74,42,713
1133265_YouthGroup.txt,632,13,48,297,54,41,13,405
1134310_AugustusGregory.txt,775,11,70,274,103,35,16,428
1134311_Semarang.txt,956,14,68,460,75,56,12,603
1134455_JoanGuzman.txt,791,18,43,290,102,40,21,453
1134480_HelgiHundingsbane.txt,1016,17,59,349,142,74,31,596
113496_SpaceWeather.txt,704,9,78,306,75,59,22,462
113510_TalkingAnimal.txt,1373,29,47,475,195,129,42,841
113515_Blackscholes.txt,2837,133,21,1084,332,245,81,1742
113516_FischerBlack.txt,842,27,31,344,88,50,25,507
113519_ShortSelling.txt,3172,46,68,967,510,280,146,1903
113522_FreeTerritoryOfTrieste.txt,939,23,40,346,108,52,29,535
113527_Wangsurname.txt,861,15,57,456,62,75,23,616
113530_Fen.txt,938,14,67,334,136,80,38,588
113536_Gawain.txt,1381,13,106,543,162,94,57,856
113537_WimborneMinster.txt,896,20,44,397,97,60,23,577
113540_BishamAbbey.txt,575,10,57,220,84,31,14,349
113543_OwenTudor.txt,744,14,53,348,88,24,12,472
1136626_HerthaBscBerlin.txt,1301,23,56,466,149,99,42,756
1137222_JimKarygiannis.txt,682,14,48,267,82,39,16,404
1137609_RoyalMalaysianAirForce.txt,1015,23,44,520,84,54,18,676
1137616_Ama002NeueZiel.txt,565,8,70,289,53,44,11,397
1137695_1997FormulaOneSeason.txt,1728,25,69,673,252,143,36,1104
1137700_1995FormulaOneSeason.txt,804,15,53,290,123,53,22,488
1137702_1994FormulaOneSeason.txt,1809,18,100,658,264,115,62,1099
1137704_1992FormulaOneSeason.txt,679,13,52,245,102,47,23,417
1137710_DamianDrum.txt,661,10,66,243,92,41,18,394
1138374_SecondBattleOfFallujah.txt,2641,49,53,1113,339,177,67,1696
113844_AldenIowa.txt,1125,38,29,410,145,61,17,633
1138831_TrueStoriesfilm.txt,657,14,46,263,80,55,19,417
1139590_Vivendi.txt,1417,24,59,574,180,81,27,862
113962_SigourneyIowa.txt,1060,21,50,340,160,48,25,573
113967_AlgonaIowa.txt,763,21,36,254,97,43,13,407
113982_KeokukIowa.txt,893,17,52,324,107,50,21,502
1139878_HistoryOfWarwickshire.txt,1024,34,30,386,136,81,26,629
1139890_HistoryOfSussex.txt,2283,34,67,780,327,158,50,1315
1139974_Jakalope.txt,629,19,33,275,74,49,9,407
1140616_TomGordon.txt,562,21,26,232,57,24,17,330
1140831_Wordtank.txt,406,15,27,141,25,52,10,228
1140832_AdelaidecrafersHighway.txt,696,11,63,250,104,66,21,441
1141025_CommendatoryAbbot.txt,699,4,174,230,91,53,32,406
1141036_LayAbbot.txt,776,9,86,269,103,52,32,456
1141998_TheLatymerSchool.txt,1765,31,56,709,213,149,34,1105
1142156_ListsOfRadioStationsInSouthAmerica.txt,765,36,21,499,11,26,6,542
1142777_ScottEvil.txt,710,13,54,235,117,43,51,446
1142789_ListOfYouCantDoThatOnTelevisionEpisodes.txt,483,16,30,292,13,11,5,321
1143105_Marauderscomics.txt,1037,12,86,358,156,76,39,629
1143760_DavidCorn.txt,738,12,61,324,87,34,19,464
1144146_PattaniKingdom.txt,1107,16,69,438,145,65,27,675
1144321_SouthernExpressway.txt,682,14,48,252,90,44,7,393
1144327_Graftgold.txt,1832,29,63,665,253,156,83,1157
1144328_InternetExplorerForMac.txt,1984,26,76,833,254,123,52,1262
1144908_Wnwotv.txt,1066,23,46,534,114,39,33,720
1144969_PrinceXizor.txt,919,14,65,339,132,46,27,544
1145280_KabutoYakushi.txt,1993,23,86,630,345,116,101,1192
1145289_KurenaiYuhi.txt,1547,17,91,509,259,72,68,908
1145368_Dominionism.txt,3700,55,67,1430,410,300,135,2275
1145370_SymphonicMetal.txt,1682,27,62,670,190,217,83,1160
1145922_WashingtonCrossingTheDelaware.txt,934,19,49,324,128,64,29,545
114612_NewtonKansas.txt,1141,20,57,536,102,57,11,706
1146168_LancetSurveysOfMortalityBeforeAndAfterThe2003InvasionOfIraq.txt,7979,108,73,2731,1136,512,275,4654
114621_DenisonKansas.txt,964,14,68,357,122,42,14,535
1146323_DarrenDaulton.txt,1002,20,50,336,154,65,31,586
1147129_BattleOfZadwrze.txt,1013,17,59,357,141,90,38,626
1147130_AreaCodesInGermany.txt,15042,160,94,7023,288,1163,182,8656
1147579_JamesFannin.txt,1263,17,74,497,178,51,33,759
1148291_InSearchOfSpace.txt,669,11,60,345,66,36,17,464
1148294_RoyalWarrant.txt,1475,23,64,1015,72,63,12,1162
1148486_ChangeManagementitsm.txt,614,12,51,260,86,27,17,390
1148507_2003AflSeason.txt,4249,65,65,1318,31,194,3,1546
1148532_JanKulczyk.txt,692,11,62,273,71,64,28,436
1148534_Muixeranga.txt,565,11,51,187,66,56,29,338
1148676_VulcanFoundry.txt,829,21,39,307,102,61,29,499
1148726_Stollen.txt,643,11,58,231,102,40,27,400
1149303_IlsaShewolfOfTheSs.txt,601,9,66,268,69,37,22,396
1149365_Devourment.txt,1125,19,59,436,156,79,50,721
115062_BellevueKentucky.txt,658,19,34,239,76,37,6,358
1150863_TheatreOrgan.txt,3197,46,69,1262,371,330,113,2076
1150894_VictimBlaming.txt,893,13,68,266,133,82,44,525
1151822_BnewYorkCitySubwayService.txt,796,19,41,310,92,55,26,483
1151939_CodexAlimentarius.txt,747,15,49,353,85,57,15,510
1152899_MermaidSeries.txt,768,42,18,455,17,13,1,486
1154033_SilkairFlight185.txt,675,13,51,253,79,62,26,420
1155221_BlazemortalKombat.txt,955,17,56,368,164,38,33,603
1155244_Uraeus.txt,685,17,40,292,73,29,20,414
1155832_SistersOfBattlewarhammer40000.txt,819,12,68,279,112,73,40,504
1156179_Soluna.txt,1135,20,56,485,142,73,23,723
1156180_WomenInTheUnitedStatesSenate.txt,1528,35,43,679,150,102,50,981
1156187_UniversityOfMontevallo.txt,1167,21,55,597,97,58,19,771
1156189_IndianHeadTestCard.txt,1275,20,63,509,153,102,50,814
1156283_BrownCorpus.txt,1131,16,70,523,106,131,46,806
1156284_Lumbriculidae.txt,748,2,374,529,97,17,13,656
1156289_ArtificialTurf.txt,1711,30,57,585,258,181,91,1115
1156374_ChinaVideoDisc.txt,758,16,47,265,99,97,35,496
115682_MonroeLouisiana.txt,1289,27,47,633,122,62,21,838
115695_NewRoadsLouisiana.txt,1024,20,51,408,117,74,13,612
115698_BoyceLouisiana.txt,592,11,53,191,80,35,9,315
1157037_RadolaGajda.txt,1195,20,59,441,152,85,25,703
115707_CoushattaLouisiana.txt,832,19,43,296,103,48,12,459
1157237_HJones.txt,1072,17,63,384,147,65,38,634
1157341_WashingtonMetropolitanAreaTransitAuthority.txt,894,18,49,401,117,54,20,592
1157430_WebBug.txt,1549,20,77,516,266,123,68,973
1158422_IllinoisCentralRailroad.txt,1005,21,47,461,99,66,18,644
1159157_BeYourselfTonight.txt,583,12,48,326,34,33,8,401
1160179_RayOfLight.txt,1925,34,56,762,266,142,52,1222
1160191_LongTermCareInsurance.txt,1218,26,46,419,191,139,57,806
1160558_Corydoras.txt,1018,10,101,473,139,84,47,743
1160586_EyeCircles.txt,638,17,37,218,92,51,29,390
1160743_Gerbera.txt,529,9,58,327,47,28,15,417
116131_MattawamkeagMaine.txt,569,13,43,203,76,19,4,302
1161404_Waaffm.txt,4075,80,50,1753,417,334,125,2629
1161510_TeachForAmerica.txt,1188,18,66,492,162,84,40,778
1161795_OttoAbetz.txt,891,14,63,313,118,65,28,524
11623_FrancescoISforza.txt,968,15,64,347,119,56,29,551
1162474_WestGodavari.txt,744,19,39,379,79,51,19,528
11624_FolkDance.txt,848,17,49,341,105,93,43,582
1162761_RiverchaseGalleria.txt,970,15,64,374,123,59,28,584
1162763_Baoul.txt,912,29,31,301,153,79,32,565
1162918_Margolioth.txt,634,18,35,427,32,28,8,495
11634_FieldExtension.txt,1665,33,50,579,228,180,71,1058
11635_FloodFill.txt,754,10,75,261,74,76,13,424
11638_FrancisOfAssisi.txt,3051,42,72,1092,402,138,101,1733
11643_FirstCouncilOfConstantinople.txt,942,17,55,347,114,56,32,549
11646_FriedrichHayek.txt,2932,29,101,1178,280,234,79,1771
1164721_RoyalGrammarSchoolGuildford.txt,567,13,43,329,30,25,3,387
1164730_RhodesUniversity.txt,2941,48,61,1322,279,182,65,1848
1164940_AurlioBuarqueDeHolandaFerreira.txt,793,18,44,349,79,44,8,480
1165108_JamesEdwinThoroldRogers.txt,553,10,55,229,43,34,6,312
1165130_MidlandAndGreatNorthernJointRailway.txt,1392,20,69,565,155,112,51,883
11652_FredBrooks.txt,640,44,14,333,44,29,13,419
1165669_1994FifaWorldCupmatchReports.txt,798,9,88,276,113,56,25,470
11656_FiguredBass.txt,1982,28,70,553,335,196,120,1204
11657_Fashion.txt,1914,25,76,717,237,167,86,1207
11659_FourierAnalysis.txt,2058,51,40,768,251,214,79,1312
1166059_BoltzmannMachine.txt,1521,44,34,531,223,124,47,925
1166093_HabitualAbortion.txt,979,17,57,379,154,91,42,666
11660_FatMan.txt,1200,20,60,387,172,110,50,719
1166117_Lycidas.txt,798,12,66,267,111,68,33,479
11661_FalseClaimsAct.txt,672,15,44,275,92,33,21,421
1166837_KoreanTeaCeremony.txt,2041,42,48,739,277,205,86,1307
1166888_MichaelRose.txt,643,13,49,272,78,41,19,410
1166897_Landstalker.txt,811,14,57,294,137,41,21,493
1166902_RedHillAustralianCapitalTerritory.txt,1539,32,48,600,195,89,37,921
1166903_OutlawscomputerGame.txt,1132,29,39,432,150,89,38,709
1167316_ViennaUbahn.txt,958,33,29,402,114,86,28,630
11673_FawltyTowers.txt,3694,51,72,1214,557,257,175,2203
116759_SalemMassachusetts.txt,1702,28,60,718,185,116,31,1050
116766_ColrainMassachusetts.txt,960,15,64,310,133,55,31,529
116784_SouthDeerfieldMassachusetts.txt,580,10,58,206,67,34,6,313
116787_WarwickMassachusetts.txt,689,16,43,228,89,42,11,370
116790_Hygroscopy.txt,579,12,48,207,85,51,18,361
116793_BrimfieldMassachusetts.txt,580,11,52,215,61,27,3,306
116795_ChicopeeMassachusetts.txt,722,15,48,252,97,49,7,405
116796_EastLongmeadowMassachusetts.txt,579,11,52,204,67,37,5,313
1167973_GeorgeAllenfootball.txt,1327,21,63,527,179,68,33,807
116797_GranvilleMassachusetts.txt,685,11,62,247,84,48,15,394
116798_HampdenMassachusetts.txt,1248,31,40,416,179,94,35,724
116799_HolyokeMassachusetts.txt,1038,19,54,364,130,70,22,586
116800_LudlowMassachusetts.txt,693,11,63,236,91,51,16,394
1168044_Dhritarashtra.txt,922,13,70,312,155,46,23,536
116805_SouthwickMassachusetts.txt,1387,21,66,498,180,91,31,800
116820_NorthamptonMassachusetts.txt,1724,28,61,729,181,106,31,1047
1168272_AndrewJohnsonfootballer.txt,1734,27,64,628,238,95,63,1024
1169319_IllinoisStateTollHighwayAuthority.txt,1134,16,70,428,154,73,34,689
1169455_December2001Riotsargentina.txt,2497,38,65,935,357,164,67,1523
1169457_BrianClark.txt,959,32,29,288,175,51,27,541
1169490_SunbeamCarCompany.txt,2302,26,88,848,308,148,70,1374
1170093_JohnFacenda.txt,991,33,30,379,138,45,30,592
1170153_Catch22band.txt,721,12,60,319,92,44,17,472
1171498_UssHawkbillss366.txt,826,16,51,337,100,45,17,499
1171504_TripleJHottest1001995.txt,827,7,118,429,22,9,5,465
117178_ShorewoodtowerHillsharbertMichigan.txt,690,9,76,237,86,37,7,367
1172273_ArchitectureOfIreland.txt,2620,33,79,1033,290,276,107,1706
117228_MarshallMichigan.txt,1268,24,52,456,150,69,24,699
1172596_CoatOfArmsOfTheNetherlands.txt,1382,24,57,495,155,73,26,749
1172601_CanoeCamping.txt,950,19,50,395,103,85,36,619
1172622_SkylonTower.txt,685,10,68,305,74,37,15,431
1172710_PsychedelicArt.txt,1718,22,78,743,217,157,80,1197
1172789_RosalindHicks.txt,939,12,78,286,155,46,32,519
1173470_TelDanStele.txt,1723,12,143,597,258,69,50,974
1173760_HumanGivens.txt,1039,20,51,322,181,90,41,634
1173858_VendettaRed.txt,558,14,39,255,62,43,7,367
1173866_NoelMalcolm.txt,670,27,24,332,45,29,13,419
1174994_AnatomyOfCriticism.txt,3318,40,82,1131,340,410,118,1999
1175002_JohnCanemaker.txt,647,9,71,325,50,18,3,396
1175010_RayClemence.txt,1495,19,78,531,186,96,54,867
1175965_Phorusrhacidae.txt,563,11,51,254,61,52,22,389
1175987_ListOfNobelLaureates.txt,1011,62,16,740,26,6,2,774
1177186_Gp30.txt,556,16,34,212,69,35,12,328
1177_AleisterCrowley.txt,6894,90,76,2401,931,479,233,4044
1178134_BlackCodesInTheUsa.txt,1583,19,83,621,206,88,36,951
1178147_ListOfPennsylvaniaRailroadPassengerTrains.txt,698,2,349,552,56,1,0,609
1178150_TsutomuMiyazaki.txt,766,15,51,271,107,46,30,454
1178163_CharlesGoodell.txt,805,13,61,317,93,55,17,482
117856_RockfordMichigan.txt,860,18,47,306,108,55,14,483
117865_WyomingMichigan.txt,585,11,53,186,72,31,7,296
1178793_AtiatihanFestival.txt,685,13,52,246,89,71,26,432
1178806_BangladeshAgriculturalUniversity.txt,813,15,54,409,52,36,13,510
117889_AlmontMichigan.txt,590,9,65,199,74,31,7,311
117897_ColumbiavilleMichigan.txt,739,12,61,242,90,35,13,380
1178_Afterlife.txt,4502,92,48,1454,661,352,207,2674
1179347_ChiakiKuriyama.txt,673,14,48,402,29,36,4,471
1179355_MeroiticScript.txt,572,11,52,167,84,62,26,339
1179369_DomeCar.txt,1126,18,62,431,151,76,30,688
1179390_ScottStapp.txt,757,16,47,315,105,32,20,472
1180004_Falcon40.txt,893,15,59,360,111,83,32,586
1180298_CindyWalker.txt,641,13,49,235,97,32,17,381
1180324_SonyEricssonK700.txt,924,15,61,309,135,66,32,542
1181153_LiberalismInGreece.txt,571,16,35,296,47,27,8,378
1181464_Chipitts.txt,577,9,64,309,42,25,13,389
1181467_ItalianComics.txt,1626,22,73,727,148,168,40,1083
1181469_RmsRepublic1903.txt,861,12,71,341,132,34,29,536
1181480_ElectronCloud.txt,750,8,93,265,97,77,36,475
1181481_Clipammunition.txt,742,22,33,276,120,50,37,483
1181_Astrometry.txt,599,14,42,234,73,64,13,384
1182691_ListOfCensusdesignatedPlacesInNewYork.txt,1528,26,58,1490,2,10,2,1504
1182_Athena.txt,3327,46,72,1163,489,209,127,1988
118326_ClawsonMichigan.txt,646,12,53,209,84,36,7,336
1183322_Loadmaster.txt,732,11,66,252,100,48,30,430
1183636_BattleOfAbydos.txt,719,8,89,253,121,28,17,419
1183638_GianfrancoFini.txt,1074,26,41,358,137,81,46,622
1184272_ListOfAssyrians.txt,835,23,36,660,6,15,2,683
1184863_RobertPalmerauthorproducer.txt,576,12,48,287,47,31,9,374
1185806_OuterHeaven.txt,1094,24,45,468,138,69,26,701
1185811_KinderMorganEnergyPartners.txt,719,10,71,319,95,36,21,471
1185836_MindBodySoul.txt,915,12,76,615,41,32,18,706
1185918_Movementalbum.txt,926,22,42,329,106,57,47,539
1185922_SteelSquare.txt,782,11,71,278,112,55,17,462
1186538_GunnarKaasen.txt,771,13,59,292,105,44,22,463
1186641_HouseTully.txt,1753,30,58,674,251,86,47,1058
1186885_Turangawaewae.txt,812,9,90,331,100,50,22,503
1186886_LinearSystemOfDivisors.txt,708,19,37,246,80,78,25,429
1187028_UnitedStatesArmyReserve.txt,913,14,65,474,74,46,15,609
1189044_HenryWCoeStatePark.txt,2481,37,67,1013,294,218,113,1638
1189140_Ddtband.txt,806,26,31,367,93,42,20,522
1189247_MuseumOfFineArtsBoston.txt,700,15,46,301,69,54,11,435
1189259_ManhattanCollege.txt,1080,21,51,491,108,69,20,688
118962_StHelenMichigan.txt,586,12,48,198,68,28,7,301
1190213_LeoWalmsley.txt,347,8,43,160,25,10,5,200
1191343_PopulousTheBeginning.txt,1488,28,53,504,214,123,55,896
1191971_AbdulMajidAlkhoei.txt,810,13,62,262,132,44,30,468
1191975_UrbanCowboy.txt,691,13,53,271,108,28,17,424
1192039_FrederickGeorgeTopham.txt,1161,20,58,416,156,91,26,689
1192538_SwainsonaFormosa.txt,810,14,57,288,103,75,36,502
1193502_ShimazuYoshihisa.txt,620,7,88,206,100,20,24,350
1193618_ShimazuYoshihiro.txt,780,10,78,261,122,36,30,449
1194265_HmsExeter68.txt,812,10,81,310,121,43,15,489
1194533_CosmicEraMobileUnits.txt,6883,134,51,3211,712,566,128,4617
1194551_AdrianCartonDeWiart.txt,4488,66,68,1648,596,300,142,2686
1194553_VacheronConstantin.txt,1136,24,47,388,160,81,33,662
1194556_TheLittlePrincetvSeries.txt,582,16,36,346,40,21,12,419
1194558_PaperMonsters.txt,1899,70,27,1197,134,90,25,1446
1194572_VictorAlexanderCharlesCrutchley.txt,1504,21,71,646,167,79,19,911
1195226_WilliamMcgregor.txt,681,9,75,245,94,39,23,401
1195281_RugbyLeaguePositions.txt,2712,53,51,989,369,207,126,1691
1195294_Degreeangle.txt,739,17,43,216,78,73,26,393
1195777_DougJonesactor.txt,815,15,54,371,64,39,18,492
1195796_UssSouthfield1857.txt,1026,15,68,407,158,49,18,632
1195805_WalkingWithDinosaurs.txt,2758,62,44,1094,354,187,75,1710
1196424_MuhammadZafrullaKhan.txt,681,4,170,270,62,16,9,357
1196709_OnIntelligence.txt,1455,23,63,572,152,120,46,890
1199100_Unglued.txt,655,10,65,274,86,45,22,427
1199108_PetrleosDeVenezuelaSa.txt,952,18,52,461,83,54,19,617
1199136_TexasSouthmostCollege.txt,637,10,63,291,66,30,11,398
1199138_StairwayToHeaventvSeries.txt,1197,19,63,486,166,78,49,779
1200054_BattleRoyal.txt,605,11,55,197,92,54,29,372
1200154_ColumbusDayStormOf1962.txt,1415,23,61,518,154,129,48,849
120023_LanesboroMinnesota.txt,594,15,39,223,70,31,7,331
120042_AlbertLeaMinnesota.txt,656,13,50,286,79,34,4,403
120095_RedWingMinnesota.txt,544,21,25,213,50,25,3,291
120105_ZumbrotaMinnesota.txt,670,22,30,228,87,45,10,370
120108_BarrettMinnesota.txt,711,17,41,267,85,33,11,396
120122_Beemster.txt,562,12,46,212,67,40,13,332
1201272_Clacks.txt,1435,24,59,469,241,94,53,857
1201303_ForcingNotrump.txt,1663,36,46,482,194,180,63,919
1201752_51PegasiB.txt,618,13,47,221,90,44,23,378
1202264_FirstConfederateCongress.txt,941,36,26,683,55,10,3,751
1202265_SaltLakeCitySchoolDistrict.txt,1250,22,56,577,130,83,23,813
1202333_AlbertaSenateNomineeElection2004.txt,925,22,42,342,148,57,28,575
1202882_DougEllis.txt,782,15,52,261,123,47,24,455
1202949_Wau.txt,912,16,57,330,112,75,18,535
1203282_WarRoomvideoGame.txt,976,18,54,347,160,65,26,598
1204035_ProgressiveMuslimUnion.txt,603,18,33,242,70,61,17,390
1204419_PresidentialAdvisoryCouncilOnHivaids.txt,685,8,85,387,54,42,8,491
1204499_DavidReidboxer.txt,721,15,48,269,81,57,20,427
1204611_AirBud.txt,577,16,36,280,55,27,20,382
1204618_ListOfFictionalJournalists.txt,669,14,47,431,22,29,6,488
1204621_LesChoristes.txt,817,13,62,278,114,74,39,505
1204623_TrifidCipher.txt,636,11,57,160,66,34,37,297
12047_GazaStrip.txt,1845,26,70,759,214,119,51,1143
120499_NorthomeMinnesota.txt,791,13,60,275,108,47,16,446
1205487_JuneJones.txt,681,15,45,276,73,36,18,403
1205488_BritishRailwaysMark1.txt,1845,27,68,641,268,161,53,1123
1205569_HighclereCastle.txt,819,12,68,289,110,59,29,487
1205580_Biba.txt,1974,32,61,630,352,162,84,1228
1205661_M1917BrowningMachineGun.txt,1059,22,48,391,143,88,33,655
1206775_LowFloor.txt,1126,19,59,526,104,103,38,771
1206780_RaymondGHSeitz.txt,689,11,62,303,60,27,8,398
1207239_Alliancefirefly.txt,1609,30,53,554,232,132,80,998
1207830_CeriumiiiChloride.txt,599,9,66,285,56,38,15,394
1207841_Shadowsong.txt,914,20,45,300,124,57,35,516
1207852_LaLasong.txt,1630,22,74,554,213,123,54,944
1208396_JulianKnight.txt,1270,24,52,555,141,76,25,797
1208779_Glamorama.txt,622,12,51,203,95,45,27,370
1209609_LoveMeDo.txt,2047,26,78,768,301,134,87,1290
1210028_LanguagesOfSouthAfrica.txt,1028,18,57,426,103,111,43,683
1210030_Oct4.txt,727,24,30,320,66,61,20,467
1210949_BioethicsOfNeonatalCircumcision.txt,2173,53,41,839,272,210,61,1382
1210961_DefenceResearchAndDevelopmentCanada.txt,588,15,39,312,43,59,6,420
1211143_Petrushkaballet.txt,1453,48,30,603,179,84,32,898
12113_EconomyOfGreece.txt,2169,25,86,779,236,192,54,1261
1211722_Genestealer.txt,1712,17,100,515,258,153,94,1020
1211783_FelipeFernndezarmesto.txt,728,9,80,234,134,37,29,434
1212160_AlyxVance.txt,1674,25,66,554,238,132,82,1006
1212186_TransylvanianSaxons.txt,1526,25,61,595,180,113,32,920
1212188_TedWilliamsTunnel.txt,589,13,45,235,84,37,16,372
1213134_TheRailwaySeries.txt,3344,74,45,1252,431,192,126,2001
1213146_TredegarIronWorks.txt,979,12,81,418,115,46,23,602
1213370_MatthewBlagdenHale.txt,1042,27,38,399,139,37,20,595
1213375_BadGottleubaberggiehbel.txt,1394,52,26,536,177,82,34,829
1213970_Rivne.txt,840,16,52,323,83,71,18,495
1214314_SuncorpStadium.txt,1101,27,40,466,124,46,26,662
1215524_ConsolidatedAppropriationsAct2005.txt,983,21,46,336,111,63,22,532
121567_FaribaultMinnesota.txt,1681,32,52,609,209,142,43,1003
121572_NerstrandMinnesota.txt,695,18,38,249,98,40,14,401
1216466_IvanAGetting.txt,936,30,31,457,73,45,8,583
1216569_RoyalGrammarSchoolNewcastle.txt,1271,20,63,528,148,92,38,806
1217160_PromptCritical.txt,861,10,86,273,123,101,48,545
1218644_JordanKnight.txt,1023,14,73,424,117,47,20,608
1218749_CraigJohnston.txt,1713,36,47,585,229,110,67,991
1219314_EconomyOfAsia.txt,2630,44,59,1000,292,277,94,1663
1219401_TechnicalCommunication.txt,1598,40,39,591,219,163,52,1025
1219503_DeltaChi.txt,3891,34,114,1912,327,162,82,2483
1219513_1978WorldSeries.txt,830,43,19,342,24,14,5,385
1219720_HanaZagorov.txt,9763,286,34,6121,137,902,42,7202
1219881_Highway410ontario.txt,666,15,44,236,83,40,18,377
1220817_SportInTheUnitedKingdom.txt,6631,93,71,2453,820,681,297,4251
1220825_PhilippineRevolution.txt,3910,71,55,1390,573,236,135,2334
1221031_NinaSky.txt,766,14,54,347,91,46,14,498
1221494_JonKingpornStar.txt,723,9,80,241,123,33,37,434
1221496_Fusker.txt,677,16,42,223,110,46,33,412
1221889_MercedesbenzO530Citaro.txt,666,20,33,309,50,53,22,434
122256_CrystalSpringsMississippi.txt,1333,21,63,429,195,88,38,750
122258_HazlehurstMississippi.txt,795,17,46,285,102,42,9,438
1222656_EconomyOfOceania.txt,633,29,21,243,69,53,28,393
122267_OliveBranchMississippi.txt,732,19,38,263,79,53,12,407
1222711_DaigoFukuryMaru.txt,581,15,38,221,85,35,13,354
122275_BayStLouisMississippi.txt,965,18,53,359,109,61,18,547
122278_PearlingtonMississippi.txt,730,20,36,264,87,37,11,399
122280_WavelandMississippi.txt,834,20,41,295,107,43,18,463
122281_BiloxiMississippi.txt,1403,31,45,541,179,98,18,836
122283_GulfportMississippi.txt,632,13,48,206,81,42,11,340
122286_PassChristianMississippi.txt,943,18,52,321,125,62,22,530
122289_ByramMississippi.txt,524,10,52,154,81,27,6,268
122290_ClintonMississippi.txt,1043,18,57,470,96,56,19,641
122293_RaymondMississippi.txt,753,17,44,262,89,42,9,402
1223055_IonMihalache.txt,1868,19,98,721,226,113,63,1123
1223195_MeridianHouse.txt,650,11,59,261,77,47,21,406
1223684_Veerzaara.txt,1227,23,53,641,127,58,31,857
1223875_JamesMorrisColquhounColvin.txt,718,17,42,358,49,34,6,447
1224156_DistrictsOfGhana.txt,587,33,17,451,28,21,1,501
1224162_LanguageDelay.txt,629,20,31,256,82,43,24,405
1225205_Menards.txt,732,20,36,350,94,44,21,509
1225206_GovernmentOfFreeVietnam.txt,820,20,41,395,85,34,13,527
1225218_32Demands.txt,1268,23,55,444,174,119,47,784
1225219_TheHumbleGuys.txt,1612,25,64,601,206,107,60,974
1225237_TokyoMarui.txt,1750,26,67,773,213,137,57,1180
1226442_StewartGrandPrix.txt,882,11,80,304,122,75,35,536
1226446_ElFilibusterismo.txt,1271,16,79,458,169,78,41,746
1226456_HaraldErtl.txt,568,15,37,195,64,36,20,315
122671_PattonsburgMissouri.txt,800,11,72,241,118,42,23,424
1227054_TheKinksAreTheVillageGreenPreservationSociety.txt,1462,26,56,742,139,100,30,1011
1227181_BoYibo.txt,1250,18,69,449,159,95,45,748
1227380_TheHongkongAndShanghaiBankingCorporation.txt,1703,30,56,717,184,97,32,1030
1227385_BuddhistCalendar.txt,693,9,77,261,75,63,36,435
1227414_Galerina.txt,772,18,42,318,94,78,28,518
1228638_ChemicalShift.txt,679,16,42,236,89,93,15,433
1229351_WhereTheWildThingsAre.txt,933,33,28,383,113,46,22,564
1229566_GuadalupeIsland.txt,1027,19,54,428,101,92,32,653
1229600_Wandervogel.txt,600,13,46,219,77,45,23,364
1229770_YeshivasChofetzChaimRabbinicalSeminaryOfAmerica.txt,1082,22,49,449,125,76,44,694
1229775_KeppelHarbour.txt,670,15,44,263,96,37,11,407
1230308_JuanRomnRiquelme.txt,1178,19,62,465,143,74,31,713
1230710_TheEducationOfHenryAdams.txt,1073,22,48,404,132,87,36,659
1231529_PhilippinePesoCoins.txt,909,13,69,290,143,62,31,526
1231928_Naskhtafsir.txt,4446,91,48,1557,586,317,196,2656
1231956_FortRinella.txt,706,20,35,228,130,39,25,422
1232918_JazzJackrabbit2.txt,913,15,60,404,107,59,35,605
123348_RedLodgeMontana.txt,688,15,45,235,88,41,11,375
123349_EkalakaMontana.txt,709,12,59,210,95,47,13,365
123369_MilesCityMontana.txt,790,18,43,284,91,49,13,437
123391_BozemanMontana.txt,1630,26,62,715,168,105,24,1012
1234104_Warheadscomics.txt,817,31,26,402,91,70,15,578
1234115_OneWeekendAMonthTwoWeeksAYear.txt,629,20,31,197,110,32,30,369
1234120_EssexRegiment.txt,1388,26,53,610,146,74,27,857
1235059_BreedRegistry.txt,1311,20,65,481,213,90,52,836
1235060_ForTheWorldIsHollowAndIHaveTouchedTheSky.txt,1416,24,59,471,230,73,50,824
1235065_MaxPapis.txt,634,9,70,211,88,40,19,358
1235096_HanifKureishi.txt,863,9,95,423,89,39,13,564
1235742_HansHerrmann.txt,1022,18,56,352,114,76,28,570
1236132_MaginationDuel.txt,1059,17,62,412,168,86,34,700
1236283_Swatpakistan.txt,2102,21,100,818,272,112,56,1258
1236295_ShlomoMintz.txt,862,33,26,482,59,22,18,581
1236481_Wpcw.txt,1339,26,51,575,153,85,29,842
1236496_Wtaetv.txt,1649,24,68,903,104,62,34,1103
1236501_DavidRBeatty.txt,623,13,47,372,25,19,5,421
1236502_Wpxi.txt,1931,36,53,945,134,96,60,1235
1236505_JosetteFrankAward.txt,755,134,5,505,12,9,5,531
1236507_InnerWestRailwayLineSydney.txt,624,7,89,293,62,27,15,397
1236517_HyamMaccoby.txt,1106,15,73,421,120,69,42,652
1236519_Wpghtv.txt,648,15,43,233,90,36,29,388
1236523_TommyWindich.txt,587,8,73,207,86,39,12,344
1237092_Closerplay.txt,728,12,60,269,98,25,22,414
1238129_HamiltonNaki.txt,596,6,99,186,92,40,16,334
1238660_ListOfStateLeadersIn1117.txt,855,4,213,512,1,11,0,524
1238662_ListOfStateLeadersIn1116.txt,856,4,214,512,1,10,0,523
1238673_ListOfStateLeadersIn1115.txt,849,4,212,509,2,10,0,521
1238677_ListOfStateLeadersIn1114.txt,834,4,208,498,1,10,0,509
1238681_ListOfStateLeadersIn1113.txt,827,4,206,493,1,10,0,504
1238683_ListOfStateLeadersIn1112.txt,847,4,211,502,1,11,0,514
1238686_ListOfStateLeadersIn1111.txt,824,4,206,493,1,10,0,504
1238690_ListOfStateLeadersIn1110.txt,787,4,196,472,1,10,0,483
1238702_ListOfStateLeadersIn1108.txt,790,4,197,469,1,14,0,484
1238705_ListOfStateLeadersIn1107.txt,830,4,207,494,1,13,0,508
1238707_ListOfStateLeadersIn1106.txt,844,4,211,502,2,13,0,517
1239089_WilliamApplemanWilliams.txt,1108,18,61,449,115,79,25,668
1239866_PopulationHistoryOfAmericanIndigenousPeoples.txt,3455,36,95,1196,493,334,168,2191
1239891_Oberiu.txt,821,12,68,299,100,69,32,500
1240297_VinylConfessions.txt,567,10,56,284,49,34,19,386
1240850_Cessna206.txt,1241,39,31,440,173,70,30,713
1240867_PublicHousingInTheAustralianCapitalTerritory.txt,1979,40,49,706,307,135,58,1206
1241020_JamesIvorydirector.txt,1018,13,78,588,92,30,17,727
1241036_VersionsAndPortsOfDoom.txt,2657,52,51,1022,358,207,106,1693
1241061_DominicanUniversityOfCalifornia.txt,705,18,39,324,73,57,12,466
1241991_Horwich.txt,832,24,34,338,91,56,20,505
124259_Buxton.txt,1079,21,51,437,122,82,37,678
124260_PlainfieldTownshipKentCountyMichigan.txt,649,11,59,233,69,37,4,343
1243211_KingdomOfNdongo.txt,2036,49,41,745,291,116,62,1214
1243236_ReggieWayne.txt,608,10,60,239,69,43,12,363
1243558_Targe.txt,582,7,83,175,83,51,23,332
1243625_WaterlooSunset.txt,681,16,42,248,82,51,21,402
1243627_SeanConway.txt,877,13,67,336,104,64,26,530
1244173_UltramaficRock.txt,558,13,42,206,93,84,25,408
1244583_MotTest.txt,929,22,42,324,129,79,33,565
1245240_2hd.txt,976,24,40,409,98,50,20,577
1245381_ThumbWars.txt,1173,26,45,498,162,68,36,764
1245740_19thOfAprilMovement.txt,1224,21,58,403,170,106,40,719
1245781_LordJusticeClerk.txt,573,8,71,334,19,13,3,369
1246458_TrevorBaylis.txt,1041,25,41,378,159,53,20,610
1246747_Byss.txt,1201,11,109,381,172,110,48,711
1247577_BasketballAtThe2004SummerOlympicsteamSquads.txt,1136,55,20,806,4,12,0,822
1247969_FerdinandHrold.txt,1124,26,43,419,137,101,32,689
1248527_NationalAirwaysCorporation.txt,648,20,32,317,71,28,13,429
1248904_KazimierzKutz.txt,639,11,58,246,57,41,12,356
124901_FremontNewHampshire.txt,684,14,48,238,84,40,6,368
124902_GreenlandNewHampshire.txt,562,10,56,182,69,30,7,288
124903_HampsteadNewHampshire.txt,549,13,42,200,59,30,4,293
124905_HamptonFallsNewHampshire.txt,1374,27,50,440,180,84,35,739
124910_NewingtonNewHampshire.txt,681,11,61,239,79,27,9,354
1249122_WaterSupplyNetwork.txt,722,16,45,305,97,59,20,481
124913_NorthwoodNewHampshire.txt,678,14,48,258,74,37,7,376
124914_Matrixmathematics.txt,2025,67,30,761,254,191,71,1277
124915_NottinghamNewHampshire.txt,574,14,41,216,60,32,3,311
1249586_Namaste.txt,769,17,45,240,103,52,39,434
1249591_RaymondGoethals.txt,818,17,48,303,112,63,17,495
1249602_FreddyThePig.txt,663,10,66,277,52,47,12,388
124970_WeymouthTownshipNewJersey.txt,541,15,36,208,57,23,3,291
124971_AllendaleNewJersey.txt,1150,30,38,458,131,59,8,656
124972_AlpineNewJersey.txt,1060,23,46,424,110,62,9,605
1249781_SteveWhite.txt,921,63,14,420,67,35,22,544
1250088_SenderLangenberg.txt,783,15,52,261,125,50,18,454
1250124_RandomNumberGeneratorAttack.txt,1155,14,82,407,181,97,55,740
1250758_OakhamSchool.txt,1827,42,43,892,165,120,44,1221
1250904_LouiseLehzen.txt,994,10,99,332,153,58,40,583
1251213_Townhall.txt,612,10,61,262,70,48,18,398
1251215_Pullip.txt,1085,59,18,629,109,85,25,848
1251240_AestheticsOfMusic.txt,823,14,58,295,92,85,32,504
1251857_DeltaDeltaDelta.txt,748,24,31,365,77,47,22,511
1251950_BillVukovich.txt,560,12,46,219,77,24,14,334
1251951_BisligCity.txt,738,18,41,260,95,69,26,450
1251978_BerievA50.txt,639,19,33,253,74,49,18,394
1252911_Rgm79Gm.txt,4067,75,54,1678,487,351,127,2643
1252913_ThermionicConverter.txt,1213,22,55,572,95,120,22,809
1252914_IndianaJones4.txt,681,13,52,220,116,39,29,404
125325_NewburyBerkshire.txt,2205,47,46,973,233,134,64,1404
125337_GeorgeCavendishwriter.txt,814,7,116,266,104,61,33,464
125341_FlemingtonNewJersey.txt,1212,28,43,528,123,64,21,736
125342_FranklinTownshipHunterdonCountyNewJersey.txt,723,19,38,303,65,34,8,410
125344_FrenchtownNewJersey.txt,669,20,33,278,69,28,4,379
1253460_ElCentroDeLaRaza.txt,639,8,79,267,77,36,21,401
1253464_DonPierson.txt,1282,18,71,515,148,87,23,773
125346_GlenGardnerNewJersey.txt,611,17,35,259,61,27,5,352
1253487_Morathi.txt,979,11,89,311,143,59,34,547
125349_HamptonNewJersey.txt,1018,24,42,433,108,60,17,618
125350_HighBridgeNewJersey.txt,951,23,41,408,96,53,9,566
125352_HollandTownshipNewJersey.txt,766,18,42,318,81,36,6,441
125354_KingwoodTownshipNewJersey.txt,598,17,35,238,62,25,6,331
125356_LambertvilleNewJersey.txt,1207,28,43,519,130,62,17,728
125358_LebanonNewJersey.txt,792,22,36,338,81,39,10,468
125360_LebanonTownshipNewJersey.txt,622,17,36,278,58,23,4,363
125361_MilfordNewJersey.txt,656,17,38,270,72,26,7,375
125363_RaritanTownshipNewJersey.txt,749,18,41,334,67,37,9,447
125365_ReadingtonTownshipNewJersey.txt,1052,25,42,457,99,58,9,623
125368_TewksburyTownshipNewJersey.txt,782,19,41,335,84,33,11,463
125370_UnionTownshipHunterdonCountyNewJersey.txt,640,15,42,272,68,23,6,369
125371_CaterpillarTrack.txt,1554,17,91,520,260,146,52,978
125372_WestAmwellTownshipNewJersey.txt,690,17,40,294,68,27,7,396
1254130_Jagdterrier.txt,1341,26,51,449,203,98,50,800
1254133_ManitobaHydro.txt,3972,53,74,1628,476,332,88,2524
1255078_Abjection.txt,861,8,107,227,134,73,34,468
1255092_PuttannaKanagal.txt,2117,68,31,864,254,149,68,1335
1255098_Grendizer.txt,3499,53,66,1398,492,238,101,2229
1256333_TheQueenOfSpadesopera.txt,1511,22,68,495,231,103,39,868
1257276_FeastOfTheImmaculateConception.txt,602,16,37,229,55,44,23,351
1257292_Vfa37.txt,651,15,43,291,61,29,9,390
1257454_BiggsAndWedge.txt,994,30,33,391,129,55,44,619
1257455_ProfessorWeston.txt,946,14,67,325,142,71,43,581
1257474_JaguarDtype.txt,1364,13,104,472,208,109,60,849
1257674_PolyviosKossivas.txt,825,9,91,262,136,40,26,464
1258402_StAndrewsSchoolsingapore.txt,2040,44,46,827,259,107,62,1255
1258453_TerryCooper.txt,947,14,67,335,124,64,37,560
1258455_OpusClavicembalisticum.txt,595,13,45,223,80,48,20,371
125983_LasVegasNewMexico.txt,1069,28,38,438,119,55,18,630
1259858_JohnBassett.txt,589,11,53,255,54,28,8,345
1260585_ColorCommentator.txt,520,19,27,364,35,18,16,433
1260687_Schreckstoff.txt,601,5,120,163,103,61,27,354
1260693_Harkatulmujahideen.txt,693,13,53,267,90,45,15,417
1260694_AboutUriScheme.txt,677,17,39,250,101,45,30,426
1261663_MutantLeagueFootball.txt,576,18,32,236,64,41,26,367
1261839_Sensurround.txt,668,21,31,276,82,50,19,427
1261840_PerkinsObservatory.txt,783,14,55,295,117,76,30,518
1262152_JudithExner.txt,602,13,46,197,109,25,19,350
1262174_LaylaAndMajnun.txt,550,10,55,202,71,23,20,316
1262220_1976UnitedStatesGrandPrixWest.txt,1039,14,74,388,132,78,40,638
1262769_AndyHui.txt,500,7,71,234,38,14,11,297
1263186_Lavalas.txt,4234,18,235,1649,575,311,64,2599
1263999_ElectionsInGermany.txt,1025,56,18,489,82,105,13,689
1264020_Elvaalbum.txt,661,7,94,383,22,25,3,433
126407_ConcordNewYork.txt,660,12,55,240,61,29,6,336
126417_LackawannaNewYork.txt,1362,27,50,513,159,83,18,773
126421_MarillaNewYork.txt,649,13,49,233,69,28,7,337
126424_SardiniaNewYork.txt,622,12,51,224,61,33,4,322
126426_SpringvilleNewYork.txt,577,15,38,218,59,32,3,312
126428_WalesNewYork.txt,1413,22,64,554,158,80,27,819
126429_WilliamsvilleNewYork.txt,1058,20,52,394,137,70,17,618
126430_ChesterfieldNewYork.txt,728,18,40,272,65,36,5,378
126431_CrownPointNewYork.txt,829,19,43,334,67,39,8,448
126432_ElizabethtownNewYork.txt,723,15,48,267,71,35,4,377
126433_EssexNewYork.txt,695,14,49,247,67,28,3,345
126436_LakePlacidNewYork.txt,2415,53,45,983,272,150,56,1461
126442_NorthElbaNewYork.txt,589,13,45,222,55,25,2,304
126445_SchroonLakeNewYork.txt,1150,19,60,511,118,58,15,702
126449_WillsboroNewYork.txt,645,12,53,220,69,33,11,333
126453_BellmontNewYork.txt,6917,71,97,2580,854,377,193,4004
126454_BombayNewYork.txt,639,15,42,226,62,28,6,322
126459_DickinsonFranklinCountyNewYork.txt,613,14,43,206,66,31,6,309
126460_1998FifaWorldCup.txt,927,98,9,475,74,41,9,599
126462_FortCovingtonNewYork.txt,591,13,45,201,70,24,6,301
1265996_ListOfPrinceEdwardIslandTownships.txt,654,11,59,269,54,30,8,361
1265998_CliffordOlson.txt,736,14,52,232,130,43,27,432
1266003_AlexKrycek.txt,1019,36,28,389,175,47,44,655
1266023_SouthwesternAdventistUniversity.txt,670,14,47,314,82,31,11,438
1266110_SmoothedParticleHydrodynamics.txt,917,22,41,322,134,94,37,587
1266201_Cugir.txt,702,10,70,267,79,47,14,407
1266213_JapaneseFilipino.txt,701,13,53,244,89,87,23,443
1266215_MorningPost.txt,662,14,47,242,79,46,16,383
1267166_IndustriesInMaldives.txt,1179,13,90,402,179,123,25,729
1267311_DouglasSkystreak.txt,760,11,69,317,76,44,8,445
1267322_LaNouba.txt,1783,40,44,698,220,132,51,1101
1267543_StevePoizner.txt,585,15,39,258,60,33,6,357
1267738_Aparajito.txt,630,11,57,212,102,37,25,376
1268378_Piedmon.txt,770,17,45,290,97,38,27,452
1269326_DougYule.txt,833,17,49,318,104,48,35,505
1269895_Gorchakov.txt,634,10,63,214,76,35,5,330
1270458_EisensteinSeries.txt,619,32,19,268,53,47,19,387
1270533_GreenDiamond.txt,612,11,55,233,93,35,15,376
1270558_IndochineseTiger.txt,632,15,42,203,92,54,23,372
1270559_AcomaPueblo.txt,620,9,68,238,90,44,23,395
1270564_JohnJGlennon.txt,684,12,57,297,73,34,14,418
1270566_TobiasWolff.txt,935,22,42,395,105,50,20,570
127073_ClarkstownNewYork.txt,777,14,55,299,59,37,3,398
12707_GuyFawkes.txt,2237,30,74,845,322,128,63,1358
127085_NewSquareNewYork.txt,1112,25,44,422,148,63,21,654
1270879_Pancelticism.txt,1204,18,66,486,128,138,55,807
127087_NyackNewYork.txt,833,16,52,318,86,41,18,463
12709_GoodtimesVirus.txt,925,18,51,309,145,63,39,556
12710_GarySnyder.txt,3648,45,81,1336,418,251,130,2135
127129_WiltonNewYork.txt,556,13,42,201,54,20,3,278
127130_DelansonNewYork.txt,2067,32,64,693,319,126,51,1189
127143_FultonSchoharieCountyNewYork.txt,556,12,46,198,57,25,6,286
127144_GilboaNewYork.txt,614,13,47,213,61,23,4,301
1271526_SouthernRegionBrazil.txt,607,19,31,244,48,52,25,369
12719_GustaveDeMolinari.txt,599,10,59,200,70,52,24,346
1272077_CueStick.txt,4301,25,172,1264,685,341,297,2587
12720_GuerrillaWarfare.txt,10676,118,90,4014,1374,1007,449,6844
12721_GeosynchronousSatellite.txt,800,13,61,279,119,86,26,510
1272643_RobinHoodEngineering.txt,646,12,53,239,103,40,31,413
1272748_MobilePhoneRadiationAndHealth.txt,2581,46,56,1001,334,259,78,1672
1272752_RyanairDestinations.txt,590,3,196,538,5,18,1,562
12727_OriginalProofOfGdelsCompletenessTheorem.txt,1653,45,36,438,234,163,90,925
12729_Grits.txt,581,10,58,204,89,45,26,364
12730_GeneralElectric.txt,1855,38,48,842,219,128,39,1228
12731_GeorgeHarrison.txt,6731,74,90,2527,896,436,233,4092
12733_GasGiant.txt,1483,21,70,483,202,157,68,910
12734_Goddess.txt,2782,59,47,1107,318,219,110,1754
12737_Gunpowder.txt,1391,19,73,489,187,127,66,869
1273903_DuchyOfBenevento.txt,1489,16,93,530,193,90,55,868
12740_GaryKildall.txt,1817,20,90,652,280,121,51,1104
1274179_RomanAgriculture.txt,623,17,36,195,73,61,15,344
12741_GestaDanorum.txt,1467,30,48,687,169,90,44,990
1274240_CecilHowardGreen.txt,764,13,58,334,90,30,16,470
1274258_JosSerra.txt,800,11,72,307,106,55,20,488
1274361_ForSpecialServices.txt,759,15,50,323,108,46,15,492
12743_GarrisonKeillor.txt,1962,26,75,790,244,129,65,1228
12744_Galatia.txt,1400,19,73,501,186,75,41,803
12746_Generalization.txt,1324,30,44,474,184,118,52,828
12747_GiaCarangi.txt,1787,72,24,627,273,92,81,1073
1274866_ValeriLobanovsky.txt,736,10,73,253,102,52,22,429
127501_JohnsburgNewYork.txt,637,11,57,222,56,30,3,311
127502_LakeLuzerneNewYork.txt,611,12,50,220,60,29,4,313
127520_ArcadiaNewYork.txt,755,16,47,282,69,36,7,394
127521_ButlerNewYork.txt,574,13,44,199,56,30,4,289
127523_GalenNewYork.txt,744,16,46,278,64,33,2,377
127524_HuronNewYork.txt,829,13,63,328,72,34,12,446
127535_OntarioNewYork.txt,747,16,46,269,75,36,5,385
127538_RoseNewYork.txt,634,12,52,224,67,29,7,327
127539_SavannahNewYork.txt,717,15,47,258,73,44,5,380
127541_WalworthNewYork.txt,633,14,45,217,69,31,5,322
127542_WilliamsonNewYork.txt,1391,26,53,507,160,77,30,774
127543_ArdsleyNewYork.txt,814,18,45,316,84,46,4,450
127544_ArmonkNewYork.txt,698,14,49,276,79,38,6,399
127545_BriarcliffManorNewYork.txt,1071,13,82,436,114,64,24,638
1276068_Azraelcomics.txt,951,12,79,297,169,65,45,576
1276354_JoshuaFalk.txt,637,10,63,285,58,41,16,400
1276358_ListOfNewYorkCentralRailroadPrecursors.txt,1094,28,39,825,36,16,1,878
1276360_AntoineCourtDeGbelin.txt,577,10,57,230,58,42,10,340
1277015_AccotzhaiSteeringLaw.txt,721,22,32,262,88,57,20,427
1277110_PaulEddington.txt,564,9,62,203,72,31,16,322
1277617_CharlesOakley.txt,999,17,58,392,116,56,29,593
1278226_AmaniToomer.txt,722,8,90,267,80,53,15,415
1278238_JohnShanks.txt,736,9,81,405,45,32,12,494
1278239_AirForceMetrologyAndCalibrationProgramOffice.txt,674,10,67,330,88,26,9,453
1278256_CapitalPunishmentInNewHampshire.txt,1498,26,57,564,222,75,21,882
1278543_HenryCort.txt,571,7,81,213,88,24,20,345
1278581_ChDasCaldeiras.txt,2080,35,59,756,264,214,65,1299
1278649_SaraPezzini.txt,1113,18,61,370,185,72,52,679
1280407_TheDickCavettShow.txt,1779,13,136,649,259,111,67,1086
1281454_ShinyEntertainment.txt,810,16,50,380,108,33,29,550
1281477_GregAlexander.txt,630,16,39,224,82,34,21,361
128167_LumbertonNorthCarolina.txt,776,17,45,282,114,39,12,447
128177_PembrokeNorthCarolina.txt,1368,22,62,566,138,101,22,827
1281795_AntichristianPrejudice.txt,1920,40,48,747,242,172,56,1217
1282411_OrthogonalInstructionSet.txt,1096,13,84,333,166,95,56,650
1282425_TheCricketOnTheHearth.txt,644,15,42,237,79,46,24,386
128276_ColumbiaNorthCarolina.txt,1393,28,49,561,169,107,18,855
128286_MonroeNorthCarolina.txt,580,12,48,197,71,31,6,305
1283011_Guardgrappling.txt,801,19,42,277,122,68,35,502
1283118_mobi.txt,786,15,52,266,129,78,34,507
1283751_DutchEmpire.txt,2393,97,24,901,225,184,53,1363
1284789_GaborASomorjai.txt,621,13,47,247,76,41,8,372
1284798_UniversityPhilosophicalSocietytrinityCollegeDublin.txt,1547,23,67,742,138,102,21,1003
1285129_AzerbaijanPeoplesGovernment.txt,600,10,60,241,70,54,16,381
128600_VelvaNorthDakota.txt,579,19,30,197,70,34,9,310
128607_Acadia.txt,882,15,58,363,102,67,19,551
128608_PopulationDensity.txt,646,19,34,268,76,61,25,430
1286970_WhitmellPTunstall.txt,656,16,41,272,78,23,14,387
1286976_LondonXi.txt,643,17,37,454,33,18,8,513
1286978_RateOfFire.txt,913,13,70,283,135,123,45,586
1286981_ListOfNotableMusicalTheatreProductions.txt,3960,9,440,2223,215,194,48,2680
1289152_WorldWildernessCongress.txt,667,40,16,333,43,52,6,434
1290092_NormanLowell.txt,660,17,38,267,93,45,12,417
1290093_Xenotime.txt,606,8,75,211,84,91,25,411
1290281_HoteliertvSeries.txt,660,19,34,320,89,29,14,452
1290303_HungarianMinorityInRomania.txt,3364,56,60,1160,412,331,113,2016
1290323_DunGene.txt,603,16,37,249,71,51,27,398
1290801_DavidRuffin.txt,1676,18,93,665,234,78,51,1028
1291763_Jawbreakerband.txt,1376,29,47,540,181,93,49,863
1291826_TheNflToday.txt,1237,29,42,560,119,47,27,753
1292447_DavidGraeber.txt,628,12,52,271,60,44,11,386
129246_TheLastEmperor.txt,1411,26,54,566,160,99,38,863
1292470_RevolvingRestaurant.txt,918,71,12,751,24,25,2,802
1292484_JapaneseAircraftCarrierRyj.txt,589,11,53,224,78,26,12,340
129249_PanblueCoalition.txt,879,8,109,296,116,70,32,514
129254_BexleyOhio.txt,1174,21,55,470,141,76,22,709
129259_GroveCityOhio.txt,841,21,40,334,98,56,12,500
129301_BeavercreekOhio.txt,665,15,44,238,85,40,7,370
129311_YellowSpringsOhio.txt,818,19,43,347,98,51,6,502
1293452_EasternProvincialAirways.txt,1283,18,71,496,155,105,42,798
129368_RainMan.txt,3018,48,62,1039,514,133,114,1800
1294628_CassetteScandal.txt,1283,25,51,471,231,86,36,824
1294640_DusMohamedAli.txt,1043,19,54,427,112,53,29,621
1295629_Majora.txt,3158,38,83,1047,488,195,156,1886
129670_MountGileadOhio.txt,593,13,45,222,73,32,3,330
1296807_ArnoldGesell.txt,689,11,62,282,84,40,14,420
1296834_TheAdventureOfTheCardboardBox.txt,577,9,64,188,86,45,22,341
129683_ZanesvilleOhio.txt,704,16,44,286,73,34,9,402
129695_PutinbayOhio.txt,886,16,55,342,97,58,18,515
129705_PauldingOhio.txt,1162,18,64,416,164,70,25,675
1297137_SheepShearing.txt,998,18,55,330,170,74,46,620
1297238_TopTrumps.txt,1102,26,42,430,137,84,39,690
1297796_OxygenMask.txt,1147,20,57,440,187,74,43,744
1297886_MorristownAndErieRailway.txt,1468,39,37,734,157,66,19,976
1298156_LeonidBorisovitchKogan.txt,655,13,50,238,73,46,22,379
1298350_LindaEllerbee.txt,606,17,35,301,53,28,8,390
1298976_AsbestosAndTheLaw.txt,2887,45,64,1143,389,170,86,1788
1298984_BlueSkiesfilm.txt,1318,29,45,542,153,70,38,803
1299122_IronMansong.txt,990,35,28,391,128,76,32,627
1300175_JimRaynor.txt,1642,28,58,603,228,71,58,960
1300181_LeamingtonSpaRailwayStation.txt,1279,18,71,502,142,73,52,769
1300341_NonhomologousEndJoining.txt,645,6,107,242,119,53,33,447
1301119_SuperMonkeyBall2.txt,3117,48,64,1049,473,190,110,1822
1301136_AlexandrOstrovsky.txt,565,6,94,221,56,46,19,342
1301139_AlGrassby.txt,950,16,59,379,123,49,21,572
1301141_TrapShooting.txt,2726,36,75,900,394,229,128,1651
1301153_RedDwarfCharacters.txt,6679,118,56,2400,1020,402,294,4116
1301165_BirminghamhoovercullmanCombinedStatisticalArea.txt,1079,17,63,514,107,84,33,738
1301307_TheWhistlingGypsy.txt,516,20,25,192,88,21,7,308
1301536_Platonomastics.txt,666,32,20,450,39,30,12,531
1301540_HumboldtMuseum.txt,781,14,55,269,82,75,30,456
1302380_HomoUniusLibri.txt,770,14,55,275,117,52,33,477
1302568_Nastran.txt,992,28,35,411,121,105,22,659
1303300_JohnAlexanderLowWaddell.txt,584,11,53,252,64,32,13,361
1303317_UssQueenfishss393.txt,1003,24,41,412,107,68,11,598
1303723_FabianDelPriore.txt,953,14,68,430,90,62,23,605
130447_DelCityOklahoma.txt,669,14,47,241,77,39,13,370
1305494_ThunderclapNewman.txt,804,13,61,292,101,66,25,484
1305681_WilliamAllenquaker.txt,1665,21,79,652,193,118,44,1007
1305702_GarychicagoInternationalAirport.txt,699,16,43,285,99,55,27,466
1306617_RonCarroll.txt,574,11,52,313,23,16,9,361
1306655_SergeantBenton.txt,787,16,49,349,85,33,26,493
1306661_YorkshireRegiment.txt,1316,21,62,725,83,64,19,891
1306936_JimHarbaugh.txt,828,16,51,330,93,39,13,475
130754_RoseburgOregon.txt,1139,28,40,451,135,59,18,663
130764_CanyonCityOregon.txt,604,13,46,196,76,25,7,304
1307860_HasdaiIbnShaprut.txt,1049,12,87,410,117,54,17,598
1307869_WilliamLever1stViscountLeverhulme.txt,927,15,61,373,114,50,31,568
130789_HoodRiverOregon.txt,658,20,32,246,68,39,8,361
130815_MedfordOregon.txt,1393,26,53,548,160,97,31,836
130826_GrantsPassOregon.txt,951,21,45,349,122,56,19,546
130832_KlamathFallsOregon.txt,1117,29,38,458,127,65,15,665
130837_CoburgOregon.txt,749,14,53,267,87,38,10,402
130838_CottageGroveOregon.txt,891,14,63,310,113,54,16,493
130839_CreswellOregon.txt,638,12,53,246,67,32,5,350
130841_FlorenceOregon.txt,917,18,50,347,102,43,11,503
130852_SpringfieldOregon.txt,1182,24,49,428,152,75,18,673
130862_ToledoOregon.txt,601,14,42,194,77,32,8,311
1308802_WrecklessEric.txt,754,19,39,384,61,32,11,488
1308826_BenjaminMazar.txt,1643,13,126,498,221,100,57,876
1308828_CentralizedTrafficControl.txt,1344,25,53,506,209,83,63,861
1309880_Live365.txt,657,15,43,270,93,49,14,426
1309883_SamUskiw.txt,749,12,62,268,102,38,23,431
1310418_CarbonLeaf.txt,982,28,35,498,106,49,14,667
1311098_ShortCircuit2.txt,1820,21,86,618,286,90,73,1067
1312064_Biolizard.txt,1113,14,79,392,171,56,49,668
13134_Gecko.txt,989,12,82,391,125,79,38,633
13135_GameShow.txt,2491,41,60,1266,223,153,72,1714
13137_Grindcore.txt,712,10,71,315,89,65,31,500
13141_GeorgeMargraveOfBrandenburgansbach.txt,1191,14,85,395,120,81,33,629
1314319_TheWeirdAlShow.txt,695,12,57,311,84,38,18,451
1315352_Phyrexia.txt,2118,35,60,667,366,180,98,1311
131540_NewtownBucksCountyPennsylvania.txt,685,14,48,256,83,42,12,393
1315553_AmericanTrustAndSavingsBank.txt,582,15,38,258,69,32,8,367
1316566_JanuszRadziwi16121655.txt,576,10,57,226,56,49,12,343
1316615_ZeSalmon.txt,690,16,43,258,108,27,29,422
1317736_ChristianDailly.txt,1065,25,42,377,140,69,50,636
1318097_WelchRegiment.txt,584,13,44,321,29,19,8,377
1319083_DougForrester.txt,963,17,56,396,143,37,33,609
131927_Halland.txt,1255,30,41,429,172,114,38,753
131928_Metic.txt,1351,14,96,387,205,136,61,789
131948_SligoPennsylvania.txt,612,13,47,208,75,36,11,330
131965_stersundMunicipality.txt,805,18,44,283,109,65,25,482
1319910_MusicCityMiracle.txt,733,14,52,268,96,46,30,440
1320925_Mojo.txt,562,32,17,197,84,27,21,329
1320954_Kobol.txt,1005,18,55,355,146,67,26,594
1321881_HistoryOfModernLiterature.txt,3905,111,35,1840,459,204,63,2566
1321906_MassachusettsStatePolice.txt,1381,23,60,626,151,100,40,917
1323035_Griefer.txt,1716,23,74,545,309,130,87,1071
1323060_BlacktuftedMarmoset.txt,930,15,62,348,108,90,49,595
1323096_TimMcilrath.txt,950,14,67,428,105,63,27,623
1323503_KichiKido.txt,679,8,84,241,84,38,19,382
1324462_JeffreySkoll.txt,752,16,47,306,99,53,16,474
1325265_Headbutt.txt,593,11,53,228,73,59,16,376
1325321_LimBoSeng.txt,927,19,48,344,107,75,34,560
132576_ChambersburgPennsylvania.txt,1024,23,44,431,106,50,13,600
1326282_ListOfMaleMixedMartialArtists.txt,1158,27,42,1109,3,14,1,1127
1327403_CharlesLawrence.txt,925,13,71,321,129,61,23,534
1327443_WesternWarriors.txt,1031,15,68,667,33,23,7,730
1327491_NationalSocietyOfBlackEngineers.txt,628,9,69,265,80,43,17,405
1327495_Sziget.txt,814,11,74,478,56,43,14,591
1328452_AnneCharleston.txt,861,21,41,336,112,63,31,542
1328466_PKVasudevanNair.txt,655,9,72,251,74,33,11,369
1328476_A5Juggernaut.txt,1014,12,84,327,133,95,71,626
1329581_NegurBunget.txt,549,10,54,264,41,31,3,339
1329587_SidneyFreedman.txt,622,9,69,203,108,42,31,384
1329601_FreedomCity.txt,909,10,90,448,57,112,22,639
1329694_ListOfEnglishWordsOfOldNorseOrigin.txt,806,31,26,380,69,66,15,530
132982_AllentownPennsylvania.txt,3730,91,40,1795,372,272,68,2507
132984_CatasauquaPennsylvania.txt,922,22,41,343,114,60,13,530
132987_EmmausPennsylvania.txt,1274,38,33,509,149,91,16,765
1329993_JacopoMazzoni.txt,1519,24,63,592,170,104,61,927
133001_SchnecksvillePennsylvania.txt,718,16,44,269,80,43,11,403
1330059_MaryYoungPickersgill.txt,591,10,59,234,78,36,10,358
133011_WhitehallTownshipPennsylvania.txt,1205,28,43,596,94,66,13,769
133015_BackMountainPennsylvania.txt,899,12,74,343,91,83,15,532
133017_SecondLawOfThermodynamics.txt,3302,85,38,1051,420,340,145,1956
133039_FortyFortPennsylvania.txt,680,14,48,242,75,53,8,378
133040_JudicialReview.txt,1813,27,67,584,256,174,58,1072
1330657_AmateurAndProfessionalCricketers.txt,879,10,87,262,122,92,49,525
1330842_BenefitSeason.txt,725,8,90,207,111,63,40,421
1331235_ParentalControls.txt,1008,8,126,369,143,77,43,632
1331969_CultureOfAncientRus.txt,1849,19,97,699,184,169,67,1119
1332346_1932WorldSeries.txt,1016,21,48,432,138,37,23,630
1332383_1914WorldSeries.txt,771,19,40,328,72,50,19,469
1333969_DoomsdayBooknovel.txt,738,12,61,205,116,61,44,426
1333980_UssFanningdd37.txt,624,10,62,247,81,30,6,364
1334155_ManolisGlezos.txt,1080,9,120,356,121,43,29,549
1334520_FamousMonstersOfFilmland.txt,670,12,55,254,77,54,20,405
1335109_KingJamesVersionalbum.txt,538,15,35,330,27,25,6,388
1335110_MgZs.txt,641,14,45,234,89,42,18,383
1335477_AnalogPussy.txt,614,10,61,251,79,40,10,380
1335522_ConsiderationUnderEnglishLaw.txt,2549,38,67,809,459,157,91,1516
1336325_FortunaSittard.txt,603,17,35,288,59,43,19,409
1336512_PersonalComputerGame.txt,3132,58,54,1180,427,335,140,2082
1336514_Mostek.txt,946,16,59,317,136,73,31,557
1337332_HistoryOfTheJewsInLatinAmerica.txt,1687,45,37,633,185,132,53,1003
1337682_TheSecretHistoryOfTheMongols.txt,1181,22,53,383,171,83,36,673
1338505_ListOfIntegratedDevelopmentEnvironments.txt,1766,23,76,866,191,156,35,1248
1338521_WickHighland.txt,1620,49,33,673,214,90,43,1020
1338540_SandalCastle.txt,1162,15,77,399,166,63,35,663
1338681_PortmanRoad.txt,1294,30,43,506,151,80,48,785
1339472_BorisThomashefsky.txt,851,13,65,321,106,56,35,518
1339476_GiovanniCroce.txt,690,13,53,254,66,59,28,407
1339512_LicoReyes.txt,1108,11,100,437,138,76,34,685
1339560_StephenGuernseyCookEnsko.txt,1222,15,81,552,127,52,28,759
1339855_FairchildHillerFh227.txt,571,18,31,243,49,37,8,337
1340054_ListOfIslamicAndMuslimRelatedTopics.txt,3051,30,101,2605,22,102,5,2734
1340719_ParticleBoard.txt,1596,38,42,495,304,164,95,1058
134086_WashingtonPennsylvania.txt,1080,25,43,385,129,75,12,601
134105_HonesdalePennsylvania.txt,1332,26,51,523,169,88,17,797
1342693_HectorLuisBustamante.txt,545,16,34,228,63,43,13,347
1342698_Aceydeucey.txt,685,9,76,182,110,56,28,376
1342905_JeopardyUltimateTournamentOfChampions.txt,574,23,24,209,79,32,9,329
1343866_ModelbasedTesting.txt,1511,18,83,596,237,127,51,1011
1345030_NypdRodmansNeckFiringRange.txt,805,16,50,357,125,26,25,533
1346094_JohnKStewart.txt,732,14,52,339,87,28,12,466
1346197_CrawfordVWashington.txt,1310,29,45,455,233,82,50,820
1347058_RolandJupiter8.txt,618,12,51,238,71,72,23,404
1347173_MichaRolaymierski.txt,575,6,95,206,61,37,12,316
1347221_BritishAirwaysFlight5390.txt,893,19,47,365,118,48,32,563
134799_CusterSouthDakota.txt,727,16,45,268,78,52,11,409
1348229_Xmms2.txt,1150,16,71,389,196,94,54,733
1348586_2005InSwitzerland.txt,982,23,42,566,8,85,6,665
1348590_TheProtector1985Film.txt,734,16,45,261,118,56,32,467
1348660_CanadianHipHop.txt,929,16,58,370,110,96,38,614
1348780_QueenOfTheSeaTrainDisaster.txt,779,13,59,246,124,43,40,453
1348785_TheLibrarianQuestForTheSpear.txt,788,14,56,305,102,54,24,485
1349427_GerryMcnamara.txt,1267,29,43,518,142,70,24,754
1349446_2005InGayRights.txt,1218,16,76,566,130,101,19,816
1350792_GaziYasargil.txt,997,15,66,468,56,66,6,596
1350962_TemasekJuniorCollege.txt,2782,69,40,1094,350,197,95,1736
1350979_TimeOut.txt,639,10,63,275,85,38,25,423
1351574_BloomsburgUniversityOfPennsylvania.txt,1364,28,48,588,139,83,32,842
1351617_PeterMay.txt,554,19,29,208,58,33,13,312
135176_EstillSpringsTennessee.txt,805,17,47,252,108,49,23,432
135179_WinchesterTennessee.txt,625,18,34,231,70,31,8,340
135184_MilanTennessee.txt,1768,35,50,764,228,110,41,1143
135186_TrentonTennessee.txt,602,15,40,214,69,33,9,325
1352564_MachineThatAlwaysHalts.txt,872,16,54,305,108,82,44,539
1354745_CarlesPuyol.txt,560,17,32,222,66,34,12,334
1354747_EffectOfThe2004IndianOceanEarthquakeOnIndonesia.txt,2375,42,56,841,379,156,96,1472
1354749_JhBinfordPeayIii.txt,799,13,61,392,63,34,8,497
1354905_NozomiTsuji.txt,701,16,43,273,80,55,20,428
1355869_NumbuhOne.txt,2615,47,55,1021,388,169,97,1675
1355873_EmdF7.txt,868,17,51,322,118,97,38,575
1356363_Dakini.txt,652,12,54,257,75,44,19,395
1356456_SouthAfricaAndWeaponsOfMassDestruction.txt,2056,26,79,774,309,158,57,1298
1357093_SeventhDoctor.txt,1504,29,51,631,178,70,61,940
1357108_CoercivePersuasion.txt,803,11,73,407,67,69,13,556
1357327_ChildJesus.txt,845,11,76,308,102,58,27,495
1357405_Wzzmtv.txt,2461,52,47,1099,242,155,56,1552
1358059_DavidOgilvy.txt,1089,17,64,385,145,77,29,636
1358094_March2005InScience.txt,1304,25,52,558,162,91,22,833
135822_ClintTexas.txt,987,14,70,305,132,51,19,507
135823_ElPasoTexas.txt,6156,107,57,3053,618,354,111,4136
135825_FortBliss.txt,4027,48,83,1625,514,229,87,2455
135844_MidlothianTexas.txt,844,19,44,310,97,72,15,494
135886_FresnoTexas.txt,1109,24,46,407,134,66,27,634
1359290_Jakubwinka.txt,1709,17,100,742,182,91,55,1070
1359316_CoenraadJohannesVanHouten.txt,571,9,63,219,80,34,26,359
135949_ShermanTexas.txt,629,18,34,229,80,31,6,346
135952_TomBeanTexas.txt,865,20,43,314,112,52,20,498
1360014_LadellBetts.txt,841,18,46,291,117,49,22,479
1360740_SamRockwell.txt,834,10,83,355,89,69,22,535
1360769_UnitedStatesNavalSeaCadetCorps.txt,1534,23,66,689,176,89,31,985
1360807_MarkMallochBrown.txt,1213,19,63,495,141,73,20,729
1361149_LanguageContact.txt,1276,22,58,434,177,150,67,828
136278_LometaTexas.txt,621,17,36,223,70,30,9,332
136282_ShinerTexas.txt,565,12,47,254,53,23,3,333
136283_GiddingsTexas.txt,1111,20,55,405,143,64,18,630
136291_ClevelandTexas.txt,691,18,38,253,85,41,10,389
136293_DaytonTexas.txt,1190,15,79,447,145,58,20,670
136298_LibertyTexas.txt,1641,16,102,606,198,82,20,906
1363007_SuperMario128.txt,2692,57,47,815,416,160,150,1541
1363010_JaniceNicolich.txt,2697,16,168,758,488,111,120,1477
136313_ThreeRiversTexas.txt,1119,21,53,389,143,72,30,634
1363321_Kcbstv.txt,1520,24,63,684,130,103,30,947
1363328_CaliforniaStateRoute39.txt,624,13,48,250,74,31,26,381
1363329_ElizabethHoltzman.txt,735,10,73,312,87,44,14,457
1363333_AustralianRepublicReferendum1999.txt,1682,30,56,486,245,178,79,988
1363334_ListOfRevivedLanguages.txt,1527,34,44,513,211,158,61,943
1363412_Vfa103.txt,2772,27,102,1070,348,144,74,1636
1363946_MasterCorporal.txt,643,12,53,277,59,50,20,406
1364160_ArProvince.txt,625,17,36,236,75,54,17,382
1364362_GhostLightdoctorWho.txt,1302,15,86,495,195,81,33,804
1364528_Wusc.txt,747,11,67,285,89,62,24,460
1365140_GrandDukeNicholasNikolaevichOfRussia18311891.txt,1146,24,47,428,152,65,36,681
1365485_TheWestEndrichmondVirginia.txt,1027,28,36,602,67,55,29,753
1365514_HaunsMillMassacre.txt,681,12,56,261,103,42,12,418
1365587_JrgenMoe.txt,603,11,54,197,76,53,30,356
1365595_CovenantElite.txt,3047,28,108,989,450,280,155,1874
1365692_ColinMarshallBaronMarshallOfKnightsbridge.txt,777,13,59,309,86,34,13,442
1368338_Badlapur.txt,1405,28,50,568,178,102,42,890
1368914_PaleSaints.txt,1174,23,51,519,128,77,29,753
1368928_Mirpur.txt,1395,16,87,508,183,112,53,856
136908_BurlingtonTownshipNewJersey.txt,597,14,42,259,52,25,4,340
136910_EveshamTownshipNewJersey.txt,886,23,38,381,94,43,12,530
136913_HainesportTownshipNewJersey.txt,567,14,40,221,57,28,4,310
136920_MedfordNewJersey.txt,1826,30,60,752,231,81,34,1098
136923_MedfordLakesNewJersey.txt,924,21,44,373,105,43,10,531
1369583_Diamondbackcomics.txt,588,10,58,219,90,34,18,361
136974_AtlanticHighlandsNewJersey.txt,581,17,34,224,59,38,2,323
136982_HolmdelTownshipNewJersey.txt,983,25,39,409,93,58,8,568
136984_Bookbinding.txt,2780,57,48,864,480,230,147,1721
1369851_RupertBaxter.txt,846,15,56,291,126,45,30,492
136985_JeffersonTownshipNewJersey.txt,735,18,40,308,80,34,6,428
1371097_Maues.txt,625,17,36,258,84,37,23,402
1371114_BlackScreenOfDeath.txt,667,14,47,228,95,48,21,392
1371761_FaculdadeDeMedicinaDeRibeiroPreto.txt,820,16,51,359,60,75,7,501
137327_AmusementPark.txt,1559,25,62,633,184,125,75,1017
137347_StoweVermont.txt,605,10,60,219,67,40,14,340
137360_TunbridgeVermont.txt,1667,33,50,733,176,98,29,1036
137385_BensonVermont.txt,1831,28,65,733,200,135,68,1136
137386_CastletonVermont.txt,1040,14,74,383,121,76,7,587
1374225_Winds.txt,990,23,43,441,88,65,28,622
1374397_DioceseOfStAsaph.txt,904,9,100,354,95,54,25,528
1375023_MattUrban.txt,997,12,83,407,131,59,24,621
1375382_Changquan.txt,828,22,37,450,62,79,21,612
1375421_PowerPlaytngEpisode.txt,780,10,78,275,116,36,25,452
1375468_OscarsborgFortress.txt,973,14,69,326,145,69,40,580
1376056_GranadaStudiosTour.txt,855,15,57,327,123,61,20,531
1376426_ChrisBachalo.txt,971,20,48,377,127,81,41,626
1376598_BmcBseriesEngine.txt,1120,42,26,512,98,45,14,669
1377168_NeutronStarstory.txt,825,11,75,300,114,51,25,490
1377267_UssMcgintyde365.txt,1238,17,72,497,132,57,14,700
1377542_ListOfSchoolsInMalaysia.txt,3639,22,165,3370,6,40,24,3440
1377591_MortKondracke.txt,574,13,44,263,60,26,12,361
13790_HashFunction.txt,1551,29,53,571,233,159,82,1045
13791_HighJump.txt,1571,25,62,640,201,120,39,1000
13792_Heraclitus.txt,1740,30,58,674,222,117,68,1081
13793_HarrisonSchmitt.txt,665,14,47,262,83,29,19,393
1379414_HughOfItaly.txt,689,10,68,234,90,43,28,395
13794_Homelessness.txt,4093,61,67,1597,490,377,139,2603
13801_HistoryOfPalestine.txt,5262,105,50,2082,613,313,142,3150
138053_SilverdaleWashington.txt,613,11,55,214,70,39,9,332
13805_Hohenstaufen.txt,1629,20,81,593,206,110,47,956
13806_HistoryOfMalaysia.txt,8398,70,119,2906,1152,735,293,5086
138071_LyleWashington.txt,627,13,48,194,81,49,12,336
138077_CentraliaWashington.txt,912,19,48,334,107,55,12,508
13808_HistoryOfIsrael.txt,8888,112,79,3443,1003,643,247,5336
1380947_Sullia.txt,907,24,37,445,93,71,8,617
13810_HarveyMuddCollege.txt,2558,37,69,1046,293,171,82,1592
13812_HistoryOfLibya.txt,1340,24,55,510,183,91,31,815
13813_HistoryOfAfghanistan.txt,4264,58,73,1741,478,294,113,2626
138141_FifeWashington.txt,793,16,49,276,92,54,17,439
13814_HistoryOfModernGreece.txt,3992,38,105,1486,584,270,106,2446
13815_Heracles.txt,3604,49,73,1270,549,200,103,2122
1381930_MorrisDay.txt,763,17,44,316,99,66,25,506
1382023_QuarticInteraction.txt,985,83,11,329,131,93,43,596
1382092_AfghanistanTimelineJuly2004.txt,1199,24,49,513,157,61,30,761
1382097_CardinalinfanteFerdinand.txt,1388,20,69,452,189,106,65,812
13820_HenryRollins.txt,2886,43,67,1341,246,151,51,1789
13828_BritishHouseOfCommons.txt,7788,75,103,2727,1043,462,351,4583
13829_Hearts.txt,5517,9,613,1482,964,401,255,3102
13830_Hastings.txt,3234,56,57,1360,398,231,102,2091
13831_HumanRights.txt,4232,59,71,1707,481,406,122,2716
13834_HelloWorldProgram.txt,550,12,45,224,58,45,20,347
1384091_TheElectrifyingMojo.txt,1510,21,71,534,179,115,62,890
1384140_PassengerNameRecord.txt,981,16,61,374,131,78,37,620
138419_BridgeportWestVirginia.txt,937,21,44,355,118,49,16,538
138420_ClarksburgWestVirginia.txt,880,18,48,359,102,52,5,518
138430_RavenswoodWestVirginia.txt,720,17,42,284,82,32,6,404
138434_RipleyWestVirginia.txt,679,16,42,251,84,29,6,370
138436_CharlesTownWestVirginia.txt,807,35,23,305,87,42,10,444
138438_ShepherdstownWestVirginia.txt,1303,27,48,522,153,84,22,781
138460_WestonWestVirginia.txt,684,36,19,334,51,31,5,421
1384931_EstablishmentClauseOfTheFirstAmendment.txt,2205,25,88,796,278,153,82,1309
1384943_SafeSexMakespan.txt,682,16,42,218,101,57,34,410
13849_HouseOfHohenzollern.txt,1064,28,38,414,86,63,27,590
138518_FortAshbyWestVirginia.txt,2849,37,77,937,424,159,90,1610
138519_KeyserWestVirginia.txt,697,15,46,248,89,31,11,379
1385251_WeddingCrashers.txt,1092,15,72,451,135,57,37,680
13854_HistoryOfFrance.txt,5143,64,80,2003,644,370,148,3165
13855_Halloween.txt,7346,93,78,2586,1033,596,311,4526
13860_HahnbanachTheorem.txt,576,14,41,217,63,38,24,342
13861_Hampshire.txt,2747,42,65,1079,302,221,58,1660
1386310_ProtestantismInBulgaria.txt,595,7,85,209,69,48,9,335
1386469_NosemaApis.txt,646,9,71,238,112,53,27,430
13867_HaroldHolt.txt,5153,94,54,1927,689,347,135,3098
13869_HeavyMetalMusic.txt,5805,72,80,2199,687,668,251,3805
13871_HereticsOfDune.txt,3131,32,97,1088,515,156,122,1881
13873_Halakha.txt,7529,96,78,2736,958,630,333,4657
13876_HistoryOfAncientIsraelAndJudah.txt,4772,69,69,1885,606,269,134,2894
13877_ListOfKingsOfPersia.txt,2772,64,43,1413,147,122,27,1709
13879_HenryJHeinz.txt,570,10,57,220,76,26,10,332
1388288_Wibro.txt,674,14,48,313,67,31,8,419
13883_HuffmanCoding.txt,2465,42,58,902,332,228,87,1549
13885_HighDensityLipoprotein.txt,1246,19,65,434,157,155,63,809
13887_HonoluluHawaii.txt,3227,57,56,1512,283,202,74,2071
13890_HistoryOfIndia.txt,8473,143,59,3200,963,692,235,5090
1389115_MonkcharacterClass.txt,856,20,42,340,114,58,37,549
1389125_ResidenceLife.txt,706,11,64,294,68,75,23,460
13891_Highlanderseries.txt,1777,44,40,621,245,132,64,1062
1389320_GasInAHarmonicTrap.txt,865,48,18,298,116,65,21,500
13894_HoustonAstros.txt,6412,90,71,2419,779,391,200,3789
13895_HalClement.txt,660,12,55,288,51,45,13,397
1389661_MembersOfTheTennisHallOfFamealphabetical.txt,1241,38,32,680,0,8,1,689
1389674_YorkRoadRailwayStation.txt,900,10,90,335,119,55,32,541
13896_HalldrLaxness.txt,1595,19,83,610,161,180,44,995
1389700_PurushottamNageshOak.txt,1155,22,52,508,156,49,28,741
1390283_DiffuseInterstellarBand.txt,897,18,49,323,114,92,40,569
1390627_SealOfNewHampshire.txt,642,11,58,252,86,31,15,384
1390657_JoshuaDaviswebDesigner.txt,877,17,51,368,108,68,19,563
13911_Harp.txt,5261,67,78,1807,673,493,220,3193
13912_HollowEarth.txt,3995,59,67,1672,439,291,132,2534
139176_Citystate.txt,1410,26,54,536,158,135,50,879
139177_NikolaiGogol.txt,3210,41,78,1011,453,274,140,1878
1391811_SaskatchewanOrderOfMerit.txt,543,30,18,393,23,17,5,438
1391813_ImpellerDrive.txt,776,12,64,248,120,69,41,478
1391825_InterplanetaryInternet.txt,1092,17,64,451,120,112,19,702
139229_GaussbonnetTheorem.txt,760,10,76,215,86,98,29,428
1392449_MaputoBay.txt,885,10,88,362,93,36,21,512
1392450_AirChinaFlight129.txt,575,10,57,235,65,28,13,341
1392461_PatObrientelevision.txt,587,13,45,271,66,33,21,391
1393014_NorwegianChurchAid.txt,1034,19,54,384,133,116,17,650
1393046_Agarwood.txt,960,16,60,379,119,68,36,602
1393667_UssS48ss159.txt,980,11,89,343,158,30,21,552
1394652_BayazidBastami.txt,699,11,63,243,109,36,27,415
139520_MequonWisconsin.txt,954,19,50,322,108,63,21,514
139599_ParkFallsWisconsin.txt,897,20,44,318,111,79,20,528
1396135_Parzival.txt,1431,17,84,539,166,77,56,838
1396150_ActiveRadarHoming.txt,717,10,71,202,114,72,44,432
1396187_Grendon.txt,1273,34,37,503,157,70,19,749
1396913_MarsAnalogueResearchStationProgramme.txt,983,19,51,375,130,78,23,606
1396914_Arreton.txt,670,19,35,258,89,36,13,396
1397193_RTudurJones.txt,648,8,81,242,79,31,19,371
1397219_MacedonianCultureslavic.txt,1672,17,98,640,193,150,54,1037
1397357_FireTeamCharlie.txt,2445,10,244,857,399,118,80,1454
1397380_ManuelMarulanda.txt,854,16,53,333,98,58,30,519
1397383_RubyGoldstein.txt,655,11,59,230,113,35,31,409
1398326_Jenova.txt,2596,26,99,850,399,155,106,1510
1398330_RussellCooper.txt,971,12,80,351,142,70,18,581
1398427_BlueSubmarineNo6.txt,2066,34,60,712,313,128,49,1202
1398430_CatherineUhlmyer.txt,732,10,73,275,103,30,16,424
1399393_InstitutNationalPolytechniqueDeGrenoble.txt,811,27,30,396,73,74,14,557
1399590_HistoryOfTheJewsInIndia.txt,911,19,47,394,92,67,35,588
1400114_DemetriusIiOfIndia.txt,574,13,44,205,102,34,33,374
1400125_ThomasJWatsonResearchCenter.txt,572,17,33,292,56,26,14,388
1400694_JeffPurvis.txt,2143,28,76,694,283,155,84,1216
1401333_MusicOfKarnataka.txt,954,14,68,425,110,51,24,610
1401670_ClanMackay.txt,5397,52,103,2159,699,231,110,3199
1401727_HumanMitochondrialGenetics.txt,2827,23,122,1048,357,286,88,1779
1401760_Shanshan.txt,731,12,60,332,63,44,11,450
140254_Tyranids.txt,5231,73,71,1802,755,516,236,3309
140256_Ebonics.txt,779,16,48,297,96,74,25,492
140257_Emperorband.txt,1294,34,38,576,144,76,37,833
1403853_GrandTheftAutoSanAndreasSoundtrack.txt,4258,61,69,2208,383,216,95,2902
1403903_FlamingPie.txt,622,9,69,256,71,32,21,380
1403932_PolymerBanknote.txt,1989,59,33,750,270,152,50,1222
1404896_TaxicabsOfHongKong.txt,804,22,36,306,129,58,32,525
1404898_KashGill.txt,625,21,29,262,78,44,25,409
1404900_TedRadcliffe.txt,2282,26,87,1007,241,122,36,1406
1405065_UssGermantown1846.txt,964,11,87,424,117,32,15,588
1405070_PuntaDelEste.txt,746,10,74,364,69,51,24,508
1405072_Polyglycolide.txt,1064,14,76,354,186,117,44,701
1406081_RecombinationFrequency.txt,742,13,57,272,102,55,24,453
1406132_UssS18ss123.txt,746,23,32,282,83,54,14,433
140670_AlfredDelp.txt,855,16,53,357,92,32,24,505
140672_GoldRush.txt,1506,31,48,635,130,126,56,947
140683_Agathias.txt,695,10,69,278,65,51,17,411
140687_HundredFlowersCampaign.txt,1174,14,83,390,180,104,37,711
140697_TorpedoTube.txt,978,17,57,391,117,69,21,598
140716_GordianI.txt,584,16,36,202,84,60,15,361
1407267_CityOfVillains.txt,1344,28,48,533,163,103,26,825
1407276_BrunswickEastVictoria.txt,992,25,39,437,92,71,26,626
1407289_TomManley.txt,773,15,51,317,84,55,15,471
1408020_CashlandrumIncident.txt,1542,32,48,572,237,101,51,961
1408199_GeorgeStephen1stBaronMountStephen.txt,572,12,47,222,70,38,12,342
1408215_TrungDung.txt,340,10,34,174,36,14,7,231
1408239_NationalStudentTelevisionAssociation.txt,1256,25,50,593,144,86,31,854
1408983_Hill.txt,904,24,37,313,121,85,35,554
1409065_Jamnagar.txt,1009,25,40,386,142,56,31,615
1409438_MiddleAgesInFilm.txt,852,12,71,395,74,63,24,556
1409458_Consociationalism.txt,1238,24,51,418,179,135,55,787
1409469_Lunatone.txt,931,17,54,384,109,93,27,613
1410371_Wlol.txt,631,12,52,245,79,43,11,378
1410397_MassoudBehnoud.txt,699,13,53,258,85,45,21,409
1411431_Kohat.txt,692,29,23,388,62,25,12,487
1411599_WontGetFooledAgain.txt,955,20,47,345,122,81,30,578
1411613_LakeJacksonMoundsArchaeologicalStatePark.txt,631,9,70,241,92,40,11,384
1412398_Sax.txt,670,6,111,224,110,45,25,404
1412416_FixedExchangeRate.txt,578,9,64,213,93,51,21,378
1412555_BrotherTheodore.txt,1062,13,81,367,134,50,39,590
1412580_ScienceOfPhotography.txt,2136,42,50,672,311,231,90,1304
141338_Etymologiae.txt,630,8,78,294,76,34,20,424
1413772_DarkBeast.txt,820,15,54,286,121,61,24,492
1413774_MkraanCrystal.txt,841,11,76,266,138,63,23,490
1413798_MvAurora.txt,882,13,67,295,151,36,28,510
1414381_AlfredGGilman.txt,813,32,25,412,47,41,6,506
1414736_MidnightTides.txt,1095,13,84,389,174,48,45,656
1414739_DaughtersOfTheMoon.txt,2476,55,45,776,388,116,92,1372
1414852_CanadianTaxpayersFederation.txt,774,17,45,342,89,62,15,508
1414853_Stobi.txt,1439,21,68,511,181,133,31,856
1415802_Leningradband.txt,362,8,45,159,34,24,7,224
1417121_ListOfCriminologyTopics.txt,1484,26,57,674,45,208,6,933
141738_CometHyakutake.txt,2187,32,68,658,340,193,112,1303
141757_MarshfieldWisconsin.txt,1085,22,49,471,100,65,18,654
1418089_Twitches.txt,1189,21,56,391,202,80,56,729
1418090_OldStateHouseboston.txt,915,14,65,392,105,53,17,567
1418182_DinosaursOfTheIsleOfWight.txt,556,20,27,226,59,45,20,350
1419138_UssStephenPotterdd538.txt,1547,25,61,586,211,62,25,884
1419153_SilentAlarmalbum.txt,800,10,80,374,77,32,13,496
1419154_VermontLocationsByPerCapitaIncome.txt,1242,6,207,643,8,5,0,656
1420353_BengalFamineOf1943.txt,1747,37,47,629,230,107,58,1024
1420896_DamdamiTaksal.txt,810,10,81,352,115,30,18,515
1421089_Rhydon.txt,1317,16,82,509,168,129,58,864
1421315_WelfareCapitalism.txt,651,10,65,310,63,56,23,452
1421326_DragonBallZBudokai.txt,1263,16,78,549,159,61,38,807
1421336_ThornleaSecondarySchool.txt,2142,19,112,812,252,212,93,1369
1422050_TimelineOfMiddleEasternHistory.txt,1641,39,42,876,118,77,14,1085
1422095_TheJunkies.txt,3834,94,40,1419,535,239,146,2339
14220_HistoryOfMathematics.txt,6542,90,72,2326,808,651,201,3986
1422476_PlacentalAbruption.txt,773,20,38,276,109,69,23,477
1422477_DanceDanceRevolution5thmix.txt,1531,26,58,603,179,114,35,931
1422478_GurindjiStrike.txt,2214,70,31,790,311,163,78,1342
14225_HydrogenAtom.txt,1711,30,57,570,218,200,58,1046
1422621_FujiRockFestival.txt,682,21,32,308,70,46,23,447
1422649_GreatFamineOf13151317.txt,1670,30,55,522,230,137,65,954
14227_Elagabalus.txt,2759,36,76,1091,352,185,70,1698
1423587_UssLackawanna1862.txt,642,10,64,266,83,24,13,386
1423593_HansDevice.txt,666,6,111,250,85,38,33,406
1423602_Eggcorn.txt,671,9,74,266,53,58,43,420
1423633_RussianOrthodoxDioceseOfSourozh.txt,6870,87,78,2410,830,368,238,3846
1423636_KaleidaLabs.txt,2041,25,81,855,291,129,67,1342
142412_QuizShow.txt,1733,21,82,688,243,75,60,1066
1424227_BritishColumbiaGeneralElection1920.txt,693,19,36,314,33,31,9,387
1424286_BritishColumbiaGeneralElection1909.txt,610,14,43,254,21,21,9,305
142431_Homologybiology.txt,1071,26,41,363,166,123,36,688
142432_Homologymathematics.txt,851,32,26,304,90,75,25,494
142434_FentonCrackshell.txt,1320,16,82,470,218,90,71,849
142435_JerryMaguire.txt,1448,17,85,583,188,85,43,899
142473_Plantation.txt,2425,38,63,811,384,265,116,1576
142475_Papermaking.txt,1899,25,75,580,325,171,89,1165
142477_MassimoTroisi.txt,831,12,69,377,84,48,23,532
1424861_CaThayer1895.txt,726,14,51,300,85,31,21,437
1425775_JanDegaetani.txt,661,8,82,332,36,42,13,423
1426993_Biyomon.txt,871,23,37,309,130,51,30,520
1427626_ChristiernPedersen.txt,868,17,51,321,102,64,36,523
1427957_IrtFlushingLine.txt,3285,37,88,1365,391,178,97,2031
1428048_TheLastOfTheMohicans1992Film.txt,1707,21,81,608,266,114,55,1043
1428049_Yellowsong.txt,585,21,27,212,90,44,23,369
142829_PointOfNoReturn.txt,1262,25,50,373,189,98,72,732
142834_WallaceBeery.txt,1586,16,99,803,99,64,26,992
142840_Promethea.txt,2092,24,87,867,237,154,62,1320
142841_RonaldColman.txt,587,9,65,264,39,21,4,328
142849_JulioCesarChavezVsMeldrickTaylor.txt,1580,16,98,443,272,121,84,920
14285_HistoryOfScienceAndTechnology.txt,1422,11,129,711,103,56,15,885
142864_ErikEstrada.txt,882,16,55,432,73,41,15,561
142867_Ferret.txt,5613,100,56,1822,926,521,314,3583
142868_MussarMovement.txt,1580,26,60,651,162,126,43,982
14286_HolographicPrinciple.txt,828,21,39,279,94,79,38,490
142883_RjReynoldsTobaccoCompany.txt,718,19,37,321,90,50,15,476
142884_NichirenShsh.txt,3960,44,90,1500,503,278,118,2399
142887_Daimoku.txt,1007,23,43,427,102,59,34,622
1429165_HypeWilliams.txt,1829,26,70,1151,79,54,30,1314
1429171_CaitlnRKiernan.txt,1849,29,63,1075,97,66,22,1260
1429616_FormulaD.txt,1150,19,60,357,187,78,47,669
1429635_EastLondonEngland.txt,919,18,51,432,103,45,33,613
1429829_FsoCarFactory.txt,902,19,47,310,145,66,45,566
1429832_EgonFriedell.txt,1227,17,72,489,169,59,30,747
1430128_CarryOnUpTheKhyber.txt,987,12,82,365,148,53,30,596
1430229_LondonsBurning.txt,941,12,78,341,127,67,29,564
1431180_RonaldIsley.txt,1037,14,74,402,128,61,25,616
1431297_TheBourneLegacy.txt,935,23,40,320,152,42,53,567
1431938_HistoryOfHamiltonOntario.txt,5286,78,67,2248,564,400,159,3371
1432362_MichaelWaltrip.txt,1598,24,66,696,170,72,29,967
1433534_GregGumbel.txt,815,14,58,384,94,29,18,525
1434010_ProStock.txt,709,14,50,267,99,60,27,453
1434495_SuccessionCrisislatterDaySaints.txt,5092,59,86,1927,748,217,156,3048
143500_AutomobileSelfStarter.txt,982,17,57,341,153,87,41,622
143527_PoliticsOfEdinburgh.txt,1953,54,36,853,198,118,26,1195
143563_Lewis.txt,915,16,57,437,97,43,15,592
143565_Harris.txt,661,16,41,284,69,46,21,420
1435704_DonBoscoTechnicalInstitute.txt,1315,24,54,565,164,86,35,850
1435706_Cabergoline.txt,823,14,58,327,107,87,38,559
1435715_AdxFlorence.txt,1314,22,59,538,173,96,34,841
1435740_WedgetailedShearwater.txt,962,11,87,369,132,78,34,613
1436399_OperationalWarfare.txt,600,8,75,204,74,70,15,363
1436403_DreamEvil.txt,771,18,42,294,111,49,25,479
1436690_ManitobaBandOperatedSchools.txt,868,4,217,626,33,22,13,694
1436726_Sudharmono.txt,1501,31,48,571,223,61,47,902
1437337_CharlesHerbertMayo.txt,882,9,98,503,48,28,5,584
1438514_Shooto.txt,888,17,52,436,107,62,21,626
1438859_SandiPatty.txt,1102,11,100,447,116,47,27,637
1438861_TheThirteenthFloor.txt,956,10,95,350,139,47,37,573
1439045_Powervr.txt,1301,36,36,614,172,77,42,905
1439049_BritishRailClass37.txt,1370,28,48,457,192,121,52,822
1439081_FacialActionCodingSystem.txt,549,10,54,271,64,27,18,380
143914_Fulham.txt,915,21,43,396,92,52,21,561
143924_MakeMoneyFast.txt,672,14,48,227,117,43,30,417
143930_TreatyPorts.txt,1106,16,69,431,75,156,34,696
143938_DanielQuinn.txt,596,16,37,247,72,44,18,381
143945_RackRailway.txt,1776,58,30,783,204,133,66,1186
143952_Alphavillefilm.txt,1185,24,49,438,162,71,51,722
1439540_TrentDilfer.txt,1364,23,59,521,166,72,32,791
143976_nima.txt,1185,14,84,485,139,70,34,728
143977_BurgessHill.txt,1884,44,42,823,230,109,51,1213
1440016_HardboiledWonderlandAndTheEndOfTheWorld.txt,1086,19,57,356,141,86,31,614
1440034_TheWindupBirdChronicle.txt,1155,17,67,367,178,88,53,686
1440762_Undergrads.txt,3428,37,92,1049,529,240,251,2069
1441712_VancouverAquarium.txt,1541,24,64,518,237,121,70,946
1442281_ElectionsInKuwait.txt,1346,29,46,436,212,96,43,787
1442288_ElectionsInLuxembourg.txt,963,23,41,299,140,95,30,564
1443425_RoadshowTheatricalRelease.txt,1088,10,108,383,143,88,45,659
1444050_DumangasIloilo.txt,916,27,33,318,140,68,22,548
1444376_JohnKirkpatrick.txt,1128,26,43,540,109,49,26,724
1444386_SultanBahu.txt,935,28,33,496,85,52,26,659
1445192_ParentchildInteractionAssessmentiipciaii.txt,666,15,44,324,69,45,6,444
1445438_NewAddington.txt,1198,14,85,490,150,77,39,756
1445632_IsaacRoberts.txt,761,13,58,272,103,53,21,449
144589_InformationWarfare.txt,1294,24,53,603,146,97,20,866
144592_Finnair.txt,1335,37,36,552,149,82,28,811
144611_Hmv.txt,1942,27,71,758,242,101,70,1171
144612_BassRock.txt,1234,16,77,470,138,72,45,725
144704_Tanstaafl.txt,1024,14,73,326,143,86,52,607
144706_SidoniusApollinaris.txt,680,7,97,248,75,64,11,398
144726_Donatist.txt,1265,20,63,450,157,73,40,720
1447381_Nbt.txt,847,20,42,308,157,53,28,546
1447627_TragdieEnMusique.txt,613,59,10,264,44,81,14,403
1447692_CherreMoraga.txt,650,24,27,383,28,26,8,445
1447790_JeffreyLundgren.txt,1455,30,48,504,241,59,44,848
1447808_ListOfYoungGlobalLeaders.txt,2945,20,147,2470,14,55,0,2539
1448922_RoswellHigh.txt,717,9,79,309,95,40,20,464
1449892_1888InIreland.txt,668,7,95,335,74,35,11,455
145013_JeannetteRankin.txt,726,13,55,275,91,36,28,430
145014_TheodoreOfTarsus.txt,811,14,57,285,133,47,24,489
145016_Aylsham.txt,697,14,49,277,82,34,18,411
145020_Sintering.txt,645,13,49,239,90,75,19,423
145031_Miscegenation.txt,2467,37,66,858,357,200,129,1544
145035_Sigaba.txt,1215,18,67,431,150,88,41,710
145040_ConservationOfMass.txt,1071,14,76,352,146,88,64,650
145041_BerkeleySquaretvMiniseries.txt,730,13,56,314,100,29,13,456
145042_FrankMorgan.txt,808,8,101,377,46,32,9,464
145043_Vice.txt,606,15,40,265,68,51,22,406
145061_FranchotTone.txt,934,14,66,396,84,46,22,548
145066_ExtractiveMetallurgy.txt,654,16,40,239,99,79,17,434
1450904_SnowtownSouthAustralia.txt,756,21,36,286,81,67,22,456
1450911_JoaquimPedroDeOliveiraMartins.txt,2795,100,27,1208,242,230,55,1735
1450946_Ween.txt,1691,74,22,800,169,125,41,1135
1450959_KalevOts.txt,1355,16,84,511,138,71,23,743
1452070_RoebourneWesternAustralia.txt,784,15,52,290,98,52,19,459
1452153_UsProducerPriceIndex.txt,784,23,34,312,102,51,28,493
1452175_Barasat.txt,1390,61,22,662,127,100,39,928
1453081_PolishlithuanianCommonwealthNavy.txt,1012,15,67,375,141,73,46,635
1454317_TheBigWu.txt,1083,15,72,449,125,76,26,676
1455291_AchtungDieKurve.txt,1078,28,38,312,181,83,56,632
1456127_CollegeRepublicanNationalCommittee.txt,731,19,38,429,67,37,9,542
1456429_MainHoonNa.txt,731,14,52,341,97,37,21,496
145730_Frederikshavn.txt,685,17,40,323,59,47,16,445
145744_Skagen.txt,838,22,38,313,100,55,37,505
1457471_TokayGecko.txt,947,15,63,282,158,97,50,587
145753_Hydrosphere.txt,1130,23,49,382,150,89,50,671
145792_ContinentalDivide.txt,682,16,42,308,53,44,19,424
145796_OberonfairyKing.txt,1152,14,82,493,115,71,22,701
1458124_AlbertFrey.txt,914,16,57,382,100,64,26,572
145813_Subduction.txt,1156,14,82,407,158,119,58,742
1458642_ListOfBountyheadsInCowboyBebop.txt,4604,120,38,1634,628,266,194,2722
1458655_BmtLexingtonAvenueLine.txt,892,14,63,447,87,37,24,595
1459288_TimelineOfPoliticsAndDiplomacyDuringWorldWarIi.txt,606,4,151,297,46,32,6,381
1459290_ColegioDeSanJuanDeLetran.txt,2729,51,53,1718,99,100,17,1934
1459354_SrgioHenriqueFerreira.txt,815,7,116,347,64,70,11,492
1459869_ChevroletK5Blazer.txt,1337,28,47,444,155,140,31,770
1460779_TheThiefAndTheCobbler.txt,8366,93,89,2878,1221,480,299,4878
146078_UniversityOfNewSouthWales.txt,3414,76,44,1542,331,243,68,2184
146084_Anfo.txt,654,11,59,221,99,74,41,435
1460870_Whamon.txt,799,15,53,284,120,32,23,459
1460872_Ardwick.txt,645,13,49,236,96,51,25,408
146103_Nonlinearity.txt,928,27,34,327,132,116,42,617
146106_ListOfWaterways.txt,707,49,14,587,5,25,1,618
146118_ListOfLongdistanceFootpaths.txt,686,25,27,425,21,24,4,474
146141_ToothFairy.txt,1649,36,45,601,229,106,41,977
1461470_GreatLakesStormOf1913.txt,3032,54,56,1239,372,202,90,1903
146150_JooGoulart.txt,1045,13,80,391,147,92,34,664
1461519_ListOfGermanPresidentsSince1919.txt,604,31,19,299,48,15,8,370
146151_WashingtonMetro.txt,6390,81,78,2492,868,385,163,3908
1461658_MargheritaCarosio.txt,836,12,69,287,100,61,39,487
1461844_Kvrr.txt,693,23,30,329,63,33,21,446
1461855_TimKaine.txt,1000,14,71,429,109,66,18,622
1462007_SibrieMtaitContee.txt,583,11,53,232,62,58,25,377
1462013_1992Consensus.txt,1044,12,87,366,147,54,30,597
1462048_Vangiones.txt,2460,29,84,841,347,126,96,1410
1462053_StraitOfMessinaBridge.txt,864,17,50,290,124,60,28,502
1462685_NissanStagea.txt,708,21,33,320,48,82,16,466
1462983_Cheering.txt,2196,33,66,877,281,167,76,1401
1463068_AnaVoog.txt,1076,16,67,429,140,78,38,685
1463156_LokeWanTho.txt,1310,20,65,575,150,57,37,819
1464042_OpenSourceHardware.txt,878,14,62,443,87,87,16,633
1464117_IonizationChamber.txt,657,9,73,218,101,64,16,399
1464118_ListOfParishesOfPortugalP.txt,824,13,63,709,38,10,0,757
1464121_SuperstationWgn.txt,698,13,53,275,97,75,21,468
1464131_ListOfParishesOfPortugalS.txt,856,8,107,705,49,13,0,767
1465190_ListOfMilitaryDisasters.txt,1509,19,79,564,180,99,60,903
1465193_ListOfFlopsInEntertainment.txt,9802,48,204,3929,1210,594,284,6017
1465969_TheScoutAssociationOfGuyana.txt,1015,29,35,471,131,43,15,660
1465972_HaroldSheafictionalSeries.txt,1556,15,103,660,143,101,52,956
1465982_KiribatiScoutAssociation.txt,1520,13,116,333,305,71,94,803
1465983_LatvijasSkautuUnGaiduCentrlOrganizcija.txt,707,19,37,359,75,53,6,493
1466297_ShrinkingViolet.txt,691,10,69,239,111,41,21,412
1466397_ZionI.txt,743,9,82,305,109,50,26,490
1466945_Baronh.txt,645,13,49,211,100,59,29,399
1467355_InternationalCricketInSouthAfrica1971To1981.txt,2882,38,75,1303,315,174,89,1881
1467523_PapalRegaliaAndInsignia.txt,1030,8,128,358,140,76,39,613
1467962_Marimar.txt,665,5,133,267,86,25,29,407
1468207_YoureEitherWithUsOrAgainstUs.txt,579,14,41,176,74,17,16,283
146842_GeorgeVilliers1stDukeOfBuckingham.txt,1148,21,54,436,157,38,40,671
1468588_Glengarryprescottrussell.txt,436,24,18,215,43,15,1,274
146885_Funkadelicalbum.txt,682,29,23,345,59,54,18,476
146904_Zbuffering.txt,950,24,39,263,163,102,66,594
146905_FarleyMowat.txt,2061,29,71,796,245,96,56,1193
1469113_IvanAsenIiOfBulgaria.txt,1914,20,95,754,227,98,35,1114
1469497_Aspidogastrea.txt,1183,31,38,473,125,118,29,745
1469528_ListOfCivilParishesInCheshire.txt,466,10,46,435,1,8,0,444
1470282_KarlSilberbauer.txt,716,10,71,250,112,32,20,414
1470284_RomanianHumour.txt,982,32,30,294,162,91,44,591
1470750_StarWarsMush.txt,1024,14,73,371,159,76,40,646
1470770_SouthwickWestSussex.txt,770,10,77,350,68,47,27,492
1471503_EthicalChallengesToAutismTreatment.txt,1654,34,48,541,263,178,79,1061
1471706_GasMetalArcWelding.txt,4030,32,125,1405,616,398,182,2601
1471734_BlackSeadevil.txt,747,12,62,254,107,93,34,488
147174_RobertLey.txt,2125,24,88,782,276,134,60,1252
147183_ZhaoZiyang.txt,3204,32,100,1100,499,242,118,1959
147187_ChristianDior.txt,1743,22,79,633,252,154,47,1086
1471911_JohannesDeGarlandiamusicTheorist.txt,605,11,55,193,83,64,26,366
147208_Zacatecas.txt,1004,21,47,399,106,79,25,609
147209_Hermosillo.txt,574,15,38,237,68,35,15,355
147227_ArvandrudshattAlarab.txt,837,8,104,298,106,55,23,482
147234_ComicsCodeAuthority.txt,1723,24,71,627,267,133,71,1098
147235_ChineseUnitsOfMeasurement.txt,553,21,26,198,76,55,13,342
147237_LaurentGbagbo.txt,570,9,63,185,88,47,16,336
147239_GeorgeJeffreys1stBaronJeffreys.txt,601,7,85,244,83,27,10,364
147242_OctaneRating.txt,2006,30,66,714,269,166,95,1244
147247_P47Thunderbolt.txt,4491,60,74,1681,571,402,118,2772
1472525_Castlevanianintendo64.txt,2828,32,88,1009,423,191,77,1700
147252_IntegrationByParts.txt,1415,93,15,477,181,133,55,846
147253_MexicanPeso.txt,2301,42,54,742,328,147,87,1304
147259_PeyroniesDisease.txt,821,13,63,269,134,88,40,531
147271_Pallium.txt,2587,16,161,788,336,208,105,1437
147278_CedarPoint.txt,2698,42,64,1073,339,193,68,1673
147280_Atargatis.txt,1049,13,80,371,131,74,31,607
1472831_AlbertBushnellHart.txt,941,9,104,395,81,47,21,544
1472833_Cimon.txt,903,11,82,275,146,49,37,507
1474062_DukeOfEdinburghsRoyalRegimentberkshireAndWiltshire.txt,618,7,88,272,67,23,7,369
1475015_EvangeliumVitae.txt,1052,27,38,363,142,89,31,625
1475062_MNSrinivas.txt,581,5,116,213,61,54,14,342
1475109_MinkowskisQuestionMarkFunction.txt,1053,36,29,367,120,100,40,627
1475688_RealWorldroadRulesChallenge.txt,645,12,53,217,92,41,19,369
1475867_NflPlayoffs199899.txt,3713,88,42,1780,367,167,82,2396
1475872_NflPlayoffs199798.txt,1654,66,25,983,96,29,20,1128
1475874_WilliamEverson.txt,826,13,63,432,50,38,10,530
1476908_SingleConventionOnNarcoticDrugs.txt,8591,69,124,3268,1016,687,268,5239
1477215_LeeAnnSontheimerMurphy.txt,880,14,62,408,79,66,21,574
1477287_CatholicWorkerMovement.txt,746,13,57,514,38,29,13,594
1477291_ElioDiIorio.txt,796,12,66,309,102,56,25,492
1477292_Thngersheim.txt,770,20,38,333,67,76,9,485
1478259_DanaLove.txt,665,9,73,294,82,56,7,439
147911_GoldenHorde.txt,1563,36,43,623,184,110,47,964
147920_EdmundBlackadder.txt,1282,23,55,510,144,113,57,824
1479572_1stHussars.txt,2831,43,65,1014,381,163,53,1611
147972_CarloGambino.txt,770,12,64,303,113,42,18,476
1480058_WarayLiterature.txt,1036,17,60,440,106,73,23,642
1480548_PaiMarire.txt,807,12,67,276,126,34,17,453
1480553_MeSoHorny.txt,636,18,35,268,75,26,20,389
1480643_EddiePalmieri.txt,874,12,72,445,72,31,23,571
1482808_Nyingma.txt,2350,27,87,1144,199,139,55,1537
1482809_Beulahseries.txt,735,19,38,389,65,33,12,499
148313_JosephIiHolyRomanEmperor.txt,1990,28,71,688,263,139,57,1147
148341_CarlosSantana.txt,4964,59,84,2155,560,319,135,3169
148349_Chatterbot.txt,941,19,49,317,151,91,51,610
148356_BloodSweatTears.txt,1571,16,98,594,218,112,65,989
1483713_ShunGokuSatsu.txt,1067,8,133,412,142,63,49,666
1483720_TheQueensWestminsters.txt,652,12,54,281,65,42,11,399
1483729_NameDaysInTheCzechRepublic.txt,610,17,35,433,22,61,10,526
148383_Arquebus.txt,629,12,52,197,87,46,21,351
148385_Pisco.txt,3530,47,75,1270,486,233,136,2125
1484071_JurassicParkvideoGame.txt,2334,34,68,871,353,151,92,1467
1484072_SonsOfTheDark.txt,575,26,22,191,91,31,19,332
1484674_BushrodJohnson.txt,600,7,85,251,63,21,8,343
1484849_DavidHolbrook.txt,1374,15,91,700,79,42,14,835
1485038_HalifaxGrammarSchool.txt,931,16,58,389,108,60,26,583
1485905_TheMothersOfInvention.txt,585,11,53,263,50,21,21,355
1486197_WalterVeltroni.txt,648,13,49,304,48,39,12,403
1486840_CusDamato.txt,629,12,52,225,102,46,26,399
1486844_MayBall.txt,1056,20,52,461,140,75,32,708
1486868_CatherineDoherty.txt,1364,28,48,510,180,65,52,807
1487417_AbileneChristianUniversity.txt,677,15,45,369,53,22,7,451
1487987_NationalInstituteOnDrugAbuse.txt,1259,16,78,523,187,73,39,822
1488456_BadenCooke.txt,537,22,24,295,20,33,3,351
1489006_NewsLimited.txt,1041,20,52,462,112,80,37,691
1489045_TheScoreTelevisionNetwork.txt,1665,22,75,686,196,129,59,1070
1489050_PokmonHeroes.txt,2349,25,93,854,340,116,77,1387
149001_Electroclash.txt,1489,22,67,675,136,130,78,1019
149006_VivienneWestwood.txt,1018,20,50,420,149,63,22,654
149007_MalcolmMclaren.txt,2173,37,58,839,313,124,58,1334
1490216_BrunoGollnisch.txt,612,13,47,233,70,35,14,352
1491174_Rigdonite.txt,835,9,92,376,93,34,21,524
1491181_ListOfVideoGamesPublishedByNintendo.txt,2534,42,60,2019,12,61,29,2121
1491211_DoctorFaustusthomasMannNovel.txt,950,13,73,379,95,91,33,598
1491364_CharactersOfLost.txt,5457,82,66,2055,815,242,180,3292
1491601_VaginalBleeding.txt,589,10,58,188,95,63,31,377
1492333_JohnHopoate.txt,2547,32,79,838,365,145,104,1452
1492352_TaiwanUnderDutchRule.txt,698,8,87,247,89,56,18,410
1492759_PierrePierce.txt,591,11,53,226,86,33,9,354
1492960_NakhichevanCity.txt,689,9,76,270,77,53,22,422
1493565_BangOlufsen.txt,1065,22,48,459,131,92,26,708
14939_IntercontinentalBallisticMissile.txt,2573,46,55,976,355,240,88,1659
149401_JeanandrDeluc.txt,1151,11,104,359,142,100,26,627
149402_HubertHoweBancroft.txt,656,7,93,258,70,37,20,385
149419_ShoelessJoeJackson.txt,1340,19,70,483,200,67,53,803
149420_JoeJacksonmusician.txt,1025,20,51,395,116,67,30,608
149425_TheVerve.txt,1945,21,92,779,233,126,68,1206
149426_Subnetwork.txt,1073,27,39,396,157,86,22,661
14943_IrishTraditionalMusicSession.txt,723,13,55,219,103,73,39,434
149441_CharlesIiiOfSpain.txt,1115,20,55,368,142,71,33,614
14944_Insect.txt,5213,78,66,1882,718,515,235,3350
1494514_GiovanniBrusca.txt,976,16,61,387,126,55,23,591
149451_BartolommeoBandinelli.txt,872,11,79,384,96,28,27,535
1494533_Turrican.txt,1437,32,44,596,196,100,56,948
149459_AlGreen.txt,1434,19,75,659,147,54,34,894
149469_JohnVOfPortugal.txt,654,12,54,224,89,60,24,397
14946_Ice.txt,2027,39,51,737,289,182,89,1297
149471_JohnAndersonphilosopher.txt,742,15,49,285,87,60,22,454
149473_JealousAgain.txt,854,15,56,339,114,62,39,554
1495085_Archaeopteris.txt,887,15,59,337,123,76,31,567
1495137_SolomonicDynasty.txt,585,7,83,227,72,38,15,352
1495144_Amr33.txt,1532,17,90,456,233,114,69,872
1495747_BillFoulkes.txt,2357,30,78,753,344,126,118,1341
1495748_Gay.txt,746,10,74,316,99,69,26,510
14958_ImmuneSystem.txt,5630,66,85,2208,808,560,182,3758
14959_Immunology.txt,1090,21,51,416,140,117,48,721
1496708_MarionBoyd.txt,577,9,64,221,68,41,14,344
14968_Icosahedron.txt,1064,32,33,342,138,99,30,609
14971_IndustrialArchaeologyOfDartmoor.txt,580,16,36,177,90,49,35,351
14972_Idempotence.txt,839,31,27,306,107,79,29,521
14973_IthacaNewYork.txt,4443,70,63,1989,449,339,130,2907
14975_IvyLeague.txt,4205,53,79,1625,477,340,147,2589
14976_IthacaHours.txt,819,23,35,358,98,64,17,537
1497744_KamenRiderAgito.txt,4440,64,69,2216,404,212,101,2933
1497928_ListOfFemaleRappers.txt,723,28,25,671,0,17,0,688
1497964_TheSopranoFamilyTree.txt,663,8,82,503,13,19,3,538
14980_Imhotep.txt,831,19,43,294,126,45,32,497
1498881_DerekAndClive.txt,905,9,100,320,136,59,50,565
1498886_Triumphcomics.txt,632,11,57,218,96,48,23,385
1498964_1887InIreland.txt,726,6,121,366,66,31,5,468
14996_InternationalEnglish.txt,4301,55,78,1705,420,477,151,2753
1500086_ListOfNotableMelburnians.txt,495,15,33,426,12,5,2,445
1500142_PortlandWinterHawks.txt,663,14,47,389,59,26,13,487
1500415_UnfinishedSymphony.txt,731,8,91,228,116,78,33,455
150076_DoctorStrange.txt,5548,72,77,2163,672,390,181,3406
150087_Sublimeband.txt,529,16,33,220,61,44,19,344
150091_GeorgeForeman.txt,2357,37,63,804,356,122,71,1353
150095_HarpoMarx.txt,1322,24,55,456,194,69,59,778
1501255_FlorentiusVolusenus.txt,664,9,73,226,83,37,17,363
1501259_TheMuppetsWizardOfOz.txt,995,20,49,442,95,52,22,611
1501432_DavidMiscavige.txt,1417,28,50,564,193,79,45,881
150160_RailroadSwitch.txt,3394,83,40,1070,563,252,160,2045
1502230_ListOfTranceArtists.txt,1001,27,37,873,8,14,1,896
1502266_Skaara.txt,599,14,42,185,115,22,18,340
1502312_YoshiTouchGo.txt,1282,15,85,459,167,76,44,746
1502321_AncientMusic.txt,928,15,61,332,122,93,30,577
1503224_LocalBoundedness.txt,737,21,35,214,122,43,50,429
1503231_HostileSpace.txt,1059,12,88,333,189,65,38,625
1503237_MobyDicksong.txt,582,11,52,234,64,38,22,358
1503269_CriterionTheatre.txt,1220,15,81,470,148,55,26,699
1503768_ChocolateFountain.txt,948,19,49,372,135,97,47,651
1504450_RobertLudvigovichBartini.txt,770,18,42,288,82,62,26,458
1504453_HendrikusColijn.txt,674,10,67,215,87,41,18,361
1504783_RobertFlemingCo.txt,1064,14,76,452,109,65,23,649
150535_DevensMassachusetts.txt,574,11,52,235,68,36,13,352
150536_HollandMichigan.txt,1907,38,50,790,207,128,29,1154
150537_SouthHavenMichigan.txt,987,19,51,359,124,66,18,567
150539_Cpviolation.txt,1545,23,67,525,213,137,61,936
150540_NilesMichigan.txt,963,18,53,362,119,55,10,546
150545_GrandLedgeMichigan.txt,608,13,46,235,57,32,7,331
150550_TraverseCityMichigan.txt,2743,44,62,1296,263,172,51,1782
1506005_CadetCollegePetaro.txt,1491,27,55,895,101,53,18,1067
1506975_LictonSpringsSeattleWashington.txt,1575,11,143,911,107,67,14,1099
1507604_SacramentoSolons.txt,811,11,73,321,97,38,22,478
1507632_BarreChord.txt,575,10,57,213,80,50,22,365
1507798_NJudah.txt,641,7,91,305,53,30,4,392
1507806_WalterHagen.txt,817,20,40,357,97,45,27,526
1507810_Ibelin.txt,1730,16,108,848,147,96,29,1120
1507812_UgolinoDellaGherardesca.txt,1268,19,66,425,198,62,56,741
1507822_BattleOfManila1898.txt,1249,11,113,446,199,50,40,735
1507828_SamesexMarriageInNewYork.txt,2411,57,42,1113,285,146,47,1591
1507839_CalgaryHitmen.txt,1264,50,25,590,121,64,29,804
1510010_BeggarsRide.txt,742,11,67,258,105,63,26,452
1510018_DastardlyAndMuttleyInTheirFlyingMachines.txt,1711,26,65,701,209,85,94,1089
1510942_ItalianWarCrimes.txt,785,9,87,309,76,80,22,487
1510945_Abla.txt,659,10,65,249,92,50,11,402
1510974_ListOfWargamePublishers.txt,721,2,360,403,60,57,18,538
151167_FlowerMoundTexas.txt,1071,15,71,438,120,64,25,647
151185_MissouriCityTexas.txt,1927,29,66,796,225,117,43,1181
1512193_Binjai.txt,1133,26,43,430,135,88,34,687
151230_AzleTexas.txt,782,13,60,290,100,36,11,437
151250_AlfonsoIxOfLeon.txt,598,13,46,249,74,21,16,360
151252_ParkCityUtah.txt,1567,25,62,627,171,99,43,940
151253_ScottsvilleVirginia.txt,641,11,58,212,80,40,14,346
1513101_LonsdaleCollege.txt,692,17,40,293,88,50,26,457
1513152_Turbohydramatic.txt,2180,36,60,730,302,182,51,1265
1513538_JonathanSarfati.txt,1288,30,42,526,149,89,35,799
1514172_DavidMcmurtrieGregg.txt,1272,18,70,500,198,64,32,794
1514325_JimWebb.txt,4046,61,66,1647,489,249,93,2478
1514374_JJohnstonPettigrew.txt,1380,18,76,559,183,74,27,843
1514690_Fxt1.txt,626,10,62,212,93,51,15,371
1514747_NnewYorkCitySubwayService.txt,980,25,39,365,136,60,26,587
1515472_StokesParameters.txt,707,30,23,232,97,53,25,407
1515476_WatonyBoyle.txt,1415,27,52,613,178,76,23,890
1515480_HsbcWorldMatchPlayChampionship.txt,1046,20,52,384,112,64,25,585
151577_Causalityphysics.txt,659,11,59,225,91,45,27,388
151578_Wetherby.txt,1002,24,41,421,144,41,21,627
151579_BillBailey.txt,2274,36,63,884,280,147,93,1404
151582_NickHancockactor.txt,738,16,46,315,111,29,19,474
151584_JohnSmeaton.txt,755,14,53,292,90,36,14,432
151585_JonathanRosstelevisionPresenter.txt,1876,32,58,707,251,116,57,1131
151587_ForthAndClydeCanal.txt,622,9,69,244,51,24,11,330
151588_VideoToaster.txt,943,13,72,357,129,91,42,619
151590_FaradayCage.txt,612,12,51,223,75,59,17,374
1515911_TosaSchool.txt,786,13,60,286,89,52,23,450
151602_Velcro.txt,1442,31,46,510,212,99,53,874
151603_DeanMartin.txt,4386,50,87,1508,635,278,213,2634
151604_Deception.txt,592,20,29,232,71,43,24,370
151606_MarkWaugh.txt,3981,37,107,1261,538,255,119,2173
151612_LennyHenry.txt,976,23,42,416,112,49,25,602
151630_KennetAndAvonCanal.txt,2635,35,75,980,324,210,59,1573
1516352_NealeDonaldWalsch.txt,805,11,73,360,81,24,20,485
1516358_Fushun.txt,579,19,30,231,74,56,26,387
1516364_TalonNews.txt,673,13,51,303,85,45,12,445
1516369_PercyAdlon.txt,726,11,66,383,56,54,7,500
151637_WaltDisneyStudiosburbank.txt,640,9,71,272,74,37,20,403
151640_AireAndCalderNavigation.txt,880,9,97,321,99,69,32,521
1516462_TheUpperHand.txt,608,22,27,337,20,8,5,370
1516500_ChemicalFileFormat.txt,1684,81,20,848,197,138,45,1228
1516548_TheNeed.txt,601,26,23,304,53,26,18,401
1517662_Engadget.txt,907,22,41,398,119,66,27,610
1517670_AlGroh.txt,1117,13,85,453,128,57,17,655
1518039_TintinAndSnowy.txt,1357,22,61,478,181,97,66,822
1518690_Lemmings2TheTribes.txt,2526,37,68,823,399,172,95,1489
1519005_SultanOfOmansArmedForces.txt,2372,42,56,953,305,156,72,1486
1519643_Tarancharacter.txt,666,10,66,218,104,39,24,385
1519656_NonzeroTheLogicOfHumanDestiny.txt,1922,25,76,630,263,185,106,1184
1520225_RaymondFloyd.txt,687,16,42,355,50,37,7,449
1520275_OakvilleTransit.txt,773,20,38,399,78,44,14,535
1520281_Nadvirna.txt,711,16,44,280,73,60,16,429
152256_UnitedKingdomOfGreatBritainAndIreland.txt,1222,19,64,439,141,80,37,697
152277_JaneAddams.txt,676,13,52,362,44,41,7,454
1523052_OlmecMythology.txt,997,11,90,373,118,68,38,597
1523057_IceWarrior.txt,1661,25,66,631,229,101,53,1014
1523074_TheAlliance.txt,1345,13,103,582,158,61,46,847
1523081_AladdintvSeries.txt,1352,13,104,694,146,47,33,920
1523375_Demoparty.txt,1157,22,52,366,163,113,87,729
152339_Etterbeek.txt,811,14,57,340,83,78,17,518
152385_JrgHaider.txt,2825,42,67,958,375,223,109,1665
1524025_VladimirKorolenko.txt,801,20,40,315,95,46,17,473
1524052_RyabkosSystema.txt,1118,31,36,401,147,113,52,713
1524059_Chitral.txt,587,11,53,243,56,30,15,344
1524064_PuertoRicanSpanish.txt,2736,21,130,1058,295,289,126,1768
1524195_TsunamiBomb.txt,745,12,62,366,77,50,14,507
1524224_NgaHootersTour.txt,803,11,73,344,82,58,20,504
1524231_Reprogenetics.txt,877,18,48,306,115,92,45,558
1524237_QueenMaya.txt,717,13,55,285,110,38,19,452
1524244_Euskaltzaindia.txt,1145,17,67,390,145,104,29,668
1524728_MarvinLiebman.txt,802,18,44,321,86,58,16,481
1525155_FraminghamHighSchool.txt,872,28,31,397,97,61,14,569
1525163_AltonCollege.txt,855,29,29,364,93,67,13,537
1525214_SupervaluunitedStates.txt,1027,23,44,549,99,57,15,720
1525255_DistributionCenter.txt,1161,24,48,420,159,84,52,715
1525753_TorontoPublicLibrary.txt,685,17,40,264,72,39,17,392
1526385_DominickArgento.txt,2040,23,88,802,223,147,64,1236
1526433_CountVertigo.txt,1107,15,73,350,191,64,54,659
152671_Z3.txt,712,12,59,248,103,56,42,449
152678_Grantham.txt,1276,15,85,531,147,87,38,803
152679_RscAnderlecht.txt,3273,40,81,1278,317,223,78,1896
152680_FranzBeckenbauer.txt,1851,40,46,686,215,116,44,1061
152682_JeanphilippeRameau.txt,2052,27,76,746,275,201,52,1274
152692_Tractor.txt,3327,52,63,1084,527,275,154,2040
152703_HilbertsThirdProblem.txt,831,21,39,275,130,70,29,504
152726_BertrandBarreDeVieuzac.txt,716,10,71,234,81,39,19,373
1527351_LgbtRightsOpposition.txt,2004,38,52,735,287,205,65,1292
1527384_MsJackson.txt,611,14,43,218,86,45,25,374
1527386_RobotChicken.txt,1225,20,61,554,156,81,44,835
1527394_RickyHatton.txt,802,19,42,326,105,43,26,500
1528614_NakhonSiThammarat.txt,647,16,40,266,73,42,27,408
1529516_GrandCouncilOfTheCrees.txt,595,13,45,248,63,45,10,366
1529518_Aspergillus.txt,752,14,53,284,100,79,45,508
1529533_Trichoptera.txt,651,9,72,231,98,66,39,434
1530122_Synaxarium.txt,639,12,53,252,80,39,22,393
15303_IonChannel.txt,2007,28,71,749,252,221,66,1288
15305_IntegratedDevelopmentEnvironment.txt,1042,14,74,411,169,99,44,723
15309_Intellivision.txt,3113,41,75,1198,453,263,92,2006
1531092_Botball.txt,1450,26,55,571,198,90,31,890
1531725_ElishaBenAbuyah.txt,2725,27,100,978,362,166,100,1606
1531756_BergrivierLocalMunicipality.txt,692,19,36,240,79,33,7,359
1531906_Pacuvius.txt,835,11,75,299,86,65,24,474
1531913_Wbbjtv.txt,838,14,59,519,19,24,2,564
1532779_IslamInTheUnitedKingdom.txt,1925,30,64,956,152,104,50,1262
1532873_SacredTradition.txt,910,16,56,318,116,40,39,513
1532956_EmdSd24.txt,812,22,36,299,102,92,25,518
1532957_CognitiveLoad.txt,1036,21,49,349,164,114,38,665
1532975_PraveenTogadia.txt,793,17,46,281,125,51,20,477
153364_Sum41.txt,2775,38,73,1085,354,186,72,1697
1534087_WilliamHutcheson.txt,661,8,82,263,83,37,20,403
153408_SpencerFamily.txt,583,8,72,309,22,43,7,381
1534090_YaronLifschitz.txt,713,29,24,360,49,28,7,444
153418_DonkeyKongCountry3DixieKongsDoubleTrouble.txt,1510,13,116,620,187,99,45,951
1535662_LudwigBrne.txt,660,9,73,250,77,51,14,392
1537336_HamdenHallCountryDaySchool.txt,1885,33,57,777,210,182,56,1225
15374_FoodIrradiation.txt,2273,34,66,880,343,196,91,1510
153758_StarWarsJediKnightDarkForcesIi.txt,4202,40,105,1670,550,322,201,2743
15375_InternalRevenueService.txt,1774,34,52,721,247,100,44,1112
153761_HumberBridge.txt,850,19,44,300,111,47,22,480
153765_Balsagoth.txt,1558,24,64,670,161,136,34,1001
153771_BlowingARaspberry.txt,830,18,46,290,121,55,41,507
153784_Naginata.txt,1258,17,74,430,181,91,53,755
153791_CecilyNeville.txt,1291,29,44,486,154,62,42,744
153799_Teetotalism.txt,582,14,41,243,61,49,27,380
153803_MurrayBookchin.txt,1748,16,109,649,168,161,39,1017
1539839_LeslieFeist.txt,713,22,32,328,69,35,16,448
1540673_AmbrosiusBlarer.txt,671,11,61,238,110,31,28,407
1542812_Danconirak.txt,1457,32,45,620,156,103,32,911
1543779_HereComeTheAbcs.txt,666,11,60,335,58,34,16,443
1543812_Qsquared.txt,942,17,55,377,120,56,27,580
15440_IbmPcKeyboard.txt,1339,14,95,480,190,146,58,874
15441_ItalianBattleshipGiulioCesare.txt,1066,12,88,365,150,71,31,617
1544341_LeafcutterJohn.txt,854,35,24,368,85,70,50,573
1544346_CliffBastin.txt,806,10,80,277,114,37,26,454
1544985_EskPike.txt,663,9,73,276,74,42,21,413
154501_JohnWilliamsdisambiguation.txt,639,8,79,450,9,26,3,488
154518_TheRealSlimShady.txt,782,13,60,348,95,56,22,521
154521_UniversityOfCentralFlorida.txt,7204,106,67,3350,738,431,155,4674
1545294_MezzanineLoan.txt,661,7,94,239,78,69,35,421
154560_AntiochUniversity.txt,919,18,51,422,90,79,15,606
1545975_MoleculeMan.txt,1407,14,100,438,233,96,64,831
1546130_SimpsonAndDelilah.txt,711,9,79,279,114,37,19,449
1546137_Piloswine.txt,780,13,60,308,105,76,24,513
1546153_ThirdStreetLightRailProject.txt,619,13,47,271,73,35,11,390
1546526_HaroldClurman.txt,1344,12,112,569,114,76,21,780
1547111_QuebecCitywindsorCorridor.txt,1590,36,44,694,138,129,50,1011
1547308_SubjunctivePossibility.txt,848,13,65,168,148,108,82,506
1547481_RoleplayersVault.txt,1287,27,47,426,206,84,59,775
1547487_CharlesfranoisLebrunDucDePlaisance.txt,814,14,58,293,83,56,20,452
1548347_MaskedRidertvSeries.txt,3718,22,169,1543,505,245,140,2433
1548355_DorisMatsui.txt,640,9,71,270,74,35,8,387
1548362_MahmoudDarwish.txt,1673,87,19,653,181,122,34,990
154847_FirstBabylonianDynasty.txt,774,10,77,261,93,70,33,457
154849_StrategicArmsLimitationTalks.txt,693,12,57,302,77,46,12,437
154857_EmmittSmith.txt,1091,25,43,411,145,61,29,646
1548708_TwistedMetal2.txt,2291,49,46,908,316,151,80,1455
154881_HeatIndex.txt,884,20,44,308,98,71,38,515
154882_AalstBelgium.txt,705,13,54,275,83,57,22,437
154890_Ninove.txt,1234,21,58,468,137,84,13,702
154943_AlfredDeVigny.txt,895,12,74,313,130,83,19,545
154944_EidUlfitr.txt,3503,54,64,1256,500,274,160,2190
154954_AlfredDeakin.txt,889,22,40,313,110,67,34,524
154955_BillyHughes.txt,1940,21,92,687,257,135,53,1132
154956_OceansEleven1960Film.txt,1438,15,95,477,203,72,69,821
1549668_Citytrain.txt,928,33,28,428,94,46,24,592
1550491_JamesHolman.txt,727,10,72,246,92,39,35,412
1550518_IgorGiorgadze.txt,768,13,59,284,100,57,22,463
1550547_AlhambraboardGame.txt,1475,9,163,533,218,55,31,837
1551482_2006ScottTournamentOfHearts.txt,1289,69,18,629,87,70,5,791
1551490_Bigbang.txt,828,23,36,381,83,56,35,555
1551867_RichardBHubbard.txt,685,11,62,275,87,40,9,411
1551869_OranMRoberts.txt,647,6,107,244,82,27,8,361
1551928_CarlEdwards.txt,1400,24,58,599,181,64,39,883
1553629_BrianBooth.txt,628,13,48,209,83,36,23,351
1555809_Rood.txt,781,12,65,293,89,65,30,477
1555862_ComputerAnimationProductionSystem.txt,738,12,61,306,116,57,30,509
1555866_3dLemmings.txt,676,11,61,206,105,58,30,399
1555868_Comtcheese.txt,595,17,35,149,121,46,24,340
155587_GroffConklin.txt,746,11,67,340,56,44,11,451
155588_SandfordFleming.txt,850,12,70,315,100,43,37,495
155591_LaFortuneDesRougon.txt,959,8,119,316,109,93,50,568
1556012_MarchettoDaPadova.txt,781,17,45,253,98,73,27,451
1556060_TichFreeman.txt,881,10,88,219,95,70,50,434
155608_MaYingjeou.txt,2937,28,104,1026,415,236,118,1795
1556233_FibrodysplasiaOssificansProgressiva.txt,665,15,44,234,104,47,32,417
1556237_Parrhesia.txt,529,11,48,169,67,38,25,299
155664_RailwayPlatform.txt,1301,25,52,466,172,96,80,814
1556961_TugayaLanaoDelSur.txt,568,12,47,254,64,60,10,388
1556970_DictatorGame.txt,680,11,61,222,113,50,31,416
1557002_PellinRodrguez.txt,612,9,68,260,74,30,13,377
1557022_SanFranciscoZoo.txt,767,12,63,378,57,46,16,497
1557263_LittleMoMitchell.txt,1533,18,85,445,312,65,92,914
1558022_NationalChristianForensicsAndCommunicationsAssociation.txt,1750,31,56,685,233,122,78,1118
1558208_AgriculturalWastewaterTreatment.txt,1049,25,41,377,150,119,52,698
1558618_RoperVSimmons.txt,2202,23,95,828,283,114,70,1295
1558619_ValMarieSaskatchewan.txt,690,14,49,288,86,55,23,452
1558627_ComparisonOfSourcesForNumberedRoutesInRhodeIsland.txt,842,10,84,311,134,65,36,546
155925_JerkyBoys.txt,757,11,68,375,72,43,19,509
155935_L7band.txt,664,16,41,279,72,38,14,403
1559449_GermanModel.txt,830,13,63,319,94,94,26,533
155948_Greenleft.txt,4029,54,74,1413,506,341,112,2372
1559589_FleurBeale.txt,858,10,85,340,114,34,24,512
155997_BoyzNTheHood.txt,2511,31,81,945,351,154,96,1546
156018_EttoreMajorana.txt,1059,19,55,410,133,97,35,675
156024_AnneRobertJacquesTurgotBaronDeLaune.txt,3265,21,155,1048,423,222,94,1787
156029_BattleOfPoltava.txt,1249,13,96,433,169,79,47,728
1560371_UniversityOfSaintFrancisillinois.txt,740,11,67,318,85,53,20,476
1560377_ProblemGambling.txt,1182,20,59,447,170,134,47,798
1560385_BbtvChannel7.txt,182,4,45,92,6,2,1,101
156047_GuillaumechrtienDeLamoignonDeMalesherbes.txt,747,9,83,219,102,46,28,395
1561324_Northwindcomics.txt,1920,32,60,636,331,102,86,1155
1561325_Hoodie.txt,833,16,52,286,134,66,41,527
1561378_MaxwellLord.txt,1159,14,82,375,195,83,39,692
1561424_LakeChamplainTransportationCompany.txt,575,15,38,243,64,44,16,367
1561428_AdamGiambrone.txt,634,13,48,252,73,41,15,381
1561436_1984InSouthAfrica.txt,943,17,55,453,100,16,11,580
1562383_NorthernTierNationalHighAdventureBases.txt,948,23,41,415,124,44,26,609
1562395_StreetFighter2010.txt,1118,17,65,368,182,64,49,663
1562567_IntussusceptionmedicalDisorder.txt,614,12,51,173,101,44,43,361
1563701_StagHunt.txt,682,14,48,249,91,38,25,403
1564577_MaidanNezalezhnosti.txt,1092,30,36,376,138,102,44,660
1566129_UssSaufleydd465.txt,1694,32,52,669,207,87,28,991
1566134_AnatoleLitvak.txt,594,3,198,238,58,27,6,329
1566853_WannaBeStartinSomethin.txt,902,16,56,408,86,63,30,587
156754_Yoghurt.txt,2378,44,54,869,362,218,77,1526
1567871_MahindraUnitedWorldCollegeOfIndia.txt,1662,36,46,686,173,139,39,1037
1569045_EmpiresDawnOfTheModernWorld.txt,1613,19,84,638,226,145,50,1059
1569142_VirtuesOfHarmony.txt,2583,26,99,998,387,124,117,1626
1570098_ArthurMillspaugh.txt,813,15,54,357,94,66,19,536
1570637_FranklynGermn.txt,680,13,52,262,82,44,22,410
157063_land.txt,1967,46,42,632,240,176,55,1103
157065_ListOfCitiesInAlgeria.txt,902,40,22,295,5,38,1,339
157090_CasparWeinberger.txt,1347,23,58,552,155,82,27,816
157110_BattleOfEylau.txt,1897,26,72,553,306,168,92,1119
157115_CutCopyAndPaste.txt,1016,18,56,320,170,83,48,621
157116_Boaz.txt,593,12,49,195,81,27,27,330
157120_BattleOfLigny.txt,753,13,57,250,114,53,25,442
157136_MurderInc.txt,1324,23,57,613,169,55,26,863
1572240_CaptainCold.txt,1674,19,88,628,242,93,58,1021
1572242_AntonioPalocci.txt,1023,16,63,363,137,54,37,591
1572274_TreehouseOfHorrorX.txt,973,6,162,383,150,41,39,613
1572276_BeforeISleep.txt,860,8,107,260,147,39,37,483
1572437_SaintAnneSandyPointParish.txt,616,10,61,268,73,63,14,418
1572643_VriendVAlberta.txt,1008,25,40,320,146,73,43,582
1572827_1982InSouthAfrica.txt,686,17,40,363,51,25,6,445
1572831_PlantSenescence.txt,1561,13,120,488,275,96,104,963
1573422_Leachate.txt,632,9,70,209,102,68,37,416
1573423_ListOfFilmsSetInSingapore.txt,439,10,43,196,9,11,3,219
1573430_ElectrostaticGenerator.txt,2530,20,126,1072,304,212,62,1650
1574616_KarmaPolice.txt,634,17,37,227,101,42,26,396
1574620_MattFoley.txt,812,14,58,314,107,42,36,499
1575017_FarinUrlaub.txt,1043,20,52,381,139,81,47,648
1575019_SanRoqueParishCathedral.txt,849,13,65,340,84,49,16,489
1576167_FrancescoIDeMediciGrandDukeOfTuscany.txt,558,10,55,205,67,35,16,323
1576168_TheAdventuresOfTintintvSeries.txt,2630,39,67,1261,270,139,59,1729
1576612_Dysoncompany.txt,1643,41,40,636,220,154,46,1056
1576780_Adelphoe.txt,693,11,63,229,107,40,26,402
1576783_TillieKFowler.txt,959,13,73,356,125,56,43,580
1576998_WestGermanyAtThe1972SummerOlympics.txt,1111,60,18,797,17,63,2,879
1577186_DunashIbnTamim.txt,755,12,62,275,103,49,20,447
1577192_TennisBall.txt,1094,16,68,367,164,72,37,640
1577739_NewZealandAtThe1972SummerOlympics.txt,996,64,15,669,38,20,25,752
157773_TheAtaris.txt,1176,16,73,488,121,87,54,750
157774_Permafrost.txt,1240,16,77,403,157,118,76,754
1577801_GuitarChord.txt,1565,37,42,463,242,179,59,943
157780_Lifespring.txt,1530,24,63,588,222,100,43,953
1577828_OtisCollegeOfArtAndDesign.txt,767,17,45,422,66,48,15,551
1577829_AylesburyUnitedFc.txt,923,16,57,377,101,64,25,567
157837_RomanceOfTheThreeKingdoms.txt,3860,51,75,1408,499,347,144,2398
1578776_LasVegasMetropolitanPoliceDepartment.txt,1058,17,62,581,110,42,15,748
1578785_CollegiateNetwork.txt,1585,23,68,982,114,80,14,1190
1579364_Avante.txt,1296,24,54,481,155,116,35,787
1579918_UssWinslowdd53.txt,1001,11,91,355,129,54,20,558
1579964_BalloonModelling.txt,2390,47,50,706,382,224,134,1446
1579971_ElectionStockMarket.txt,997,20,49,374,133,74,32,613
1579993_Dianailit.txt,716,19,37,387,42,34,5,468
1580966_FernandoLuisGarcia.txt,679,24,28,319,72,25,17,433
1581157_FarmersMovement.txt,1957,14,139,662,228,203,80,1173
158154_Manglish.txt,1326,27,49,412,195,141,89,837
158166_BritishAndMalaysianEnglishDifferences.txt,702,20,35,217,103,77,56,453
158181_EucalyptusRegnans.txt,1204,15,80,426,181,124,58,789
158185_Hangzhou.txt,1926,42,45,739,212,163,72,1186
158205_PeterPaulAndMary.txt,741,14,52,324,69,37,10,440
158208_AfrikaKorps.txt,1265,24,52,600,145,80,36,861
1582123_BeverleyNichols.txt,544,21,25,257,43,21,4,325
158222_TamLinhasAreas.txt,2118,43,49,745,280,120,58,1203
1582335_WorldsystemsTheory.txt,1597,20,79,563,195,163,70,991
1582678_Beatclub.txt,759,8,94,499,54,37,9,599
1583299_MaherShalalHashBaz.txt,640,11,58,352,48,26,8,434
1584291_GuastavinoTile.txt,1041,18,57,400,136,86,33,655
1584297_EastWoodhay.txt,1120,21,53,410,127,75,37,649
1584300_JohnAncrumWinslow.txt,676,9,75,244,109,28,19,400
1584668_2004PutativeVenezuelanCoupDtatAttempt.txt,1019,13,78,347,162,63,31,603
1584857_OogieBoogie.txt,1283,14,91,432,208,74,63,777
1585513_LinnbentonCommunityCollege.txt,618,19,32,266,79,44,16,405
1587723_BobParsons.txt,878,12,73,350,127,41,33,551
1588053_SvenNykvist.txt,873,16,54,374,80,45,13,512
1588642_AlexanderMackendrick.txt,1000,20,50,341,140,55,35,571
1588657_JohnSinclairpoet.txt,844,14,60,359,91,49,12,511
1588662_ListOfTdsForCarlowKilkenny.txt,629,27,23,524,6,34,1,565
1588689_StMichaelsChoirSchool.txt,732,11,66,314,90,37,22,463
1588851_Piasa.txt,681,10,68,243,94,45,25,407
1588866_TripleeSenate.txt,705,9,78,242,101,55,25,423
1588874_Slingers.txt,1047,9,116,338,180,81,44,643
1588891_Aviacsa.txt,698,17,41,350,64,33,12,459
158904_ArianaAfghanAirlines.txt,1107,21,52,481,133,54,25,693
1589081_Domus.txt,578,5,115,181,82,52,23,338
1589806_JamesRoot.txt,811,18,45,411,80,47,22,560
1589836_Contax.txt,2491,54,46,1035,266,226,77,1604
1590217_Homoglyph.txt,705,7,100,220,90,63,38,411
1590221_Rancor.txt,1084,17,63,402,158,49,28,637
1590225_RaiselakeDistrict.txt,849,10,84,304,103,63,38,508
1590850_AmosBurn.txt,587,9,65,236,48,33,16,333
1591026_Togodog.txt,893,15,59,329,121,44,13,507
1591028_AltafHussain.txt,970,12,80,367,133,89,33,622
1591064_Breathalyzer.txt,3291,41,80,1188,456,225,145,2014
1591075_JoeMcdoakes.txt,1224,14,87,438,142,51,27,658
1591387_AbleTeam.txt,1175,36,32,489,170,71,34,764
1592019_AaBattery.txt,590,13,45,198,79,69,43,389
159243_SexualArousal.txt,749,15,49,264,91,98,42,495
159244_Aleppo.txt,1304,17,76,486,150,90,41,767
159275_EmilyDickinson.txt,2319,36,64,810,326,176,104,1416
159283_Lusatia.txt,1292,23,56,539,150,107,41,837
159291_FortRiley.txt,3331,77,43,1319,450,212,62,2043
159292_PotassiumChloride.txt,752,14,53,271,109,83,33,496
159298_UltralightAviation.txt,1488,42,35,545,192,152,61,950
1593228_Tikopia.txt,591,12,49,213,79,50,25,367
1593245_TimelineOfTheAlgerianCivilWar.txt,1026,16,64,435,122,36,19,612
1593550_AdamoRuggiero.txt,657,14,46,191,125,44,28,388
1594216_LseStudentsUnion.txt,1312,23,57,650,98,68,21,837
1594772_WankhedeStadium.txt,612,8,76,236,66,40,10,352
1594773_BrabourneStadium.txt,1306,17,76,483,157,71,24,735
1596374_LanciaV4Engine.txt,605,22,27,203,75,35,21,334
1596422_YiXingLong.txt,1742,26,67,721,235,76,95,1127
1596425_ChristCollegeTasmania.txt,951,21,45,354,122,51,23,550
1596568_BarefootAndPregnant.txt,1117,14,79,383,163,107,51,704
1596576_Acholi.txt,660,14,47,312,59,57,11,439
1597536_AlanArnoldGriffith.txt,1191,14,85,364,178,107,49,698
1597543_IncirlikAirBase.txt,1639,32,51,735,178,111,25,1049
1597773_OtherCharactersInSonicTheHedgehog.txt,5254,82,64,1843,823,265,202,3133
1597964_Wastegate.txt,803,15,53,255,134,75,54,518
1598528_BishopLuffaSchool.txt,636,11,57,237,89,50,10,386
1598743_AnsonShupe.txt,1069,14,76,547,61,60,18,686
1598918_PierreDubois.txt,721,12,60,258,83,51,17,409
1598986_LopoldVictorDelisle.txt,675,8,84,231,77,65,10,383
159932_Silat.txt,1465,24,61,547,216,158,52,973
159955_Dio.txt,1482,35,42,720,159,58,54,991
1599718_ListOfStateLeadersIn874.txt,569,9,63,306,17,12,3,338
1599759_RantMedia.txt,1010,18,56,397,137,69,39,642
159994_MicrosoftFlightSimulator.txt,1580,31,50,697,173,131,48,1049
1599954_MusicOfSicily.txt,885,23,38,395,70,94,31,590
160067_TsetseFly.txt,4763,88,54,1868,650,410,198,3126
1601101_Placeshifting.txt,602,11,54,211,103,34,23,371
1601287_DomesticPartnershipInCalifornia.txt,2649,25,105,1011,330,255,84,1680
1601290_ForestZone.txt,1158,18,64,399,118,129,69,715
1601935_TheMindRobber.txt,1212,21,57,456,162,53,49,720
1601940_PoliticsOfTheIsleOfWight.txt,1507,36,41,493,173,152,63,881
16025_January20.txt,2108,6,351,1163,93,80,8,1344
16027_JKRowling.txt,3315,44,75,1238,505,183,88,2014
16028_JanHus.txt,3831,65,58,1259,585,202,115,2161
16032_JulioclaudianDynasty.txt,2929,46,63,1069,424,232,96,1821
160332_Ephemeris.txt,747,12,62,255,82,75,42,454
160333_MyGeneration.txt,1112,23,48,503,92,84,34,713
160338_Houseastrology.txt,2211,46,48,760,259,227,64,1310
160340_MarineCorpsBaseCampPendleton.txt,858,17,50,391,90,49,16,546
16034_JohnsonSolid.txt,816,21,38,248,154,65,24,491
160352_Samplingmusic.txt,4734,67,70,1539,724,373,221,2857
16036_JohnPeel.txt,6498,77,84,2476,821,381,235,3913
160376_Corregidor.txt,1917,43,44,748,222,125,36,1131
16037_JosephusOnJesus.txt,3814,47,81,1180,580,268,191,2219
160388_TinyTimmusician.txt,1772,26,68,683,222,107,62,1074
16044_JEdgarHoover.txt,2371,33,71,897,336,154,102,1489
16045_JamesThurber.txt,2081,25,83,830,230,117,64,1241
16046_JamesCagney.txt,1320,29,45,551,150,70,29,800
1605066_JackPiercemakeupArtist.txt,715,10,71,246,97,51,30,424
1605069_EuropeanTreeFrog.txt,641,9,71,200,81,68,30,379
1605255_NeathukParliamentConstituency.txt,774,19,40,288,89,45,29,451
1605292_DataTransformationServices.txt,1097,25,43,448,200,49,33,730
16053_JonathanRichman.txt,1226,18,68,525,127,79,34,765
16054_JargonFile.txt,1208,18,67,414,181,93,47,735
1606261_SaifAliKhan.txt,949,16,59,467,64,49,20,600
1606664_O2Xda.txt,1089,27,40,622,65,46,12,745
1606793_CyrilKnowles.txt,903,17,53,370,87,53,19,529
16074_JamesWhale.txt,937,12,78,373,108,57,34,572
16075_January9.txt,2485,5,497,1384,96,73,4,1557
16076_January10.txt,2106,6,351,1201,68,70,4,1343
16077_JohnHagelin.txt,950,16,59,421,82,60,16,579
16078_JavelinThrow.txt,662,10,66,295,81,40,23,439
16079_JamesMadisonUniversity.txt,3024,38,79,1336,335,178,77,1926
1608143_Wbrs.txt,855,12,71,349,98,67,31,545
1608149_KoreaHapkidoFederation.txt,731,9,81,544,36,23,6,609
1608179_JosephBarondess.txt,690,12,57,261,90,27,27,405
16082_Jericho.txt,1985,35,56,747,261,142,50,1200
1608380_MorrisHillquit.txt,515,8,64,231,57,23,6,317
16083_SocietyOfJesus.txt,8369,111,75,3091,1031,585,264,4971
1608958_JackHearnejohnWilliamHearne.txt,796,11,72,220,93,56,37,406
1609024_JosephMJuran.txt,736,21,35,301,91,47,13,452
1609327_ArcticChar.txt,870,18,48,291,146,90,46,573
1609333_ChattoogaRiver.txt,731,19,38,312,93,42,31,478
161019_Negation.txt,754,33,22,266,104,70,42,482
161022_IndianIndependenceMovement.txt,8737,101,86,3234,1120,682,207,5243
161034_VachelLindsay.txt,1691,37,45,661,170,105,56,992
161046_GopalKrishnaGokhale.txt,747,10,74,297,88,60,16,461
161085_SocialismWithChineseCharacteristics.txt,957,14,68,344,130,83,36,593
161087_MilitaryOfEastTimor.txt,624,14,44,277,64,37,14,392
161091_RodneyDangerfield.txt,1493,21,71,584,188,73,45,890
161095_Monologue.txt,1437,22,65,488,191,126,62,867
1611195_Gonne.txt,704,9,78,223,107,53,23,406
1611202_HamidianMassacres.txt,1119,17,65,375,162,74,25,636
1611516_BenedictionalOfStthelwold.txt,763,8,95,240,123,35,24,422
1612159_FcRostov.txt,3177,59,53,1099,453,252,101,1905
1612343_RajshahiUniversity.txt,3932,38,103,1479,506,348,119,2452
1612519_MaddenNfl2005.txt,644,5,128,309,58,37,15,419
1612686_HalloweenResurrection.txt,808,8,101,315,98,43,27,483
1612722_ListOfGeneticsrelatedTopics.txt,2378,29,82,2223,32,57,4,2316
1612749_AmarChitraKatha.txt,756,11,68,297,101,80,23,501
1613304_SlovakNationalUprising.txt,1892,28,67,739,247,114,37,1137
1613306_KazuhideUekusa.txt,937,21,44,325,133,46,31,535
161420_Sallust.txt,1024,23,44,346,118,74,39,577
161441_RecruitmentToTheBritishArmyDuringWorldWarI.txt,1020,10,102,306,169,78,40,593
1614455_MoneyForNothingsong.txt,1437,25,57,527,195,114,40,876
1614461_BattleOfWakeIsland.txt,1911,30,63,749,236,163,47,1195
161452_BadDayAtBlackRock.txt,2185,36,60,804,404,80,71,1359
161466_RockHudson.txt,1770,19,93,747,214,101,39,1101
161467_TheognisOfMegara.txt,913,16,57,316,108,82,32,538
1614701_OldMarketSquare.txt,808,12,67,299,113,63,34,509
161479_ShortStirling.txt,2113,27,78,738,299,150,88,1275
161482_SugeKnight.txt,2187,19,115,869,342,89,88,1388
1614906_CivilContingenciesAct2004.txt,1173,30,39,499,135,78,23,735
1615871_BattleOfCarthage1861.txt,894,11,81,368,130,37,24,559
1615875_BattleOfFortDavidson.txt,1064,13,81,388,160,52,32,632
1615891_BattleOfBoonville.txt,1149,19,60,405,193,67,50,715
1615921_BattleOfSpringHill.txt,675,9,75,313,89,26,15,443
1616062_ShortageEconomy.txt,643,14,45,242,92,40,35,409
1616696_UssHammerbergde1015.txt,663,17,39,327,70,20,10,427
1616701_TactileSigning.txt,1310,21,62,490,180,97,58,825
1617653_MinorDarkWizardsInHarryPotter.txt,2387,61,39,863,386,104,98,1451
1617656_ShaulTchernichovsky.txt,805,16,50,296,89,43,22,450
1618066_NicholasStern.txt,566,10,56,208,61,37,7,313
1618069_Palekastro.txt,660,12,55,252,89,59,26,426
1618669_MercuryArcValve.txt,1417,24,59,552,168,129,38,887
1618869_Rohanfamily.txt,674,13,51,246,67,52,14,379
1619231_Copedent.txt,493,13,37,178,34,19,2,233
1619249_UniversityOfSaintMaryOfTheLake.txt,1224,27,45,463,130,95,17,705
1619826_ArchieGemmill.txt,1198,22,54,398,184,75,40,697
1620243_SchedularSystemOfTaxation.txt,2099,39,53,794,307,171,89,1361
1620422_EmmittPeters.txt,672,12,56,228,87,49,24,388
1620847_LaloGuerrero.txt,647,8,80,289,74,40,9,412
1621040_InterlochenCenterForTheArts.txt,1335,32,41,621,148,77,26,872
1621411_LansdownePortrait.txt,601,8,75,235,62,45,11,353
1621432_RightOfAsylum.txt,1846,25,73,579,272,139,78,1068
1621467_MsYMenos.txt,702,11,63,254,122,40,19,435
162163_BolandAmendment.txt,693,10,69,254,103,42,21,420
162173_Islamophobia.txt,5900,57,103,2197,851,401,155,3604
162176_RoguecomputerGame.txt,750,12,62,272,101,68,30,471
162182_GastonLeroux.txt,767,15,51,382,56,38,7,483
162183_Ieee488.txt,867,19,45,345,95,96,27,563
162186_InteractiveVoiceResponse.txt,859,30,28,366,134,65,23,588
1622369_LeoGamez.txt,1240,19,65,466,159,71,40,736
162248_Lothal.txt,5340,46,116,2006,736,441,132,3315
162249_MarkHanna.txt,956,16,59,375,126,66,31,598
162250_AlbertIPrinceOfMonaco.txt,1077,18,59,418,123,69,28,638
1623147_MetalArmsGlitchInTheSystem.txt,4889,78,62,1644,706,353,223,2926
1623227_EcommercePaymentSystems.txt,1015,17,59,383,140,93,35,651
1624178_1925SerumRunToNome.txt,4801,53,90,1720,691,245,116,2772
1624755_AliceSebold.txt,727,4,181,264,117,17,21,419
1624762_Yiquan.txt,646,6,107,262,88,50,17,417
1624784_LisaOnIce.txt,1409,11,128,529,219,57,63,868
1624798_HolyFire.txt,881,16,55,315,120,55,40,530
162498_NuclearMeltdown.txt,2512,35,71,883,320,246,118,1567
162522_January2002.txt,953,24,39,560,42,43,3,648
162533_LouisPhilippe.txt,663,5,132,242,65,45,18,370
162540_BirdOfParadise.txt,912,26,35,434,114,59,35,642
162549_HistoryOfMacOsX.txt,1259,17,74,529,163,105,43,840
162557_Collusion.txt,676,15,45,275,80,57,22,434
162567_JapaneseBeetle.txt,701,19,36,305,84,68,20,477
1626537_IndianFolkDances.txt,3204,50,64,1211,398,223,85,1917
1626757_CompaniesListedOnTheSingaporeExchange.txt,2234,109,20,2151,5,19,2,2177
1626973_BartTheDaredevil.txt,1058,11,96,353,170,56,49,628
1627555_ArnaudDossat.txt,773,10,77,270,74,73,22,439
1627918_4thGenieAwards.txt,613,59,10,559,4,12,0,575
1627934_FirstLoveLastRites.txt,1182,14,84,356,182,77,44,659
1627979_Live197585.txt,959,10,95,445,69,32,32,578
1629104_JerseyPound.txt,773,20,38,299,106,48,17,470
1629134_BojiStone.txt,699,14,49,250,98,70,27,445
1630113_PingShan.txt,718,25,28,318,89,52,19,478
1630767_ListOfPeopleInStPetersburg.txt,1097,6,182,613,95,33,25,766
1631335_RevisedCommonLectionary.txt,1285,18,71,456,150,90,48,744
1632292_BaltasarGracin.txt,1209,16,75,448,126,83,26,683
1632314_Firecrafter.txt,3732,36,103,1420,465,216,111,2212
1632324_FlyTying.txt,1409,57,24,505,214,133,87,939
163247_ChineseName.txt,2658,40,66,918,372,287,157,1734
1632486_ListOfRacingDriversWhoDiedInRacingCrashes.txt,2821,50,56,1990,54,81,12,2137
163272_JohnBonham.txt,2294,32,71,1070,261,100,69,1500
163276_Philomena.txt,1885,25,75,669,282,109,56,1116
1633120_SantaMariaDeBelm.txt,591,11,53,241,72,47,9,369
1633123_HendersonStateUniversity.txt,6050,121,50,2569,685,384,139,3777
163336_PeterShaffer.txt,583,8,72,246,64,30,6,346
1633444_KarlLudwigSand.txt,1242,9,138,766,98,46,15,925
1633471_OctoberDiploma.txt,697,12,58,254,89,53,27,423
1635643_VoiceActivityDetection.txt,1389,23,60,566,195,121,40,922
1635705_ListOfRealTennisWorldChampions.txt,642,14,45,293,63,27,14,397
163586_ViennaNewYearsConcert.txt,930,18,51,393,91,57,34,575
163588_RoddyMcdowall.txt,1459,16,91,679,86,64,13,842
163597_TheLeagueOfGentlemen.txt,1893,37,51,676,219,162,76,1133
163617_Chicory.txt,627,17,36,231,96,49,23,399
1636261_DiversityJurisdiction.txt,895,11,81,305,148,52,24,529
163628_JohnHume.txt,940,19,49,364,96,64,29,553
163629_AmericanPsycho.txt,2121,34,62,808,257,160,84,1309
163633_GeorgSolti.txt,1117,22,50,435,137,65,25,662
163639_DennisPotter.txt,1543,21,73,570,203,103,55,931
163645_JosephAddison.txt,1748,37,47,630,241,106,58,1035
163647_AldusManutius.txt,1424,17,83,540,180,65,35,820
163649_BuyNothingDay.txt,592,9,65,227,86,45,26,384
163650_JacopoSannazaro.txt,685,11,62,269,74,44,11,398
163651_JovianusPontanus.txt,865,11,78,293,99,69,35,496
163658_JohnAddingtonSymonds.txt,1679,28,59,550,214,128,45,937
1636616_LegalSystemOfHongKong.txt,2100,21,100,895,199,170,32,1296
163661_ThomasLinacre.txt,1235,15,82,451,162,75,35,723
163678_Kalimantaan.txt,653,10,65,239,95,37,20,391
1636836_Kgtv.txt,747,18,41,372,33,28,27,460
163684_JohnRedwood.txt,914,11,83,381,98,56,36,571
163697_Weyr.txt,2483,37,67,842,371,194,109,1516
163704_JoachimDuBellay.txt,1886,18,104,642,244,140,54,1080
163710_WastelandcomputerGame.txt,990,15,66,348,153,61,36,598
163711_Harrowtool.txt,611,11,55,178,101,49,33,361
1637468_ListOfBangladeshiCricketers.txt,886,6,147,421,2,110,2,535
1637852_HistoryOfNorthAfrica.txt,997,18,55,386,103,70,44,603
1638439_TropicanaClub.txt,759,11,69,336,88,36,12,472
1638631_RichardTaylorgeneral.txt,2192,25,87,866,298,113,65,1342
1638830_Cowden.txt,614,17,36,214,83,50,21,368
1638840_BusinessProcessReengineering.txt,4883,64,76,1808,718,375,173,3074
1639015_CommunityCouncil.txt,1000,19,52,365,145,69,43,622
1640055_UssHalligandd584.txt,1123,19,59,461,157,58,18,694
16403_JustinMartyr.txt,3412,29,117,1071,464,183,141,1859
1640974_BuckRam.txt,628,10,62,243,86,30,18,377
1640978_ScienceAndInventionInBirmingham.txt,2008,58,34,812,239,174,36,1261
1640986_PublicUniversity.txt,1214,24,50,431,145,165,51,792
1641203_PaschalCycle.txt,605,6,100,298,37,37,10,382
16412_JamesTiptreeJr.txt,2775,28,99,1275,236,166,72,1749
1642126_JuanFranciscoDeLaBodegaYQuadra.txt,1404,18,78,589,172,70,43,874
1642974_TheTrialsong.txt,1050,22,47,355,157,73,30,615
1643341_VerticalPunch.txt,602,5,120,170,107,42,41,360
1643361_IndependentWomenPartI.txt,617,14,44,304,46,50,8,408
1643377_JohnElliottCairnes.txt,2120,16,132,660,258,202,70,1190
164339_TinyToonAdventures.txt,2560,42,60,1192,312,180,67,1751
164342_TelevisionMovie.txt,1194,25,47,466,143,122,57,788
164344_BobbyFuller.txt,1256,18,69,578,97,56,25,756
164365_TheChinaSyndrome.txt,924,12,77,389,129,47,25,590
1644300_DoubleCrosssliders.txt,912,10,91,314,126,55,25,520
1645142_UssTangierav8.txt,1804,16,112,701,209,100,43,1053
1645518_Massachusetts.txt,5810,79,73,2299,617,538,164,3618
1645570_ActiveManagement.txt,857,17,50,293,113,99,50,555
1646485_MassachusettsWrestling.txt,2557,29,88,1154,289,179,75,1697
1646486_ForteSpagnolo.txt,663,10,66,216,98,44,27,385
1646532_SantaMariaDiCollemaggio.txt,887,11,80,302,106,73,23,504
1646575_Chuckengineering.txt,1135,26,43,367,196,114,32,709
16467_JohnWalkerLindh.txt,2098,31,67,791,329,108,56,1284
1647133_OnevoyagerEpisode.txt,1123,19,59,326,195,47,39,607
16472_JetStream.txt,1718,21,81,586,221,169,72,1048
1647736_UssSolaceah5.txt,1009,12,84,353,145,39,22,559
1648665_MapsOfTheUkAndIreland.txt,1076,29,37,621,54,64,13,752
1648694_Riken.txt,1089,16,68,474,106,65,38,683
1648727_CultureOfTrinidadAndTobago.txt,1265,27,46,562,158,102,42,864
1648733_ListOfOrganicCompounds.txt,2319,73,31,1687,85,174,33,1979
1648746_BeateUhserotermund.txt,1472,23,64,495,220,91,56,862
1648752_Baidoa.txt,621,10,62,233,90,35,13,371
1648890_HellsAngelsTheStrangeAndTerribleSagaOfTheOutlawMotorcycleGangs.txt,658,11,59,247,82,42,29,400
1648915_ChemicalPlant.txt,1440,15,96,525,230,152,71,978
1649550_TuckPatti.txt,1085,14,77,392,150,82,38,662
1649855_TheBigBreak.txt,4308,63,68,1835,551,230,132,2748
1650511_ChristianityInChina.txt,4240,67,63,1619,503,380,136,2638
1650869_VaishaliDistrict.txt,731,12,60,332,80,44,19,475
1650871_MoiraineDamodred.txt,1280,11,116,400,211,59,53,723
1651671_SomaCruz.txt,1673,14,119,549,244,124,79,996
1652087_PhiMu.txt,1121,41,27,790,59,38,13,900
1652116_DesolationWilderness.txt,719,14,51,365,75,59,19,518
1653906_Hulldown.txt,1033,19,54,295,170,121,52,638
1653918_Arabist.txt,1200,19,63,481,124,80,32,717
1654243_TankResearchAndDevelopment.txt,1607,15,107,554,235,181,69,1039
165431_Magmaband.txt,930,23,40,376,108,91,37,612
165441_PaulSignac.txt,702,22,31,273,85,50,17,425
1654878_PrisonBook.txt,855,13,65,259,155,47,40,501
1655059_Vidyapati.txt,623,13,47,225,84,46,27,382
1655069_Bilimbi.txt,617,15,41,196,101,60,29,386
165507_AvrilLavigne.txt,2665,42,63,982,363,185,86,1616
1655202_MarylhurstUniversity.txt,927,45,20,479,87,53,3,622
1655263_AskeHall.txt,737,9,81,267,101,43,23,434
1656423_HestonBlumenthal.txt,731,11,66,272,90,71,21,454
1656479_Mannlicherschnauer.txt,596,10,59,201,63,75,25,364
1657394_Mark14.txt,4009,56,71,1196,702,161,188,2247
1657433_Ziggurat8.txt,2034,31,65,717,316,97,69,1199
1657443_ListOfAcronymsAndInitialismsD.txt,2558,29,88,1652,31,105,9,1797
1657585_ListOfAcronymsAndInitialismsT.txt,1984,27,73,1253,23,72,12,1360
165813_ManchesterCityFc.txt,2974,51,58,1137,341,218,76,1772
165846_ClevelandSpiders.txt,611,13,47,216,70,49,17,352
165847_BookerTTheMgs.txt,1989,29,68,830,254,113,85,1282
165848_LilianBaels.txt,1217,22,55,450,156,94,33,733
165851_IndustrialDesign.txt,1223,28,43,497,143,122,36,798
165852_SamDave.txt,1467,29,50,519,181,78,43,821
1658553_ColeYounger.txt,1492,16,93,594,205,74,34,907
1658556_Sjdis.txt,933,16,58,403,132,59,19,613
165857_DuaneEddy.txt,1504,18,83,672,175,99,25,971
165864_TheShirelles.txt,1701,10,170,757,154,94,43,1048
165886_RockefellerCenter.txt,1805,28,64,849,164,102,37,1152
165887_SlyStone.txt,1994,24,83,823,224,119,66,1232
1659342_ValentinoMazzola.txt,810,21,38,274,114,50,37,475
1659344_Fenqing.txt,767,8,95,267,91,98,46,502
1659396_SaebSalam.txt,839,10,83,297,122,35,18,472
1659410_SocialistUnityNetwork.txt,576,14,41,220,80,40,19,359
1659799_LeoKu.txt,1187,18,65,524,78,62,22,686
1660748_LawClerk.txt,1457,27,53,620,170,107,59,956
1661977_Bloodlinescomics.txt,767,16,47,367,70,64,13,514
1661992_BadwaterUltramarathon.txt,1243,20,62,478,154,88,43,763
1662543_ListOfLebanonrelatedTopics.txt,974,33,29,535,7,35,2,579
1662934_OgadenNationalLiberationFront.txt,912,15,60,349,135,46,17,547
1663685_ListOfFictionalFoodsAndBeveragesInStarTrek.txt,1016,28,36,410,148,85,38,681
1663947_CouncilOfTheAmericas.txt,639,12,53,385,51,24,10,470
1665137_MissJulie.txt,980,12,81,315,160,58,45,578
166518_PubQuiz.txt,1267,24,52,410,198,90,65,763
166519_MahaliaJackson.txt,838,16,52,411,71,38,16,536
1665301_ShoheiBaba.txt,1125,11,102,462,132,73,28,695
1665312_MarieCarolineOfAustria.txt,579,8,72,220,68,29,16,333
166531_SaadiaGaon.txt,2413,34,70,905,294,161,95,1455
1666132_MilfordTownshipButlerCountyOhio.txt,659,10,65,299,49,39,4,391
1666267_TheCapitols.txt,872,18,48,379,90,57,16,542
1666272_UssHaradendd585.txt,958,16,59,414,109,41,13,577
1666311_RoseOnline.txt,2180,45,48,839,315,176,101,1431
1666314_BryceWilson.txt,650,16,40,317,62,30,16,425
1666316_Heyoka.txt,1108,18,61,388,186,60,37,671
1666883_PhenomenologyOfReligion.txt,1544,13,118,640,167,96,42,945
1666893_AYearInTheMerde.txt,903,23,39,271,137,67,46,521
1667488_FrenshamSchool.txt,698,10,69,328,72,23,5,428
1668026_SamRagan.txt,1038,12,86,553,73,51,15,692
166915_JimCroce.txt,849,17,49,352,87,68,20,527
166929_IndoeuropeanAblaut.txt,2355,48,49,725,297,291,101,1414
166945_Cartilage.txt,1166,21,55,440,180,118,40,778
166957_BaathParty.txt,3731,53,70,1449,419,306,108,2282
166959_MattDamon.txt,1326,19,69,533,191,84,36,844
166963_ListOfAlbanians.txt,3296,31,106,2288,18,191,7,2504
1669640_EnglandNationalFootballTeamRecords.txt,2437,13,187,1231,48,88,15,1382
166964_GeorgeLansbury.txt,1043,14,74,398,134,55,39,626
1669681_AustrianPostalCodes30003099.txt,2775,3,925,1190,7,223,1,1421
1669691_AustrianPostalCodes31003199.txt,3267,3,1089,1576,27,215,1,1819
1671816_ListOfPeopleByNameBusbuz.txt,808,10,80,604,3,34,2,643
1672443_FenderBassVi.txt,1289,36,35,522,154,89,44,809
1672787_3rdSsDivisionTotenkopf.txt,3320,52,63,1255,490,221,86,2052
1672976_AccBigTenChallenge.txt,781,46,16,376,49,20,14,459
1673003_ChuckHarder.txt,1506,22,68,578,195,138,44,955
1674015_DerbyMidlandRailwayStation.txt,2618,48,54,971,341,159,77,1548
1674691_DeadlinecomputerGame.txt,848,14,60,321,121,60,27,529
1675644_ListOfProvostsAndLordProvostsOfAberdeen.txt,1086,6,181,680,11,19,4,714
167596_ProtectedMode.txt,1211,26,46,456,173,86,58,773
167599_MenInBlackfilm.txt,1554,23,67,696,195,85,46,1022
1676149_LambethDegree.txt,914,14,65,335,116,51,34,536
167622_ColinWilson.txt,1799,11,163,832,114,97,27,1070
167663_TheSmallFaces.txt,2739,60,45,1287,298,158,81,1824
167680_TheElectricPrunes.txt,1040,23,45,413,123,80,31,647
167683_Mittelschmerz.txt,661,18,36,206,98,63,34,401
1677157_Overdubbing.txt,702,11,63,246,111,61,39,457
1677369_MartinVZiherl.txt,830,11,75,305,127,57,34,523
1679557_Covenantalias.txt,630,6,105,283,94,34,14,425
167999_RiscOs.txt,3117,47,66,1165,493,255,105,2018
168000_Inuyashacharacter.txt,7434,59,126,2346,1180,475,428,4429
168006_CecilJohnRhodes.txt,2656,35,75,977,352,155,72,1556
168007_ReadingFc.txt,2228,35,63,898,264,147,60,1369
1680120_ListOfTheCatholicCathedralsOfTheUnitedStates.txt,2477,83,29,1606,51,31,8,1696
168037_StationWagon.txt,3572,57,62,1255,511,320,142,2228
168041_AnatomicalTermsOfLocation.txt,1995,35,57,638,250,237,71,1196
168053_Boto.txt,867,18,48,353,117,64,37,571
1681334_Cobrala.txt,792,8,99,279,134,45,26,484
1681520_SetonHallPreparatorySchool.txt,644,13,49,321,49,55,10,435
1681700_RobertLawrenceKuhn.txt,2733,28,97,1382,229,153,32,1796
1681714_Mybulletinboard.txt,712,21,33,361,91,44,12,508
1682298_AsymptoticallyFlatSpacetime.txt,1966,23,85,589,246,267,134,1236
1682665_MissIndependent.txt,653,11,59,199,109,64,34,406
1682669_InternetworkProtocol.txt,858,24,35,343,127,53,27,550
1682871_LittleBuddha.txt,597,17,35,222,94,19,29,364
1682875_Schillerband.txt,650,22,29,277,62,43,29,411
1683327_LeeBowyer.txt,594,14,42,232,81,40,17,370
1683879_Ithkuil.txt,620,14,44,185,95,67,34,381
1685699_CarlGustavFleischer.txt,827,12,68,301,104,66,18,489
1686070_SailingBallast.txt,999,9,111,290,185,96,39,610
168682_PanaviaTornado.txt,1857,29,64,782,223,116,47,1168
168687_HeySlavs.txt,976,15,65,351,130,89,40,610
168689_Transmeta.txt,1787,29,61,677,237,136,82,1132
1687051_Sobrassada.txt,840,23,36,324,118,86,30,558
1687059_GuineabissauPresidentialElection2005.txt,1222,17,71,498,163,98,12,771
168706_MoneySupply.txt,2286,42,54,884,278,186,93,1441
168707_TreyAnastasio.txt,3134,51,61,1324,361,192,85,1962
1687680_JorgeCardinalBergoglio.txt,836,14,59,294,116,65,16,491
1687743_BuddhismInBrazil.txt,580,10,58,253,55,56,21,385
1688230_AliaksandrHleb.txt,725,21,34,285,78,49,23,435
1688280_FranciscoJavierCardinalErrzuriz.txt,789,11,71,334,61,44,4,443
1688282_Kpnx.txt,1290,34,37,664,95,67,41,867
1688816_CanadaAtThe1976SummerOlympics.txt,666,34,19,427,23,24,8,482
1689234_UsaCartoonExpress.txt,791,15,52,481,43,32,10,566
1690036_FlipCup.txt,1321,25,52,393,207,76,58,734
1690360_GunjiKoizumi.txt,858,25,34,299,117,44,18,478
1690363_RaoFarmanAli.txt,1493,20,74,547,249,56,40,892
1690376_TypesOfCorporations.txt,3041,121,25,1509,278,321,67,2175
1690398_EmanuelCeller.txt,883,16,55,317,99,57,27,500
1690405_BrooklynCityRailRoad.txt,701,12,58,352,57,33,15,457
1690431_RonDarling.txt,2875,35,82,864,419,234,101,1618
1690432_JeepersCreepersfilm.txt,931,17,54,365,150,41,32,588
169071_Smilodon.txt,677,30,22,275,89,50,18,432
1690983_TracySmothers.txt,1090,33,33,597,83,47,19,746
1690988_GlobalWrestlingFederation.txt,1193,18,66,567,144,71,29,811
169102_Vegetius.txt,726,9,80,264,79,75,21,439
169112_JacquesAntoineHippolyteComteDeGuibert.txt,663,8,82,248,67,57,16,388
169143_JulieWalters.txt,574,11,52,275,50,24,11,360
169144_GnuLilypond.txt,729,23,31,275,98,64,26,463
169146_ColdCathode.txt,627,13,48,242,102,61,33,438
1691581_Millonarios.txt,629,16,39,350,44,23,10,427
1692020_RomanCatholicDioceseOfArlington.txt,624,81,7,440,24,10,4,478
1692535_CadillacSeries70.txt,616,23,26,166,70,57,16,309
1692611_AllianceForTheFutureOfAustria.txt,2171,29,74,790,247,164,72,1273
1693165_ConcurrentEstate.txt,2352,34,69,735,286,178,82,1281
1693168_FrantiekHrubn.txt,827,6,137,363,42,59,7,471
1693569_RodDedeaux.txt,948,9,105,309,133,52,32,526
1693743_Isaaq.txt,538,8,67,327,19,34,10,390
1694384_Tc.txt,788,9,87,281,117,52,23,473
1694703_OverthehorizonRadar.txt,1492,17,87,500,220,127,72,919
1694764_BillHaast.txt,1065,17,62,352,182,67,36,637
1694786_GomeryCommission.txt,1496,25,59,553,231,122,33,939
1695397_GeelongGrammarSchool.txt,1708,40,42,751,183,95,30,1059
1695749_SingaporeGuards.txt,1249,29,43,458,176,100,35,769
1695750_OldGutnish.txt,714,8,89,351,71,41,10,473
1696941_AnarchicComedyFilm.txt,864,12,72,341,86,87,24,538
1696945_HomerDefined.txt,795,13,61,311,113,40,33,497
1697127_BattleClash.txt,1033,17,60,383,147,66,46,642
1697757_PapalConclave1914.txt,866,14,61,449,81,45,11,586
169778_GoldenEarring.txt,1312,18,72,503,149,104,27,783
169784_Nili.txt,748,23,32,288,111,30,21,450
1697928_PeacockBass.txt,768,14,54,300,86,93,34,513
169798_SoniaGandhi.txt,2093,32,65,823,276,91,55,1245
169861_ScottishGreenParty.txt,991,25,39,448,101,66,26,641
169863_Hypocrisy.txt,666,19,35,208,122,52,33,415
1698794_ArtisticRollerSkating.txt,1058,16,66,399,149,103,42,693
1698796_RememberWenn.txt,1340,5,268,456,227,94,59,836
169900_Margarita.txt,1240,26,47,486,161,81,52,780
1699957_SalmanAlfarsi.txt,1064,27,39,344,166,59,37,606
1701470_GreatBritainAndNorthernIrelandAtThe1980SummerOlympics.txt,1004,66,15,659,31,27,12,729
170157_ParaaqueCity.txt,802,19,42,478,42,55,12,587
170158_StatisticalThermodynamics.txt,989,21,47,373,103,120,27,623
170160_CantonOfSchwyz.txt,923,20,46,320,108,62,32,522
170162_Preference.txt,878,20,43,302,118,69,43,532
170164_MuntinlupaCity.txt,960,20,48,517,68,70,26,681
170191_Role.txt,1209,15,80,341,189,119,63,712
170194_TheDamBustersfilm.txt,1683,32,52,597,254,101,59,1011
170211_RabbitsInAustralia.txt,918,19,48,312,153,73,49,587
1702123_Fzeroseries.txt,3669,53,69,1367,491,333,125,2316
170215_StepperMotor.txt,963,14,68,304,153,99,51,607
170230_Top40radioFormat.txt,1780,19,93,751,182,147,57,1137
1703085_IslandsOfAdventure.txt,1108,20,55,487,131,73,34,725
1703150_GhostWorld.txt,1037,24,43,347,148,83,50,628
1703649_AsiaCooperationDialogue.txt,568,20,28,237,51,56,12,356
1704228_SoilConservation.txt,1784,33,54,700,257,181,62,1200
1704664_EdwardBond.txt,1488,25,59,574,173,102,36,885
1704694_ForeignAgriculturalService.txt,892,14,63,412,99,46,17,574
1705627_Liquidmetal.txt,667,10,66,257,71,77,22,427
1705649_Lovech.txt,957,20,47,406,85,85,18,594
1705826_OilCanBoyd.txt,717,16,44,250,84,37,13,384
1706275_RaneyNickel.txt,1844,32,57,651,274,176,66,1167
1706779_TofikBakhramov.txt,739,11,67,222,110,39,41,412
1707428_StVincentGardensMelbourne.txt,1016,21,48,428,125,82,15,650
1707979_WindowsPresentationFoundation.txt,1996,32,62,894,253,164,55,1366
1708003_Simpliciusoperetta.txt,1465,25,58,510,226,78,60,874
1708981_SamuelMorland.txt,628,8,78,216,85,45,15,361
1709033_GreatSetoBridge.txt,709,11,64,259,95,36,13,403
170927_Pertussis.txt,1568,15,104,591,214,147,54,1006
170992_Sp500.txt,1201,25,48,440,141,92,62,735
1709984_EquivalencePartitioning.txt,693,16,43,203,112,46,27,388
1709986_BoundaryValueAnalysis.txt,659,14,47,199,91,48,21,359
171003_DanielDaylewis.txt,1880,28,67,631,293,111,67,1102
1710215_BlackpoolTramway.txt,1796,33,54,655,269,90,28,1042
1711155_CrcbasedFraming.txt,804,10,80,282,118,84,21,505
17112_Hmac.txt,759,10,75,295,97,38,13,443
17121_KurtSchwitters.txt,1119,17,65,485,130,54,26,695
17123_Karachi.txt,5450,85,64,2314,654,420,174,3562
171259_1990InFilm.txt,868,14,62,633,30,7,1,671
17125_KerguelenIslands.txt,1390,20,69,572,128,140,32,872
171268_ChrisRock.txt,1646,23,71,724,191,105,45,1065
171275_BenJerrys.txt,1362,24,56,573,165,65,39,842
171279_1989InFilm.txt,1242,13,95,823,67,19,3,912
171288_Chalcis.txt,723,15,48,259,82,50,18,409
171290_WestCoastHipHop.txt,3722,41,90,1443,510,296,150,2399
171292_1988InFilm.txt,858,14,61,655,30,6,7,698
171293_1987InFilm.txt,869,14,62,652,26,8,1,687
171300_SouthernHipHop.txt,2058,26,79,990,214,170,66,1440
171302_Nostalgia.txt,1314,18,73,454,175,102,67,798
171305_JohnReith1stBaronReith.txt,2281,47,48,795,337,125,57,1314
17130_KelseyGrammer.txt,1050,22,47,462,118,44,16,640
1713353_FrancisBaring.txt,4810,47,102,1711,591,336,163,2801
1713388_AustralasianPerformingRightAssociation.txt,1656,32,51,809,159,90,28,1086
1713536_RockCarvingsAtAlta.txt,2009,21,95,625,331,201,100,1257
171353_TheobaldWolfeTone.txt,3215,29,110,1090,450,212,90,1842
1713552_AdobeFlashPlayer.txt,1001,14,71,433,136,69,36,674
17135_KentuckyDerby.txt,1474,21,70,601,197,92,38,928
1714183_ControllercontrolTheory.txt,1177,19,61,350,192,110,59,711
1714337_ListOfScottishExecutiveMinisterialTeams.txt,568,18,31,281,72,18,0,371
17143_Koala.txt,2142,28,76,708,309,210,109,1336
1714530_NgauTauKok.txt,599,11,54,297,66,40,14,417
1715107_FloriaSigismondi.txt,721,12,60,401,53,40,14,508
17156_Kipper.txt,669,12,55,207,129,52,32,420
17160_Knife.txt,4434,64,69,1480,739,426,207,2852
17161_KachAndKahaneChai.txt,1586,56,28,768,176,62,24,1030
17165_KalahariDesert.txt,784,12,65,323,96,57,23,499
17166_KatangaProvince.txt,912,20,45,354,113,56,26,549
1716721_AndrewJacksonDonelson.txt,723,10,72,308,84,49,13,454
1716726_JohnPart.txt,862,19,45,294,113,51,32,490
17168_Kathmandu.txt,1147,26,44,447,146,91,35,719
17171_Kiosk.txt,828,13,63,334,92,77,27,530
1717663_AssociatedPublicSchoolsOfVictoria.txt,603,9,67,419,30,19,5,473
1717889_SalvationInCatholicism.txt,1654,15,110,557,211,112,71,951
1718356_HughRose1stBaronStrathnairn.txt,1580,15,105,510,201,106,30,847
1718506_JohannKasparBluntschli.txt,700,9,77,262,75,39,16,392
1719868_LeonardKnight.txt,1176,19,61,320,218,43,70,651
1720074_FawcettPublications.txt,5235,60,87,2205,678,250,147,3280
172017_PrincessEugenieOfYork.txt,760,14,54,313,96,38,27,474
172020_MarlboroughCollege.txt,1554,28,55,845,140,93,32,1110
172022_TeKooti.txt,848,11,77,313,141,29,34,517
172029_JeanneEagels.txt,873,11,79,315,111,50,25,501
172083_1959InFilm.txt,624,14,44,453,18,16,1,488
172089_1956InFilm.txt,603,16,37,427,18,5,1,451
172090_1955InFilm.txt,631,16,39,437,21,11,1,470
172094_1952InFilm.txt,670,16,41,455,34,12,3,504
172095_1951InFilm.txt,517,16,32,352,20,5,6,383
1721035_PhilipAhn.txt,1009,17,59,404,146,66,27,643
1721061_BaseballTonight.txt,980,13,75,484,84,59,44,671
1721069_FrankNicklin.txt,1876,28,67,607,302,152,83,1144
1721674_LithuanianRock.txt,2168,49,44,850,242,233,60,1385
1722025_Brandenburgers.txt,3330,71,46,1271,500,204,92,2067
1722026_SoulReaver.txt,1076,17,63,375,165,56,47,643
1722214_DragonwheelOfTime.txt,609,14,43,201,99,36,22,358
1722825_PeteNewell.txt,799,19,42,345,96,43,20,504
1723230_HamburgUbahn.txt,1538,31,49,492,222,120,52,886
172352_Democrats66.txt,3178,38,83,1174,410,288,82,1954
172405_1946InFilm.txt,745,13,57,509,33,15,0,557
172421_1940InFilm.txt,571,11,51,355,36,13,7,411
172424_Stocking.txt,1372,15,91,418,199,134,82,833
172427_FuturesStudies.txt,4015,58,69,1865,372,375,109,2721
172428_Tracker.txt,1641,28,58,605,224,169,79,1077
172431_Fuelband.txt,805,20,40,310,118,42,28,498
172432_1939InFilm.txt,765,12,63,505,33,14,5,557
172436_1938InFilm.txt,617,10,61,389,55,7,6,457
1724395_PatMiletich.txt,1251,12,104,452,102,49,20,623
1724397_ScottSkiles.txt,1048,13,80,387,130,69,19,605
172443_1936InFilm.txt,574,10,57,395,47,10,1,453
172451_1934InFilm.txt,1081,10,108,727,98,14,5,844
172458_VerticalHorizon.txt,1065,21,50,395,141,83,59,678
1725366_FridayscartoonNetwork.txt,759,17,44,392,86,40,23,541
1726582_JamesEmersonTennent.txt,597,11,54,223,69,22,7,321
1726636_Wdrq.txt,1191,15,79,517,124,71,67,779
1727255_TheWestWingPresidentialElection2006.txt,4871,65,74,1743,718,370,168,2999
1727257_AchillesLastStand.txt,603,9,67,214,80,42,26,362
1727260_AlmostLive.txt,967,14,69,441,114,73,39,667
1727572_ChineseCharacterClassification.txt,1832,29,63,619,234,189,78,1120
1728198_NationalFireIncidentReportingSystem.txt,600,9,66,260,72,40,12,384
1728579_Mr.txt,2542,51,49,1006,327,173,90,1596
1728592_NoahBeerySr.txt,628,7,89,297,48,23,13,381
1728797_JohnClarkMarshman.txt,956,29,32,326,123,54,32,535
1729356_AnaIvanovi.txt,1110,22,50,392,123,85,23,623
1729754_WhiteRockCreek.txt,764,14,54,364,84,44,33,525
1730770_JuanitaNelson.txt,757,14,54,196,139,44,37,416
173107_SecondarySource.txt,578,13,44,208,58,88,22,376
173109_WarpedTour.txt,1468,30,48,615,178,62,39,894
1731136_YttriumAluminiumGarnet.txt,1331,29,45,558,199,182,45,984
1731151_NorthSydneyBoysHighSchool.txt,872,15,58,449,85,63,16,613
173121_CladdaghRing.txt,1395,28,49,487,202,57,44,790
173160_LensFlare.txt,627,12,52,200,95,77,31,403
173181_RiemannSurface.txt,1578,35,45,561,206,178,50,995
1733315_ArchipelagoSea.txt,1399,27,51,454,166,170,61,851
1733317_LockheedMartinTransportationSecuritySolutions.txt,667,10,66,316,74,49,12,451
1733505_NetworkcentricWarfare.txt,2688,37,72,1099,344,228,96,1767
1734510_Bishapur.txt,618,11,56,208,90,54,20,372
173512_DifferentiatedServices.txt,2254,48,46,856,339,203,90,1488
173514_Gambit.txt,834,11,75,316,104,48,40,508
173519_NellCarter.txt,759,19,39,282,114,36,20,452
173521_Brahmanism.txt,646,14,46,212,81,57,26,376
173522_Khtml.txt,575,12,47,255,64,41,15,375
173524_NissanSkylineGtr.txt,4817,63,76,1684,712,437,167,3000
173530_Beelzebub.txt,1896,19,99,738,236,105,61,1140
173532_HenryVaneTheYounger.txt,2029,26,78,678,278,86,66,1108
173533_Romanization.txt,2877,144,19,1174,303,293,107,1877
173547_CayleyhamiltonTheorem.txt,946,35,27,370,93,73,35,571
173548_Fennel.txt,949,22,43,341,142,102,38,623
173553_Kroqfm.txt,1993,27,73,943,173,116,44,1276
1735724_WarlordZsinj.txt,1690,11,153,621,240,102,73,1036
1736051_Piston.txt,559,9,62,221,64,40,21,346
1736065_TerryAndJune.txt,1092,10,109,515,72,28,21,636
1736117_ThunderBluff.txt,614,7,87,243,78,46,24,391
1736728_Tashlikh.txt,723,10,72,255,88,53,15,411
1738861_DarrallImhoff.txt,714,10,71,263,99,41,28,431
1739869_Microdrive.txt,2045,25,81,699,280,194,111,1284
1740080_EdmundPhelps.txt,1806,26,69,719,202,134,54,1109
1741637_RayStevenson.txt,701,17,41,258,94,43,10,405
1742036_BlackTieWhiteNoise.txt,981,19,51,585,74,44,29,732
174203_Epsom.txt,1421,37,38,755,144,62,29,990
174251_TheLordOfTheRingsTheReturnOfTheKingfilm.txt,7216,70,103,2617,946,436,234,4233
1742661_FreedomForceVsTheThirdReich.txt,2491,7,355,858,386,191,104,1539
1743431_ConvergentSeries.txt,737,45,16,255,70,46,43,414
1743598_Sophiagnosticism.txt,1632,22,74,584,173,94,50,901
1744401_CalicoEarlyManSite.txt,673,8,84,293,80,47,16,436
1744403_ChiaraLubich.txt,1432,19,75,484,175,95,34,788
1744425_SedberghSchool.txt,632,11,57,276,71,40,17,404
1744454_InternationalLongshoremensAssociation.txt,2885,50,57,1101,394,177,109,1781
1745361_BlaydonRaces.txt,609,21,29,234,92,29,19,374
1745367_BrazilAtThe2000SummerOlympics.txt,1543,63,24,868,58,37,46,1009
1745369_BsidesRarities.txt,2223,3,741,1380,29,85,11,1505
1745378_DeanaCarter.txt,558,15,37,244,66,28,17,355
1745392_RussiaAtThe2000SummerOlympics.txt,4713,319,14,3110,119,51,106,3386
1745419_KickingAndScreaming.txt,645,3,215,216,105,36,39,396
174599_TamworthNewSouthWales.txt,1697,30,56,782,172,120,33,1107
174600_RioCuartoCraters.txt,665,16,41,226,84,63,26,399
174601_Demonology.txt,2195,34,64,676,317,172,101,1266
174602_WabarCraters.txt,830,13,63,270,114,75,31,490
174604_ListOfUniversityOfOxfordPeople.txt,15861,209,75,12367,119,266,57,12809
174607_SupplysideEconomics.txt,4540,60,75,1660,607,450,152,2869
174609_ChicxulubCrater.txt,1335,22,60,458,187,104,47,796
174638_SkullAndBones.txt,1302,18,72,563,144,76,43,826
174640_WestCoastNewZealand.txt,882,24,36,313,108,69,38,528
1747544_Turboduo.txt,1157,9,128,530,121,91,26,768
1747550_TechnologyEducation.txt,572,10,57,290,65,39,10,404
1747565_MaxRedLine.txt,623,41,15,357,53,31,4,445
1747774_DalekdoctorWhoEpisode.txt,3939,27,145,1355,648,156,147,2306
1748817_TheScotsCollege.txt,2355,88,26,1096,240,141,42,1519
1749739_DistrictsOfSheffield.txt,857,37,23,448,88,46,12,594
1750882_Zoogeography.txt,782,24,32,314,84,77,17,492
1750937_Hypnodisc.txt,828,55,15,377,83,55,23,538
1751279_MichaelCollinsauthor.txt,866,15,57,375,83,73,11,542
1752305_InfiniteCrisis.txt,2036,35,58,828,263,152,55,1298
1753115_Metang.txt,818,19,43,324,81,93,38,536
1753441_BarclaysPlc.txt,1025,20,51,578,78,44,14,714
175348_Thuin.txt,736,19,38,268,91,66,18,443
1754313_MetalGearvideoGame.txt,3219,57,56,1204,436,245,99,1984
17547_Love.txt,2442,37,66,881,347,220,92,1540
17549_ForeverChanges.txt,930,17,54,460,85,48,24,617
1755289_DonFelder.txt,936,19,49,360,127,51,31,569
17552_LogicalFallacy.txt,924,12,77,476,73,65,26,640
17553_KeplersLawsOfPlanetaryMotion.txt,2512,90,27,804,289,227,101,1421
17560_LiveActionRoleplayingGame.txt,3220,42,76,1233,401,362,117,2113
1756264_ClearChannelUk.txt,831,18,46,447,90,50,19,606
17562_LeniRiefenstahl.txt,1994,31,64,831,230,131,46,1238
1756503_ListOfTheRomanCatholicDiocesesOfItaly.txt,779,46,16,468,11,65,1,545
175686_Ghv2.txt,843,19,44,360,97,37,30,524
175702_Namurcity.txt,884,20,44,360,84,67,26,537
1757479_EdgewaterPresbyterianChurch.txt,916,14,65,372,121,56,17,566
1757814_InverseSemigroup.txt,1980,37,53,727,231,135,59,1152
1758468_IkkiTousen.txt,4410,24,183,1526,604,327,245,2702
1759035_HarvardradcliffeChorus.txt,1332,103,12,813,51,54,10,928
1759208_UnionvilleOntario.txt,1336,23,58,509,158,86,30,783
1760793_DuffieldRailwayStation.txt,787,14,56,289,100,57,20,466
17616_Latitude.txt,2161,41,52,745,290,224,85,1344
1761806_JorgePachecoAreco.txt,827,15,55,309,107,60,32,508
1762404_HandsomeDan.txt,1478,21,70,566,211,101,46,924
176386_ArthurRansome.txt,1434,25,57,567,166,90,36,859
176391_BlueBox.txt,1263,22,57,515,163,86,36,800
1763983_TwoTonsOfSteel.txt,633,8,79,297,63,23,22,405
1764015_EmpireOfJapaneconomicAndFinancialData.txt,1204,23,52,464,116,111,18,709
1764571_Bundesautobahn1.txt,391,13,30,129,42,22,12,205
1764593_LeverEscapement.txt,1019,14,72,335,135,78,40,588
1765235_SalvadorEFelices.txt,644,10,64,300,63,41,7,411
1765548_ListOfTetrisVariants.txt,944,19,49,359,131,77,29,596
1766162_KyoSohma.txt,1790,25,71,497,346,80,119,1042
1766170_EyReqb.txt,539,47,11,295,67,29,18,409
1766373_NativeAmericanLongHouse.txt,583,11,53,192,80,58,28,358
176751_DukeOfAquitaine.txt,1173,29,40,516,60,40,44,660
176762_TheWhaleRider.txt,820,15,54,311,118,37,31,497
176767_UniversityOfCopenhagen.txt,1925,25,77,783,156,136,37,1112
176768_DornierDo17.txt,2093,32,65,681,306,138,66,1191
176771_Wisbech.txt,1100,25,44,435,148,77,22,682
176773_FieselerFi156.txt,876,14,62,295,111,65,32,503
176774_Stol.txt,575,9,63,267,67,46,15,395
176778_HortenHo229.txt,900,18,50,354,130,61,27,572
176781_MerrimackRiver.txt,882,19,46,353,113,56,23,545
176789_WardellGray.txt,2154,28,76,758,287,139,111,1295
1767914_PuteriGunungLedangfilm.txt,927,17,54,348,132,46,34,560
176793_SunilGavaskar.txt,1067,12,88,366,126,65,45,602
176794_Dunbar.txt,584,10,58,213,80,62,12,367
176796_MaharishiMaheshYogi.txt,1336,36,37,577,149,65,30,821
1768549_NanjingIncident.txt,648,10,64,230,83,51,15,379
1768557_Mongoloidsong.txt,704,8,88,260,87,73,16,436
1770093_FrenchVerbMorphology.txt,3351,117,28,1159,387,487,117,2150
1770095_Domicilelaw.txt,1258,18,69,402,156,99,38,695
1770705_AmericanChamberOfCommerceInVietnam.txt,796,9,88,356,62,50,4,472
1770740_TatTvamAsi.txt,1505,26,57,461,222,92,60,835
1770754_OperationBlackbeard.txt,800,10,80,300,130,43,26,499
1771707_KisaSohma.txt,724,11,65,224,133,42,47,446
1771747_Gitsoftware.txt,3118,46,67,1106,469,270,162,2007
1772921_HintonTrainCollision.txt,1668,23,72,551,266,112,60,989
1773896_SarojiniNagar.txt,1211,13,93,484,146,99,45,774
1774087_BoBelinsky.txt,957,13,73,331,115,65,41,552
177454_RussianAirborneTroops.txt,878,16,54,364,102,90,26,582
177456_ProblemOfInduction.txt,1022,13,78,319,153,90,52,614
177464_Tatu.txt,3650,43,84,1216,627,235,141,2219
1774861_MoCollins.txt,558,15,37,380,36,20,9,445
1774875_ListOfHvStationsbudapest.txt,543,15,36,222,47,86,11,366
1775101_ContraIiiTheAlienWars.txt,1229,31,39,489,157,78,41,765
177517_EaaAirventureOshkosh.txt,1742,32,54,637,209,153,57,1056
177526_FerdinandChristianBaur.txt,1421,13,109,529,162,96,49,836
1775374_AnusaraYoga.txt,607,21,28,254,74,37,11,376
1775568_IndemnityAndOblivionAct.txt,845,10,84,329,110,29,23,491
177591_RichardDouglasHusband.txt,727,22,33,347,77,19,8,451
177593_OrganicFood.txt,3286,58,56,1122,506,395,147,2170
1776398_Cuttack.txt,1151,21,54,483,134,84,25,726
1776610_CadillacWilliams.txt,1177,22,53,424,148,72,41,685
1777552_Sadhya.txt,730,26,28,276,113,45,25,459
1778257_RegKeys.txt,843,12,70,349,102,49,20,520
177840_ChristopherNolan.txt,1783,35,50,651,258,124,60,1093
177842_Oasisorganization.txt,803,25,32,345,98,67,16,526
177860_ManOfLaMancha.txt,2682,38,70,939,414,142,119,1614
177864_Alsabah.txt,727,14,51,355,56,41,17,469
177867_EssexCountyOntario.txt,1457,24,60,628,175,83,33,919
1778715_VolcanogenicMassiveSulfideOreDeposit.txt,1050,20,52,427,113,143,32,715
1778716_JesseMccartney.txt,1823,21,86,951,153,83,39,1226
1778718_SteamshipLexington.txt,1258,27,46,431,206,58,50,745
177882_Sealab2021.txt,3820,46,83,1369,596,229,176,2370
177892_TheFourSeasonsvivaldi.txt,1099,22,49,606,97,54,34,791
177894_Pond.txt,683,14,48,239,103,56,40,438
177896_MadHatter.txt,869,10,86,348,115,49,30,542
1779414_ApostolicPrefect.txt,959,16,59,373,82,67,27,549
1779437_Homr.txt,1235,11,112,512,161,56,58,787
1779441_Newfrontiers.txt,1441,34,42,543,192,112,46,893
1780381_BahAdministration.txt,4458,56,79,1442,613,378,148,2581
1780425_ClausiusclapeyronRelation.txt,593,26,22,227,76,42,9,354
1782573_LawrenceBlock.txt,1475,18,81,638,131,91,52,912
1782613_WildBartsCantBeBroken.txt,1144,9,127,471,161,46,56,734
1783139_ChildrenOfALesserClod.txt,1049,12,87,391,164,48,46,649
1783184_Kammatthana.txt,668,21,31,278,64,54,19,415
1783190_WestminsterCollegePennsylvania.txt,573,11,52,315,40,55,5,415
1784933_MathieuSchneider.txt,663,13,51,302,59,39,15,415
1784966_MuseumOfReconstruction.txt,630,8,78,197,72,55,39,363
1785279_TheRibosOperation.txt,1098,14,78,434,133,65,20,652
178590_Harstad.txt,932,28,33,394,80,94,27,595
1785922_ListOfLexicalDifferencesInSouthAfricanEnglish.txt,1215,10,121,465,137,100,69,771
178617_DaughtersOfTheAmericanRevolution.txt,1043,19,54,431,125,58,36,650
178618_SteveLamacq.txt,659,7,94,274,77,47,20,418
178677_JohnALogan.txt,898,14,64,361,93,44,13,511
178679_ListOfCitiesInOregon.txt,1352,27,50,747,5,7,1,760
1786_ArabicNumerals.txt,1242,26,47,445,159,96,33,733
1787121_Heidrek.txt,979,28,34,317,180,47,37,581
1787122_SuiJianguo.txt,801,6,133,263,97,88,34,482
1787146_QuebecWest.txt,459,107,4,124,19,27,1,171
1787155_AudubonsShearwater.txt,1415,22,64,552,183,116,72,923
1787156_RimouskielectoralDistrict.txt,727,177,4,170,23,46,2,241
1787468_RussellontarioElectoralDistrict.txt,911,46,19,410,24,32,4,470
1787469_TransformersCybertron.txt,2316,34,68,993,256,159,66,1474
1787470_RitsuSohma.txt,1316,16,82,363,224,90,98,775
1787489_TorontoEast.txt,436,28,15,179,18,9,5,211
1787654_DragonsDen.txt,1175,29,40,461,159,58,44,722
1787_April9.txt,2071,6,345,1146,73,88,7,1314
1788105_DaveyLopes.txt,813,15,54,349,95,46,15,505
1788119_FinderWyvernspur.txt,1282,16,80,432,210,80,55,777
178915_JimFixx.txt,712,17,41,319,83,43,12,457
178928_TorontoIslands.txt,855,20,42,365,103,59,26,553
1789323_MalayanCommunistParty.txt,709,8,88,247,99,61,24,431
1789340_Orrykelly.txt,1452,11,132,772,33,22,3,830
178937_HighFrequency.txt,605,10,60,298,42,63,20,423
178942_ConceptualArt.txt,3009,50,60,1293,348,205,80,1926
178943_Tripe.txt,686,4,171,308,67,76,25,476
178945_KlausVoormann.txt,1118,14,79,414,138,66,42,660
178947_Salami.txt,919,16,57,326,146,88,34,594
178951_Sauerkraut.txt,1592,46,34,565,251,152,77,1045
178952_Kimchi.txt,809,20,40,310,119,99,26,554
178960_SimonCrean.txt,895,18,49,371,108,45,21,545
178967_RioFerdinand.txt,1538,25,61,541,231,98,49,919
178970_UnitedNationsSecurityCouncilResolution.txt,732,32,22,299,56,33,9,397
178972_MaxNordau.txt,1950,34,57,661,262,167,74,1164
1789_Apuleius.txt,753,10,75,267,93,56,34,450
1790287_AsterixAndTheBlackGold.txt,1108,25,44,403,159,61,49,672
1790297_AmaComputerUniversity.txt,2931,70,41,1268,334,210,73,1885
1790311_FromGenesisToRevelation.txt,1181,15,78,469,119,78,46,712
1790475_DotBranning.txt,2373,40,59,720,453,115,117,1405
1790845_StreetFighterIiV.txt,3920,57,68,1486,524,215,165,2390
1790_AlexanderSelkirk.txt,1183,17,69,447,162,65,40,714
1791295_UssRandolph1776.txt,799,13,61,293,138,38,18,487
1791473_Tvn24.txt,599,8,74,408,22,28,11,469
1792987_Houndtransformers.txt,968,28,34,367,134,66,28,595
1793598_CanadaAtThe1988SummerOlympics.txt,1826,87,20,1215,32,49,23,1319
1793608_AmyYasbeck.txt,587,9,65,264,57,23,14,358
1793612_WickhamSteed.txt,642,16,40,267,59,46,12,384
1793984_GeneralMagic.txt,1359,20,67,500,212,100,52,864
1793_August29.txt,1785,6,297,970,71,68,5,1114
1794811_HumanCharactersOnSesameStreet.txt,1289,50,25,550,175,63,30,818
1794_August30.txt,1572,7,224,906,42,48,5,1001
1795010_TheBouncer.txt,671,6,111,343,73,31,12,459
1795013_SpecialAssistancePlan.txt,1443,9,160,491,173,189,70,923
1795203_CarlBaugh.txt,846,14,60,405,92,46,21,564
1795208_ShaunMurphysnookerPlayer.txt,752,12,62,257,96,53,24,430
1795816_RamnLpezVelarde.txt,2187,48,45,857,250,180,54,1341
1796984_SouthAfricaAtThe1992SummerOlympics.txt,633,38,16,380,34,24,26,464
1796989_UssLawrencedd250.txt,641,11,58,284,77,27,7,395
1797035_JohnGillclimber.txt,708,9,78,268,80,50,28,426
179709_SaulLieberman.txt,1849,25,73,698,231,115,52,1096
179750_OsakaPrefecture.txt,619,26,23,378,54,22,7,461
1797946_1928OkeechobeeHurricane.txt,2059,29,71,730,272,159,92,1253
1797948_RecordCollecting.txt,1809,21,86,762,198,138,59,1157
1797969_PinkFloydPigs.txt,2120,37,57,787,306,105,74,1272
1797_Acre.txt,754,22,34,269,79,72,33,453
1798152_Insecticons.txt,2553,36,70,907,386,159,89,1541
1798192_OskarBecker.txt,1642,24,68,737,153,130,50,1070
1798336_TheTaleOfCrosseyedLeftyFromTulaAndTheSteelFlea.txt,796,6,132,234,135,46,35,450
1799136_StarWarsYodaStories.txt,688,10,68,245,93,51,23,412
1799141_WentenRubuntja.txt,578,9,64,187,80,61,16,344
180030_MeltingPot.txt,2096,32,65,699,299,171,91,1260
180045_JourneyIntoSpace.txt,3016,51,59,1100,428,211,107,1846
180046_WatercolorPainting.txt,2911,55,52,971,471,262,129,1833
1800575_SoophieNunSquad.txt,1078,11,98,638,65,70,23,796
180058_Kansaiben.txt,2583,40,64,797,358,307,169,1631
180093_Bonanza.txt,1560,22,70,639,197,96,28,960
180094_SuratThaniProvince.txt,817,21,38,357,96,51,27,531
180095_GreekRevivalArchitecture.txt,2003,21,95,767,217,151,72,1207
180099_TimHortons.txt,2458,44,55,991,292,172,74,1529
1800_AdenosineTriphosphate.txt,1370,18,76,488,173,131,37,829
180108_HuckleberryHound.txt,646,9,71,274,75,49,25,423
180109_CopyrightLawOfTheEuropeanUnion.txt,2653,26,102,984,226,198,83,1491
180111_TonyPrez.txt,683,10,68,224,75,49,19,367
180121_Medication.txt,885,50,17,445,73,156,16,690
1801317_SteveMoorecomics.txt,678,15,45,316,27,18,7,368
1801336_AdamMitchell.txt,681,11,61,235,107,42,32,416
1801539_BeijingNationalStadium.txt,740,10,74,277,94,51,15,437
1803492_OttawaOtrain.txt,4451,53,83,1499,707,343,158,2707
1803497_DaronAcemoglu.txt,1687,8,210,1057,37,62,5,1161
1803506_Gluemeat.txt,822,17,48,373,99,74,41,587
1803856_2005PanblueVisitsToMainlandChina.txt,2125,43,49,885,262,130,56,1333
1803922_JamesRiady.txt,707,12,58,312,88,52,17,469
1804737_BlackwoodCaerphilly.txt,615,9,68,262,74,35,18,389
1804882_LisaTheSimpson.txt,1372,21,65,508,189,73,56,826
1805702_WandaOrlikowski.txt,734,27,27,243,123,43,26,435
1805709_TcfBank.txt,1056,29,36,459,154,49,36,698
1805714_Poing.txt,609,25,24,194,103,34,28,359
1805866_TennesseeStateRoute155.txt,602,13,46,276,52,30,15,373
1805_Antibiotic.txt,2022,34,59,635,269,250,97,1251
1806671_NamesOfJapan.txt,1475,24,61,535,193,130,71,929
1806840_StandishGreaterManchester.txt,591,13,45,225,72,38,18,353
1806859_CentennialParknashville.txt,609,9,67,210,93,50,18,371
1806866_UssShieldsdd596.txt,967,18,53,389,106,45,15,555
1806870_ListOfCaseWesternReserveUniversityPeople.txt,1236,8,154,681,45,91,6,823
1806_ArnoldSchwarzenegger.txt,5103,80,63,1868,700,320,174,3062
1807106_ListOfMathematicsArticlesi.txt,1548,18,86,791,30,186,5,1012
180777_SocialSecurityTrustFund.txt,1596,20,79,560,234,106,72,972
180783_AugustHermannFrancke.txt,939,10,93,340,119,54,29,542
180785_Ringfilm.txt,1602,15,106,583,190,78,53,904
1807872_Hellion.txt,722,10,72,227,122,54,28,431
180796_MenanderI.txt,4183,66,63,1629,455,258,151,2493
180846_FederalReserveNote.txt,1724,23,74,606,234,139,70,1049
1809017_SouthKoreaAtThe1996SummerOlympics.txt,868,49,17,521,44,64,28,657
1809045_MoroccanArabic.txt,2193,74,29,833,257,240,101,1431
1809291_FloydAbrams.txt,1428,15,95,591,179,82,61,913
1810004_SebastianDeisler.txt,675,17,39,229,72,46,18,365
1810048_PortOfLongBeach.txt,574,12,47,231,72,35,8,346
1810049_Mahoraba.txt,1246,40,31,473,164,72,47,756
1810239_ArnoldAirSociety.txt,1479,25,59,631,179,106,40,956
1810614_HealthDisparities.txt,1297,19,68,573,125,144,37,879
1811195_DentonAndReddishukParliamentConstituency.txt,525,16,32,227,43,24,18,312
1811218_MacclesfieldukParliamentConstituency.txt,564,17,33,252,64,22,15,353
1811223_NflPlayoffs198182.txt,2742,61,44,1326,262,139,60,1787
1811581_BuffBagwell.txt,1791,25,71,781,254,61,43,1139
181158_ComaBerenices.txt,1498,32,46,477,205,148,66,896
1811601_Tancredi.txt,795,14,56,356,115,38,22,531
181160_NimitzClassAircraftCarrier.txt,604,9,67,260,61,36,13,370
1811637_MatrilinealSuccession.txt,1105,17,65,371,135,105,58,669
181171_NicolausLudwigZinzendorf.txt,1636,15,109,585,214,83,45,927
181174_Thyristor.txt,1742,32,54,628,277,157,56,1118
181178_RedMaple.txt,698,12,58,235,92,75,38,440
181192_BernardSilvestris.txt,671,12,55,302,63,40,16,421
181200_BettyComden.txt,1071,16,66,470,97,50,21,638
1812213_NikolayYakovlevichDanilevsky.txt,918,14,65,332,125,61,19,537
1812232_ComorianFranc.txt,2042,62,32,764,256,140,34,1194
1812604_Wwlp.txt,1649,25,65,852,148,55,40,1095
1812_Amway.txt,2423,41,59,1017,296,160,54,1527
1813408_Kscr.txt,618,8,77,227,87,62,18,394
1813418_NewYorkCityCouncil.txt,767,20,38,385,67,30,14,496
1813826_CharlieUtter.txt,604,5,120,248,81,30,26,385
1813828_DesignPatent.txt,976,26,37,377,147,57,30,611
1814410_CoulombCollision.txt,626,15,41,195,69,73,31,368
1814421_Audiblecom.txt,811,13,62,353,102,54,20,529
1814556_TransatlanticTunnel.txt,600,10,60,231,72,40,10,353
1814595_RiverdaleHighSchoolarchieComics.txt,2022,43,47,721,281,148,136,1286
1814598_ErnstRdin.txt,564,17,33,254,42,34,15,345
1814607_StringfellowHawke.txt,726,6,121,311,94,35,23,463
1814766_Beykoz.txt,1384,18,76,453,166,119,66,804
1814_AdamSmith.txt,3277,36,91,1130,382,252,131,1895
1815577_BrianAdamswrestler.txt,1566,25,62,673,195,75,36,979
1817707_Ultimen.txt,939,8,117,328,155,54,44,581
181861_SammyGravano.txt,1099,17,64,414,185,52,32,683
1818950_Modenas.txt,1662,41,40,744,152,145,42,1083
1818955_MiddleBronzeAgeAlphabets.txt,1682,23,73,599,208,160,64,1031
18198_LebesgueMeasure.txt,958,23,41,313,125,89,45,572
1819957_TheGodsOfMars.txt,1874,25,74,700,267,87,69,1123
1819966_LarryFleinhardt.txt,1939,19,102,612,341,114,86,1153
18201_LakeChamplain.txt,1502,27,55,629,172,105,48,954
1820263_CommonKrait.txt,668,13,51,242,101,68,42,453
1820352_SouthPhiladelphia.txt,1167,24,48,495,129,99,33,756
18208_LossyDataCompression.txt,772,19,40,309,113,71,38,531
1820902_PyroelectricFusion.txt,575,15,38,249,66,47,8,370
18209_LosslessDataCompression.txt,1651,24,68,619,235,136,86,1076
18210_LarryNiven.txt,1660,36,46,723,172,89,50,1034
1821142_MaryGoodnight.txt,684,10,68,246,101,35,19,401
1821146_GilmanColorado.txt,766,14,54,291,93,56,14,454
18217_LeonardPeltier.txt,3131,47,66,1240,470,145,73,1928
1822111_TimeDiscipline.txt,1502,17,88,516,196,166,61,939
18221_Lambdamoo.txt,936,15,62,312,141,79,30,562
1822282_Male.txt,647,14,46,226,86,85,25,422
182246_Bishnen.txt,1466,17,86,802,102,104,40,1048
182248_BaekduMountain.txt,1279,27,47,502,153,87,27,769
182249_CryptographicallySecurePseudorandomNumberGenerator.txt,1338,33,40,497,193,122,68,880
18224_KnownSpace.txt,3335,25,133,1137,487,307,125,2056
182259_TrenchWarfare.txt,9550,110,86,3131,1447,790,452,5820
182265_BostonMarathon.txt,2181,32,68,773,293,148,87,1301
182268_BattleOfRoundwayDown.txt,604,13,46,228,96,21,20,365
182271_FrankGrimes.txt,1416,19,74,495,228,77,81,881
182284_DewoitineD520.txt,1530,28,54,492,227,126,39,884
182288_DornierDo335.txt,1330,15,88,456,187,106,42,791
182292_IlyushinIl4.txt,581,13,44,200,87,45,28,360
1822_AntoineLavoisier.txt,2024,31,65,723,283,148,54,1208
18231_Latexrubber.txt,560,11,50,182,96,49,24,351
1823264_MrzabbsNr.txt,1037,20,51,381,145,74,30,630
1823278_WolfgangKrauser.txt,1229,14,87,494,169,59,55,777
1823283_RainbowValley.txt,1375,19,72,483,221,94,66,864
1823285_GrandeBibliothqueDuQubec.txt,850,22,38,349,88,73,18,528
18242_ListOfFilmsPreservedInTheUnitedStatesNationalFilmRegistry.txt,6635,65,102,3333,498,80,8,3919
18245_Labyrinth.txt,2287,32,71,851,287,169,96,1403
18247_ListOfPhilosophicalTopicsac.txt,5523,31,178,2738,118,514,24,3394
1825426_JeffersonLiteraryAndDebatingSociety.txt,736,7,105,337,75,39,16,467
1825434_ImperialWayFaction.txt,5106,76,67,1893,644,486,145,3168
1825828_JudaismAndEvolution.txt,2958,35,84,1076,351,268,113,1808
1825853_UssGillisdd260.txt,657,10,65,301,87,20,9,417
1826473_GrotonLongPointYachtClub.txt,718,12,59,287,99,36,25,447
1826_April18.txt,1621,7,231,946,66,38,3,1053
1827612_JessieMaeHemphill.txt,1060,14,75,508,100,72,17,697
1827695_TheBluestEye.txt,1016,16,63,341,148,67,45,601
1827_April23.txt,2057,7,293,1162,58,67,4,1291
1828004_Barebacksex.txt,1057,23,45,395,150,91,38,674
1828621_OldHallManuscript.txt,750,8,93,302,69,71,26,468
1828832_TheValleyOfHorses.txt,591,8,73,194,85,34,18,331
1829236_DavidBegelman.txt,598,11,54,238,85,33,12,368
182965_CultTelevision.txt,753,12,62,272,110,73,49,504
1829830_Alumbrados.txt,585,9,65,197,78,48,17,340
1829835_UniversityOfSheffieldUnionOfStudents.txt,1092,12,91,573,51,41,8,673
1829838_Malsia.txt,8571,116,73,2941,1314,492,329,5076
1830167_SaturationArithmetic.txt,654,11,59,184,77,83,29,373
1830189_MaddenNfl06.txt,1615,13,124,724,171,93,56,1044
1830969_PierreMagnol.txt,1293,18,71,481,157,81,33,752
1831945_GeorgeVanTassel.txt,902,13,69,347,110,59,42,558
1832356_JadenYuki.txt,964,14,68,365,122,66,27,580
1832976_ZiggyStardustTheMotionPicture.txt,630,13,48,292,69,34,18,413
183339_Dragonlance.txt,1579,32,49,656,194,87,29,966
183340_BicycleBrakeSystems.txt,5048,57,88,1554,834,500,286,3174
183349_MountHood.txt,1841,39,47,697,246,129,55,1127
183351_Pennyfarthing.txt,1336,19,70,443,179,118,49,789
183358_SlcPunk.txt,571,18,31,254,68,38,16,376
183359_CycleRickshaw.txt,988,18,54,370,142,83,48,643
183363_TheSwordInTheStone.txt,663,9,73,246,83,56,36,421
183364_TheMarkTomAndTravisShowtheEnemaStrikesBack.txt,786,10,78,318,94,38,35,485
183365_UniversalPlugAndPlay.txt,2620,24,109,1281,278,170,38,1767
183370_HomeCinema.txt,1411,21,67,552,187,136,56,931
183376_GeorgeRobertsonBaronRobertsonOfPortEllen.txt,713,10,71,356,43,23,6,428
1834730_PhilippineLegionOfHonor.txt,733,20,36,319,50,59,12,440
1835337_TheFatBoys.txt,809,13,62,386,64,35,14,499
1835343_OnLeatherWings.txt,673,13,51,257,97,40,25,419
1835761_DebbieDowner.txt,890,19,46,334,114,58,41,547
1836327_InternalRevenueCode.txt,1474,25,58,668,99,78,26,871
1838523_HannesWader.txt,693,11,63,429,35,38,15,517
1838526_Dreamlover.txt,738,17,43,312,88,62,19,481
1838530_Barabajagalalbum.txt,682,9,75,312,68,31,14,425
1838565_Conshafter.txt,648,13,49,332,76,26,15,449
1838720_SpelljammerPiratesOfRealmspace.txt,1679,22,76,575,293,112,55,1035
1839664_WhitchurchHampshire.txt,1138,17,66,440,148,59,27,674
1839675_AbuFarajAllibbi.txt,629,10,62,272,79,34,8,393
1839676_AlphaSitestargate.txt,1153,24,48,390,194,70,55,709
1839678_GmFamily1Engine.txt,733,20,36,373,46,48,10,477
1839694_TheLegendOfSuriyothai.txt,1192,21,56,477,167,79,30,753
1839695_Darkman.txt,2217,37,59,802,354,118,70,1344
1839707_HansSeland.txt,857,9,95,272,108,79,22,481
1840080_MasaharuFukuyama.txt,464,10,46,203,42,30,12,287
184025_Ancistrus.txt,653,14,46,230,97,62,31,420
184030_IdriesShah.txt,1087,14,77,518,99,49,17,683
1840653_BlackMaskcomics.txt,2415,38,63,820,406,120,88,1434
1840677_JohnEder.txt,1578,19,83,607,209,108,39,963
1841039_HyderabadPublicSchool.txt,1562,28,55,709,136,82,28,955
1841901_PluperfectTense.txt,982,18,54,340,157,96,44,637
1842833_SsNaronic.txt,677,9,75,232,96,39,19,386
1842847_RichHarrison.txt,708,34,20,348,58,30,30,466
1842849_SalveRegina.txt,802,30,26,345,100,55,29,529
1842871_SouthKoreaAtThe2000SummerOlympics.txt,2157,79,27,1361,65,91,52,1569
1843410_Adblock.txt,795,22,36,324,98,71,37,530
1843435_NorwayAtThe2000SummerOlympics.txt,1050,51,20,588,18,10,12,628
1844039_Annates.txt,1104,14,78,361,139,67,36,603
1844051_IteCollegeWest.txt,576,27,21,367,29,17,10,423
184413_AmyJohnson.txt,754,20,37,310,89,37,13,449
184429_DeHavilland.txt,1214,26,46,500,129,97,31,757
184434_CJCherryh.txt,1826,32,57,757,219,137,56,1169
184436_AkitaAkita.txt,754,23,32,430,50,29,10,519
1844371_Kitefilm.txt,685,17,40,254,104,54,33,445
184440_FrancisBrettYoung.txt,648,11,58,269,73,29,10,381
184442_ChicoutimiQuebec.txt,605,33,18,247,59,57,12,375
184445_TheVicarOfBray.txt,697,14,49,257,65,63,22,407
1845031_AgnesOfFrancebyzantineEmpress.txt,1168,25,46,410,157,71,47,685
1845039_SubiacoItaly.txt,1354,16,84,467,168,88,34,757
1845606_PipeMajor.txt,576,10,57,294,47,49,13,403
1846236_FrancisSeymourconway1stMarquessOfHertford.txt,805,13,61,330,74,41,25,470
1846258_Cucurbituril.txt,1164,17,68,365,154,102,49,670
1846570_JeanLoring.txt,815,15,54,278,121,58,27,484
1847196_MilleLacsIndianReservation.txt,850,17,50,459,67,55,17,598
1847199_MilleLacsBandOfOjibwe.txt,747,15,49,407,51,37,9,504
1847217_Amenband.txt,1292,24,53,547,176,60,37,820
1847220_JohanVanDerKeuken.txt,1616,84,19,834,49,111,7,1001
1847412_ChristianMeditation.txt,1488,37,40,580,198,87,44,909
1847427_TeamFortress2.txt,1780,23,77,602,271,176,92,1141
1847432_Midichlorians.txt,1254,10,125,381,193,99,60,733
1847597_NataschaEngel.txt,638,12,53,275,78,35,6,394
1847817_NancyDaus.txt,930,18,51,348,136,44,45,573
1848409_JzefKasparek.txt,776,16,48,359,70,72,12,513
1848769_FlatlandBmx.txt,1219,8,152,441,170,84,42,737
1848778_GreatHall.txt,972,11,88,309,139,106,49,603
1849567_DennisBrown.txt,1076,10,107,520,69,42,22,653
1849581_DavidMecey.txt,1039,27,38,481,138,43,18,680
1849582_1969stargateSg1.txt,780,14,55,275,115,55,33,478
1849799_0999.txt,6829,79,86,1806,878,722,305,3711
1849804_FranceNationalBasketballTeam.txt,524,5,104,171,37,63,28,299
1849918_EugeneGendlin.txt,1074,20,53,348,169,74,45,636
1850548_TheEmptyChild.txt,3638,28,129,1283,575,155,112,2125
1850947_GermnRiesco.txt,1346,22,61,414,193,97,42,746
1851137_ThePartingOfTheWays.txt,4397,33,133,1453,674,217,169,2513
185115_StandardUserModel.txt,656,10,65,218,94,69,35,416
1851167_SirWinstonChurchillSecondarySchoolvancouver.txt,671,13,51,332,75,62,15,484
185118_ChechenLanguage.txt,556,16,34,214,62,49,24,349
185121_InternationalFinanceCentre.txt,981,15,65,467,87,57,25,636
1851764_WongJing.txt,641,14,45,257,72,54,18,401
185194_EurovisionSongContest1989.txt,300,31,9,182,16,6,2,206
185196_BirminghamCityFc.txt,3449,82,42,1363,358,254,100,2075
185202_MartinCarthy.txt,584,15,38,283,45,29,12,369
185205_CFMartinCompany.txt,2302,40,57,800,291,249,90,1430
1852166_FirstNationsInOntario.txt,525,4,131,483,1,5,0,489
1852781_APaleViewOfHills.txt,802,11,72,263,121,61,37,482
1853345_FeministInitiativesweden.txt,970,14,69,378,125,83,27,613
1853747_JeremyMcgrath.txt,733,10,73,238,94,52,28,412
1853975_JavierMaras.txt,616,11,56,275,58,39,12,384
1853980_AutonomousUniversityOfMadrid.txt,2245,29,77,1090,216,116,47,1469
1854284_BellvueColorado.txt,606,14,43,239,72,43,21,375
1854308_WudangTaiChiChuan.txt,1029,25,41,506,122,47,25,700
1854856_SybilLynch.txt,610,11,55,317,48,20,14,399
185515_Monophony.txt,732,14,52,314,84,88,20,506
185517_AloysiusSnuffleupagus.txt,907,16,56,325,150,50,43,568
185519_TheConcertForBangladesh.txt,2380,42,56,1041,321,112,63,1537
185528_ReturnedAndServicesLeagueOfAustralia.txt,583,13,44,246,69,47,22,384
185529_Scalability.txt,613,21,29,193,98,48,27,366
185536_KenyonCollege.txt,1464,16,91,763,124,112,22,1021
185537_UmkhontoWeSizwe.txt,774,13,59,298,107,48,19,472
185546_ClementeDomnguezYGmez.txt,1577,24,65,574,216,84,61,935
1855818_GoingLive.txt,752,22,34,298,98,53,17,466
1855841_HobokenElectionOf2005.txt,737,10,73,289,95,35,21,440
1856478_20thCenturyBoys.txt,3201,42,76,1039,521,172,101,1833
1856606_ExpressionPedal.txt,844,13,64,238,134,76,43,491
1856826_BuckeyeTv.txt,1748,28,62,848,165,98,35,1146
1857055_StGeorgesNightUprising.txt,680,9,75,234,103,49,25,411
1858034_AustralianQualificationsFramework.txt,1201,32,37,495,149,93,45,782
1858057_BetterThanLife.txt,1326,24,55,456,206,81,61,804
1858211_TheJewOfMalta.txt,1560,20,78,547,212,78,63,900
1858218_ScientificDrilling.txt,770,8,96,295,102,60,21,478
1858997_TheStands.txt,846,17,49,454,96,32,14,596
1859171_OlinDJohnston.txt,810,10,81,315,99,51,22,487
1860168_SergeyGlazyev.txt,620,11,56,206,84,43,19,352
1861351_TheFormat.txt,737,14,52,319,77,48,23,467
1861373_TripleChanger.txt,634,15,42,294,72,54,19,439
186157_Pccw.txt,1122,27,41,531,123,58,26,738
1862328_PowderAlarm.txt,876,13,67,332,110,53,25,520
1862337_JermainTaylor.txt,838,19,44,339,116,48,26,529
186234_DavidBohm.txt,2602,23,113,993,329,129,101,1552
1862352_UsRoute121.txt,652,13,50,288,62,30,13,393
18633_LorenzoDeMedici.txt,1651,28,58,632,185,101,54,972
18639_LucreziaBorgia.txt,2405,28,85,923,344,137,73,1477
1864145_BeachSoccer.txt,1147,14,81,446,159,70,24,699
1864217_MethodiusOfOlympus.txt,787,7,112,288,91,59,23,461
18642_Lemmy.txt,2846,26,109,1191,280,173,88,1732
1864336_LisaLisaAndCultJam.txt,635,13,48,289,71,35,13,408
18644_Ld50.txt,923,18,51,324,124,79,42,569
1864510_FredHarveyCompany.txt,1663,23,72,709,211,110,42,1072
18646_LinkinPark.txt,4731,72,65,1804,658,315,164,2941
18650_Flippercricket.txt,668,9,74,199,106,46,41,392
1865727_CanadianJournalistsForFreeExpression.txt,816,20,40,308,114,53,18,493
186641_LoaLoaFilariasis.txt,698,10,69,280,89,61,22,452
186642_SteveFossett.txt,1640,51,32,722,145,105,23,995
186658_BernardButler.txt,566,9,62,296,50,22,13,381
1866743_LinearCode.txt,670,21,31,227,92,59,29,407
186677_Elitism.txt,655,16,40,215,93,62,38,408
1866903_TheFarPavilions.txt,581,7,83,236,62,36,14,348
186694_WorldChampionshipWrestling.txt,7061,24,294,2745,942,514,303,4504
186739_MesserschmittBf109.txt,8506,96,88,2839,1141,706,295,4981
1867562_DukeNukemcaptainPlanet.txt,680,12,56,223,111,51,37,422
186758_Dispensationalism.txt,4974,45,110,1945,548,367,173,3033
186760_StatisticsCanada.txt,628,12,52,338,33,43,8,422
1867877_Bhogar.txt,934,11,84,330,131,63,30,554
1868520_ArchibaldCampbell9thEarlOfArgyll.txt,3925,40,98,1221,625,268,182,2296
1868718_LifeWithLoopy.txt,702,36,19,313,80,31,26,450
18701_Lazio.txt,815,16,50,324,87,69,19,499
1870896_MessinianSalinityCrisis.txt,1681,17,98,580,220,146,59,1005
1871856_KingstonGrammarSchool.txt,582,8,72,258,68,35,20,381
1871925_AnnArborStaging.txt,580,9,64,243,78,34,9,364
1872251_RomeynBAyres.txt,925,13,71,383,120,38,19,560
1872264_ChriskingOfFighters.txt,834,5,166,299,121,49,32,501
1872279_JamesBarnes.txt,736,8,92,288,89,35,22,434
187301_CruzeiroEsporteClube.txt,2450,57,42,886,297,163,94,1440
1873069_ShaileshVara.txt,581,15,38,233,74,35,10,352
187321_TransportSalariedStaffsAssociation.txt,1383,12,115,578,127,55,38,798
1873436_Peoles.txt,604,14,43,301,50,50,6,407
1873439_ShawnStasiak.txt,1315,29,45,570,176,65,29,840
187358_GeorgeGrosz.txt,819,15,54,315,104,46,21,486
187359_Campfire.txt,2694,37,72,738,502,231,163,1634
187360_MagneticSusceptibility.txt,789,22,35,285,91,76,18,470
187387_GeorgeIOfGreece.txt,3160,38,83,1183,394,201,90,1868
1874032_KenanStadium.txt,816,15,54,296,104,58,31,489
1874467_JohnIiOfTrebizond.txt,569,10,56,233,67,20,11,331
1875416_Vectorworks.txt,957,23,41,474,122,77,19,692
1875571_BuckleyAirForceBase.txt,887,18,49,450,78,63,14,605
1875619_GeorgeACowles.txt,917,3,305,338,135,49,32,554
1876562_Wiyy.txt,673,16,42,261,92,49,20,422
1876606_RainbowJersey.txt,858,19,45,321,104,59,24,508
1877455_CathedralOfTheAssumptionInLouisville.txt,2444,51,47,974,275,175,48,1472
187746_ListOfSoccerClubsInTheUnitedStates.txt,978,15,65,836,18,20,4,878
187749_Ethiopia.txt,5487,87,63,2026,709,485,177,3397
187750_LargeNumbers.txt,2748,66,41,721,349,309,169,1548
1877770_StuntDawgs.txt,1311,9,145,933,67,51,25,1076
1877810_GasometerVienna.txt,681,13,52,251,102,45,13,411
187792_StudentConservationAssociation.txt,969,24,40,407,110,83,26,626
187794_StevenBochco.txt,820,14,58,357,98,45,18,518
187805_PercolationTheory.txt,858,14,61,249,122,87,44,502
187807_DemiMoore.txt,943,20,47,380,128,48,31,587
187813_TransportLayerSecurity.txt,1813,38,47,763,240,141,52,1196
187816_Indianmotorcycle.txt,1359,29,46,486,189,128,25,828
187824_Offsidefootball.txt,2162,37,58,653,343,139,95,1230
187826_MichelGauquelin.txt,1724,24,71,617,202,154,50,1023
1878784_LenfantEtLesSortilges.txt,1033,12,86,440,133,79,36,688
1879392_Syntel.txt,880,34,25,492,81,48,4,625
1881164_AirMaster.txt,1715,27,63,512,259,145,98,1014
1882125_Type214Submarine.txt,818,16,51,373,91,59,14,537
1882142_Lithuanian1941Independence.txt,1794,17,105,579,287,160,59,1085
1882145_MonicaZetterlund.txt,811,11,73,382,59,57,18,516
1882179_TheChroniclesOfNarniaPrinceCaspian.txt,571,14,40,249,73,27,13,362
1883157_SinginInTheRainfilm.txt,1670,22,75,637,214,112,58,1021
1883298_Awesomefunny.txt,705,11,64,247,88,54,38,427
188385_BettyAndVeronicaMagazine.txt,731,11,66,287,81,79,18,465
1884305_ArmymccarthyHearings.txt,960,16,60,371,135,63,26,595
1884319_LenoreBlum.txt,611,11,55,275,53,24,7,359
1884336_WignerQuasiprobabilityDistribution.txt,1348,39,34,548,147,122,41,858
188454_RealMccoyband.txt,999,15,66,391,92,66,27,576
188461_JingKe.txt,684,11,62,246,120,18,21,405
1885496_RohingyaLanguage.txt,3011,58,51,1174,390,376,112,2052
1885523_Theoremfilm.txt,1115,19,58,416,142,75,41,674
1887102_LugsFsugsGlugsInIndiaAndAsia.txt,948,27,35,697,31,76,4,808
1887692_NeofascismAndReligion.txt,3550,53,66,1690,309,237,101,2337
1888325_ReformationStudyBible.txt,1364,17,80,757,120,69,31,977
1888469_DeadInside.txt,1043,25,41,317,163,104,48,632
1888633_TheDidjits.txt,854,10,85,394,84,58,25,561
1888663_EastGermanyAtThe1972SummerOlympics.txt,951,74,12,700,18,61,3,782
188885_WilliamWhiston.txt,1158,13,89,400,131,74,36,641
188886_Doctorate.txt,4888,65,75,1972,527,490,207,3196
188887_ApolloGuidanceComputer.txt,4754,82,57,1784,719,321,125,2949
188888_NeutronSource.txt,746,13,57,305,85,67,17,474
188893_BaconsRebellion.txt,1932,24,80,715,281,123,47,1166
188894_TheTripods.txt,3329,34,97,1056,482,261,140,1939
188896_NeutronModerator.txt,898,15,59,309,123,128,50,610
188899_TimAllen.txt,739,16,46,338,70,33,22,463
188900_ColonyAndDominionOfVirginia.txt,650,12,54,249,74,37,20,380
188904_Pasty.txt,2419,35,69,839,367,202,103,1511
188921_DresdenFrauenkirche.txt,2360,43,54,813,339,168,67,1387
188923_InertialGuidanceSystem.txt,3099,66,46,1072,470,290,131,1963
1889288_Babylon5InTheBeginning.txt,1012,16,63,345,161,62,41,609
1889289_CharacterDisplacement.txt,1810,17,106,710,217,163,75,1165
1889482_Sunshower.txt,598,10,59,222,99,38,19,378
1890884_NucleotideExcisionRepair.txt,912,9,101,396,104,69,33,602
1890893_SharmellSullivan.txt,680,17,40,301,84,34,16,435
1891677_IsheSmith.txt,809,16,50,301,127,58,22,508
1892637_ThorsHammerstargateSg1.txt,690,14,49,199,107,44,26,376
1893203_AdventRising.txt,3226,29,111,1197,480,181,95,1953
1894183_ChristianCountryMusic.txt,973,18,54,454,114,71,19,658
1896179_StanLane.txt,779,16,48,400,68,27,17,512
1896366_Epstein.txt,1170,13,90,684,65,71,16,836
1896367_LonaCohen.txt,707,11,64,333,69,26,7,435
1896389_Canntaireachd.txt,1478,26,56,461,241,144,69,915
1897014_MesoamericanPyramids.txt,743,15,49,285,95,74,23,477
1897203_NikosSampson.txt,953,17,56,329,141,46,30,546
1897341_ThePianist2002Film.txt,1667,26,64,681,232,89,67,1069
1897579_RockyMountainNews.txt,669,19,35,306,66,53,14,439
1897581_AMaggot.txt,1563,11,142,631,163,121,37,952
1898156_RodneyMarshfootballer.txt,952,13,73,308,132,44,31,515
1898158_PeteVuckovich.txt,779,24,32,290,90,38,18,436
1898161_TheColoradoKid.txt,1271,22,57,489,146,95,34,764
1898569_TheFifthRace.txt,1088,13,83,343,190,53,50,636
1898579_CornellUniversityGleeClub.txt,1308,23,56,659,80,70,27,836
1898618_ListOfMiddleDistanceRunners.txt,1587,35,45,1292,26,42,9,1369
1898620_January28Incident.txt,1102,15,73,375,148,95,39,657
1899374_CarlZuckmayer.txt,634,10,63,233,79,45,10,367
1899519_TradePracticesAct1974.txt,1801,55,32,748,218,123,47,1136
189960_AssimilationstarTrek.txt,732,8,91,243,97,71,35,446
1899714_AngelBotello.txt,1108,23,48,427,149,66,23,665
189972_SabbataiZevi.txt,4418,54,81,1419,629,285,164,2497
189973_Jarrow.txt,898,18,49,407,94,57,26,584
189975_TyneTunnel.txt,664,14,47,225,77,51,9,362
189976_FoxtonLocks.txt,608,17,35,201,86,46,24,357
189977_DeclarationOfIndependenceireland.txt,775,14,55,234,111,51,29,425
189981_SymphonyNo8mahler.txt,1257,24,52,480,142,103,48,773
190000_RichardPorson.txt,3904,36,108,1159,589,229,171,2148
1900348_BattleOfKilcullen.txt,672,8,84,227,90,28,22,367
1900696_GameBoyMicro.txt,1674,28,59,654,209,126,66,1055
1901894_AContractWithGod.txt,1203,19,63,352,158,109,59,678
1901908_IndianStadium.txt,632,8,79,237,83,37,19,376
1901936_NoahKaiba.txt,1087,12,90,444,135,63,51,693
1902522_JamesShepherdPike.txt,764,6,127,339,77,43,18,477
1902872_ElizabethBentley.txt,3306,30,110,1295,450,180,111,2036
1904097_TheExterminator.txt,1142,16,71,397,186,40,39,662
1904104_Breit.txt,850,58,14,591,48,25,27,691
1904654_G3tour.txt,1363,87,15,927,50,32,7,1016
1905676_LondonFieldsnovel.txt,743,12,61,245,108,58,35,446
1906295_UnitedApostolicChurch.txt,1658,36,46,584,218,127,63,992
1906305_MimosaPudica.txt,620,9,68,226,109,53,31,419
1906854_RkSelectionTheory.txt,597,10,59,223,69,81,27,400
1907256_MiguelGrauSeminario.txt,632,14,45,234,73,33,16,356
1907450_BronteOntario.txt,934,18,51,369,125,67,24,585
1908014_Citrullinemia.txt,600,9,66,242,76,48,20,386
1908075_GordonGund.txt,941,16,58,365,113,41,18,537
1908240_RepublicOfGilead.txt,1902,20,95,587,332,188,86,1193
1909647_CaseyAtwood.txt,1232,11,112,414,181,59,42,696
191051_ArchOfTitus.txt,695,21,33,261,70,60,18,409
191052_FourCourts.txt,731,7,104,246,113,59,30,448
1910621_BajagaIInstruktori.txt,1576,25,63,646,176,136,56,1014
1910626_RoyalCommissionOnTheFutureOfHealthCareInCanada.txt,2250,55,40,941,281,194,42,1458
1910639_MariahKekkonen.txt,286,4,71,196,7,11,2,216
191067_1977InLiterature.txt,681,14,48,457,13,11,1,482
191071_1976InLiterature.txt,681,13,52,462,4,17,4,487
191073_1975InLiterature.txt,796,8,99,526,14,18,4,562
191075_1974InLiterature.txt,642,14,45,448,5,13,3,469
191078_1973InLiterature.txt,601,14,42,457,4,11,3,475
191081_1971InLiterature.txt,786,13,60,536,3,17,2,558
191082_1970InLiterature.txt,727,14,51,486,6,19,3,514
191083_1969InLiterature.txt,704,15,46,478,13,15,3,509
191084_1968InLiterature.txt,757,14,54,461,19,31,9,520
191086_TheObserver.txt,622,13,47,267,61,38,14,380
191087_1967InLiterature.txt,697,14,49,467,6,13,3,489
191091_MagicTreeHouseSeries.txt,752,62,12,473,25,33,5,536
191092_Nunavik.txt,660,16,41,287,53,50,6,396
191106_Bolzano.txt,1273,27,47,495,149,122,37,803
1911206_Ratoath.txt,1055,11,95,370,139,59,36,604
1911585_Dungeoncomics.txt,820,13,63,283,107,83,24,497
1911824_CandelariaMassacre.txt,716,10,71,237,110,54,22,423
1912386_SlimeVolleyball.txt,1084,27,40,437,124,72,38,671
1912797_WraithDart.txt,739,11,67,224,136,47,34,441
1912798_SpidermanTheNewAnimatedSeries.txt,540,11,49,264,58,20,6,348
1912799_SidewalkProphets.txt,1336,15,89,395,219,102,63,779
1912804_68MmRemingtonSpc.txt,750,14,53,275,89,66,31,461
1912807_BermanVParker.txt,696,7,99,241,112,49,18,420
1912840_SpringStampede.txt,1636,18,90,828,220,51,10,1109
1913594_Preferans.txt,3984,32,124,1191,652,292,181,2316
1915956_TestamentguiltyGear.txt,853,9,94,258,138,60,36,492
1916085_AncientGreekHistoryOfCyprus.txt,658,40,16,329,69,22,11,431
191709_RidOfMe.txt,776,14,55,262,110,61,37,470
191722_EdwardBalliol.txt,4630,43,107,1465,679,269,210,2623
1918265_ArturoPrat.txt,4631,76,60,1520,702,278,149,2649
1918285_SunshineBiscuits.txt,575,8,71,216,93,35,26,370
1918291_Type052cDestroyer.txt,2111,20,105,838,265,164,64,1331
1919008_JamesGordonFarrell.txt,716,31,23,305,68,54,10,437
1919500_TwoBadNeighbors.txt,2231,30,74,891,325,96,87,1399
1919513_Kopassus.txt,2354,45,52,983,301,165,76,1525
1920481_CarlLudwig.txt,1016,11,92,379,96,78,24,577
1921309_PaulKantner.txt,1257,24,52,643,96,66,23,828
192141_DistributedHashTable.txt,1575,29,54,557,238,141,66,1002
192143_BeingAndNothingnessAnEssayOnPhenomenologicalOntology.txt,2534,40,63,726,371,219,129,1445
1921458_LotfiRaissi.txt,785,16,49,295,119,27,19,460
1921474_ErlingDekkeNss.txt,5259,44,119,1754,787,411,147,3099
192163_RexParade.txt,795,14,56,303,99,51,30,483
192166_Hammersmith.txt,1317,27,48,617,119,86,23,845
1921690_WilburWood.txt,654,12,54,221,75,40,18,354
192176_Shura.txt,905,26,34,298,144,66,42,550
192180_EurovisionSongContest1972.txt,791,51,15,254,46,19,10,329
192181_UssOklahomabb37.txt,780,12,65,331,103,37,8,479
1922142_SpokaneChiefs.txt,1602,41,39,812,98,69,20,999
1922658_Gorgo.txt,632,14,45,229,98,34,25,386
1922668_JohnMorrisonmontanaPolitician.txt,948,18,52,383,112,66,17,578
1922669_VictoriaLord.txt,876,20,43,452,109,39,22,622
1923487_Paramara.txt,7373,206,35,3094,769,422,197,4482
1923489_PeoplesChoiceAwardsaustralia.txt,1025,47,21,924,2,11,2,939
1923836_GeorgWertheim.txt,763,14,54,263,105,54,26,448
1924513_UssMoodydd277.txt,617,8,77,263,74,22,11,370
1924791_GmelinaArborea.txt,869,19,45,368,114,99,47,628
1925479_SoniaTheHedgehog.txt,972,18,54,332,157,65,49,603
1926009_TzviTzur.txt,628,15,41,246,77,32,15,370
192817_BernadetteDevlinMcaliskey.txt,965,12,80,357,128,54,22,561
192818_YouthCulture.txt,856,13,65,336,105,82,27,550
1928196_MissionInn.txt,669,11,60,253,82,56,20,411
192819_UniversityOfQueensland.txt,2071,40,51,1138,144,107,31,1420
1928207_LarsLarson.txt,714,12,59,270,88,50,25,433
1928635_SwordMaking.txt,2071,39,53,573,394,156,132,1255
1928638_Machfeld.txt,880,17,51,396,76,76,15,563
1928831_ListOfMoths.txt,802,4,200,661,32,46,5,744
1928850_JohnRoberts.txt,4311,50,86,1800,516,227,135,2678
1929171_ForgedoctorWho.txt,973,17,57,390,146,59,24,619
19291_Morocco.txt,4399,94,46,1805,497,370,126,2798
19292_HistoryOfMorocco.txt,4047,43,94,1442,522,363,118,2445
19294_DemographicsOfMorocco.txt,770,39,19,300,72,89,25,486
19295_PoliticsOfMorocco.txt,723,9,80,330,75,57,11,473
19296_EconomyOfMorocco.txt,1570,26,60,567,171,160,44,942
1929854_JohnCroninconvict.txt,1781,29,61,538,304,121,65,1028
1929856_DirectCinema.txt,907,8,113,364,111,64,35,574
1930009_BritishRailClass142.txt,752,11,68,272,103,51,17,443
19302_HistoryOfMozambique.txt,1526,21,72,545,200,132,44,921
1930385_babyOneMoreTimesong.txt,1491,28,53,632,154,117,47,950
1930393_IowaInterstateRailroad.txt,589,14,42,312,55,25,8,400
193229_JohnTaylorOfCaroline.txt,873,10,87,333,91,67,13,504
193230_DredATaleOfTheGreatDismalSwamp.txt,742,11,67,355,62,51,29,497
193231_VictorienSardou.txt,1212,12,101,430,166,99,22,717
193233_BattleOfDoggerBank1915.txt,1251,24,52,452,188,85,38,763
193243_Shorts.txt,1096,6,182,365,165,116,54,700
193246_ListOfShipwrecks.txt,8106,91,89,4721,619,231,74,5645
193252_Heligoland.txt,1841,43,42,686,220,142,62,1110
1932553_KentSchoolDistrict.txt,1250,24,52,561,192,54,33,840
1933148_HrishikeshMukherjee.txt,946,17,55,491,101,39,15,646
19331_Moon.txt,6827,98,69,2277,936,605,271,4089
19334_MarcoPolo.txt,1983,31,63,801,241,104,67,1213
1933514_KenHill.txt,1350,16,84,516,164,87,49,816
1933736_TheBickersons.txt,1877,41,45,670,232,135,85,1122
1933745_CongregationromanCuria.txt,1400,11,127,435,173,109,44,761
19340_Limitmathematics.txt,881,38,23,273,111,65,45,494
19341_Modem.txt,6263,91,68,1995,909,622,297,3823
1934664_HalLesueur.txt,971,18,53,389,131,41,26,587
1934712_ExportPromotionBureauOfPakistan.txt,813,13,62,320,106,47,15,488
1935320_HistoryOfTheJewsInMorocco.txt,4311,34,126,1381,584,278,138,2381
1935911_AvestanAlphabet.txt,642,18,35,226,111,34,30,401
193843_JoanneWoodward.txt,759,16,47,318,91,30,23,462
193845_TheThreeFacesOfEve.txt,620,11,56,203,96,42,28,369
193889_FrankJames.txt,1005,17,59,425,130,45,28,628
193891_Isoiec646.txt,710,18,39,253,98,72,24,447
1939269_DevamritaSwami.txt,1363,30,45,566,189,65,33,853
193950_PointOfKnowReturn.txt,880,14,62,375,96,76,21,568
193960_SteveBellcartoonist.txt,575,8,71,219,65,47,17,348
1940076_BagabagNuevaVizcaya.txt,668,14,47,363,52,26,12,453
1940210_JohnPiaCraven.txt,601,10,60,256,65,33,10,364
1940213_ArthurBryant.txt,1293,30,43,529,131,74,45,779
1940871_XpressionFm.txt,672,12,56,344,47,24,10,425
1940936_LisasSubstitute.txt,681,12,56,262,104,32,17,415
1941218_BattleOfPicachoPass.txt,803,14,57,321,117,40,25,503
1941240_AintIAWoman.txt,1707,27,63,504,274,107,102,987
1942448_NationalUniversityOfEngineering.txt,709,19,37,336,60,53,14,463
1943045_PuzzleBox.txt,764,5,152,220,107,72,36,435
1943050_FrederickDentGrant.txt,599,17,35,246,81,19,2,348
1943059_Kunicon.txt,873,19,45,292,156,71,33,552
194316_PrincessCharlotteAugustaOfWales.txt,916,16,57,342,118,60,22,542
194332_Bullfighting.txt,6771,66,102,2167,1038,536,249,3990
194340_InternetKeyExchange.txt,629,15,41,228,100,49,30,407
1943426_SingaporeGayLiterature.txt,1702,17,100,748,153,148,30,1079
194342_SvetlanaAlliluyeva.txt,969,15,64,335,141,59,29,564
194343_OwenRoeOneill.txt,1143,11,103,436,153,62,23,674
194347_TurkeyVulture.txt,1312,38,34,483,177,122,57,839
1943628_Hoon.txt,1421,18,78,519,226,160,77,982
1943634_CityGround.txt,818,15,54,276,111,44,26,457
1944030_RailTransportInTheUnitedStates.txt,3288,48,68,1222,441,255,127,2045
1944587_JamesAndersoncricketer.txt,1368,14,97,460,186,82,66,794
1944643_Dumafilm.txt,755,17,44,255,124,40,28,447
1945597_MadonnasAchievementsAndAwards.txt,7204,157,45,3981,510,353,148,4992
1945618_LenaPhilipsson.txt,769,17,45,325,63,58,11,457
1945801_ZoomaudioCompany.txt,949,20,47,378,113,90,31,612
1946204_WorldMusicMarket.txt,613,20,30,261,67,46,21,395
1946212_HammeringMan.txt,726,11,66,284,86,47,17,434
1947410_CriticalPeriod.txt,836,12,69,331,78,102,31,542
1947598_Armos.txt,1163,13,89,381,173,91,43,688
1947751_Godzillacomics.txt,668,8,83,240,84,43,35,402
1947770_YouTalkinToMe.txt,967,6,161,350,154,28,35,567
1947778_StatutoryInterpretation.txt,1933,40,48,671,263,156,80,1170
1948584_ForceGhost.txt,1738,16,108,552,251,119,87,1009
1948909_EuropeanHillClimbChampionship.txt,978,15,65,563,13,16,2,594
1948944_LawOfAustralia.txt,842,14,60,297,104,97,35,533
194910_SteveEarle.txt,1914,33,58,773,240,117,49,1179
194914_SymphonyNo6mahler.txt,1908,23,82,590,261,160,98,1109
1949602_NorthcottTheatre.txt,821,18,45,312,109,46,27,494
1949612_Somatotype.txt,1424,19,74,529,181,156,58,924
195045_EmperorGoshirakawa.txt,768,11,69,305,93,27,18,443
1951124_LiturgyOfTheHours.txt,1875,27,69,685,226,114,48,1073
1951150_BountyenterpriseEpisode.txt,630,9,70,210,106,37,38,391
1952105_DeepNote.txt,682,12,56,276,78,48,18,420
1952310_VanMccoy.txt,781,4,195,336,75,56,25,492
1952952_LinkAggregation.txt,876,22,39,280,140,94,51,565
1952961_Wapol.txt,927,16,57,310,140,64,49,563
1953928_GlobalInformationGrid.txt,834,17,49,374,109,63,27,573
1953991_TalknTextPhonePals.txt,2829,59,47,1220,328,140,49,1737
195407_EinsteinNotation.txt,1273,73,17,424,166,79,63,732
195409_DavidCoulthard.txt,1597,20,79,597,198,118,42,955
195413_AltHierarchy.txt,770,14,55,234,139,76,39,488
1954283_EasternNewMexicoUniversity.txt,714,16,44,360,64,41,6,471
1954311_SilentNightDeadlyNight.txt,1975,17,116,627,381,84,112,1204
195437_Audioslave.txt,1709,28,61,640,239,130,55,1064
195468_PacificRingOfFire.txt,637,9,70,267,68,61,17,413
195469_LiquidSwords.txt,608,12,50,284,63,41,19,407
195472_400Degreez.txt,377,5,75,230,19,14,5,268
195481_Tarbosaurus.txt,665,18,36,279,84,40,24,427
195486_Vitalogy.txt,973,18,54,450,111,58,20,639
195487_CharlesLeBrun.txt,1095,13,84,395,126,67,34,622
1955471_LearningObjectMetadata.txt,1884,24,78,765,254,115,36,1170
1955672_ListOfPhilippineTelevisionShows.txt,1305,41,31,963,27,18,6,1014
1956093_ClintonCorrectionalFacility.txt,838,10,83,332,85,53,22,492
1956489_FlintGenerals.txt,668,13,51,275,40,22,7,344
1957273_WashingtonDcRiotOf1991.txt,672,10,67,234,114,40,25,413
1957627_TheMegaPowers.txt,1587,19,83,629,236,44,58,967
1958496_GurpsBlackOps.txt,814,13,62,271,109,62,47,489
1958831_Saddha.txt,2620,44,59,899,333,155,121,1508
1958834_DaniloBataStojkovi.txt,1219,17,71,472,108,97,48,725
1958835_AucklandUniversityStudentsAssociation.txt,873,21,41,444,91,36,21,592
1958847_ManuelaSenz.txt,737,14,52,317,86,48,6,457
1958879_RosalieBradford.txt,575,12,47,196,89,25,24,334
1959449_StephenStorace.txt,2735,15,182,874,396,238,129,1637
1959829_IllinoisCommunityCollegeSystem.txt,1619,21,77,686,197,125,21,1029
196075_AboriginalPeoplesInCanada.txt,739,10,73,309,67,61,31,468
1961000_GayRightsInIraq.txt,2335,51,45,878,291,172,70,1411
1961039_KarlDietrichBracher.txt,711,7,101,340,68,40,9,457
1961054_Hydrogenase.txt,689,27,25,283,80,84,11,458
196117_PrenuptialAgreement.txt,623,14,44,198,95,41,26,360
196124_Peyo.txt,801,13,61,309,89,66,22,486
1961816_BombardierTransportation.txt,688,22,31,444,43,44,8,539
1962219_HocusPocusfilm.txt,1305,12,108,504,188,57,48,797
1962803_JindaleeOperationalRadarNetwork.txt,1502,28,53,590,204,92,32,918
1963223_EPSanders.txt,1059,14,75,437,130,45,24,636
1963235_MakingTheBand.txt,1119,21,53,461,129,84,21,695
1963240_SefGonzales.txt,885,11,80,300,149,45,26,520
1964171_OptimumOnline.txt,753,13,57,293,114,42,33,482
1964198_PuddleJumperstargate.txt,2201,33,66,719,360,153,101,1333
1964369_ChaseStevens.txt,1224,30,40,561,158,35,36,790
1964402_JonasBjrkman.txt,611,32,19,266,57,30,7,360
1964976_IntercooperativeCouncilAtTheUniversityOfMichigan.txt,812,14,58,367,86,49,15,517
1965052_MsgNetwork.txt,3276,35,93,1522,333,230,113,2198
1965053_DiveSitesOfPalau.txt,2508,40,62,847,285,319,153,1604
1965334_MarkusHess.txt,736,14,52,299,114,39,21,473
196533_CommunesOfTheSommeDepartment.txt,854,3,284,55,3,3,0,61
1965348_KevinCampbellfootballer.txt,743,12,61,251,107,36,21,415
1965368_ListOfWorldWarIiArtillery.txt,1062,4,265,630,22,120,2,774
196556_Postmodernity.txt,4445,69,64,1664,533,390,128,2715
196567_Codamusic.txt,645,9,71,222,74,43,25,364
196570_ChristianCoalitionOfAmerica.txt,1142,24,47,416,157,70,36,679
196573_Us4thArmoredDivision.txt,627,12,52,261,65,37,7,370
196590_NikkiSixx.txt,1917,20,95,714,285,128,65,1192
196591_GeneKrupa.txt,1043,18,57,380,151,63,33,627
1966201_PatSullivanamericanFootball.txt,728,13,56,317,74,33,15,439
1966346_HassanKuchak.txt,635,6,105,239,99,20,21,379
1966560_2001album.txt,960,20,48,445,96,57,32,630
1966592_Criminon.txt,616,11,56,244,110,44,20,418
1967170_JuanMeza.txt,974,22,44,391,105,45,22,563
1967540_DaveFinlay.txt,1532,32,47,669,182,79,33,963
1967543_AlanAcourt.txt,714,14,51,265,90,42,23,420
1967550_TheShamblescommunityTelevisionProgram.txt,641,16,40,272,67,30,22,391
1967552_BusinessValue.txt,948,21,45,385,121,86,42,634
1967554_Antigua.txt,1300,20,65,520,181,97,37,835
1968726_SantaMonicaHighSchool.txt,2327,47,49,1223,222,99,38,1582
1968737_ArthurRavenelJrBridge.txt,1508,21,71,570,196,96,35,897
1968760_JohnAstor3rdBaronAstorOfHever.txt,602,22,27,324,34,19,5,382
1968761_NaimAudio.txt,1152,18,64,464,144,109,36,753
1969342_TheGardenOfGod.txt,1239,16,77,362,225,66,56,709
1969353_Vrillon.txt,850,16,53,230,124,47,28,429
1969366_SymphonyNo7bruckner.txt,887,13,68,392,113,49,27,581
1969707_WilliamMcdonough.txt,577,7,82,245,60,44,11,360
1970317_MetalSlug4.txt,1555,20,77,519,227,135,73,954
1970382_RemoteAdministrationTool.txt,496,15,33,212,71,40,17,340
1970701_Pechmythology.txt,932,11,84,238,178,50,40,506
1970945_FreedomOfContract.txt,631,6,105,204,86,55,13,358
1971339_HistoryOfTheArabicAlphabet.txt,2056,31,66,674,296,187,87,1244
197202_GreatSpottedWoodpecker.txt,565,17,33,182,82,46,29,339
197203_TechnicalUniversityOfBerlin.txt,614,20,30,297,43,42,6,388
197204_LesserSpottedWoodpecker.txt,619,11,56,207,84,58,27,376
1972098_WesttownSchool.txt,839,11,76,364,90,70,18,542
19722_Metallurgy.txt,1065,22,48,384,185,114,34,717
19723_Mumps.txt,5230,106,49,1948,743,491,234,3416
1972694_ListOfAngolanCompanies.txt,909,46,19,669,46,44,7,766
1972708_BattleOfAnnihilation.txt,1442,37,38,432,227,134,85,878
19727_MichaelFaraday.txt,2580,42,61,960,320,189,62,1531
19728_Marriage.txt,6113,83,73,2066,879,563,273,3781
1973072_LorisTjeknavorian.txt,663,13,51,304,57,38,12,411
1973087_LudovicoTechnique.txt,899,15,59,317,127,65,36,545
1973092_TaxationInTheRepublicOfIreland.txt,1919,34,56,657,221,167,66,1111
19731_Midgard.txt,884,14,63,355,118,64,14,551
19734_MalcolmFraser.txt,1787,40,44,690,239,111,50,1090
1974884_CityCollegeOfSanFrancisco.txt,1414,34,41,834,88,102,18,1042
1974897_ThePrinceOfDarknessnadesico.txt,1244,22,56,409,199,90,59,757
1975260_StellatvSeries.txt,990,28,35,444,117,54,39,654
1975854_SealOfNewMexico.txt,778,14,55,294,102,40,20,456
197618_JosMaraAznar.txt,2954,51,57,1085,366,217,82,1750
197637_1962InSports.txt,1767,54,32,1227,74,59,8,1368
197638_GrandSlamtennis.txt,2625,60,43,1344,203,192,62,1801
197639_InquisitorialSystem.txt,1647,21,78,514,215,180,69,978
197655_SkiBinding.txt,1007,16,62,342,155,93,47,637
197661_InternationalSolidarityMovement.txt,3185,46,69,1266,448,174,71,1959
197696_Sakya.txt,630,18,35,288,56,47,9,400
1977073_JoondalupWesternAustralia.txt,1074,30,35,448,104,75,30,657
1977079_June2005InRailTransport.txt,1778,6,296,741,199,91,36,1067
1977431_LoraineBraham.txt,1895,24,78,596,304,115,97,1112
1977435_Moralia.txt,1128,8,141,494,71,63,24,652
1978363_HistoryOfTheUnitedStatesDollar.txt,2844,37,76,912,372,205,94,1583
1978705_ListOfWhaleSpecies.txt,603,16,37,328,82,33,20,463
1978719_BishopCarrollHighSchoolalberta.txt,696,12,58,306,65,54,12,437
1979299_GizaPyramidComplex.txt,853,13,65,340,94,42,31,507
1979327_DerekLaud.txt,1052,22,47,380,151,62,33,626
1980512_ImmortalGrandPrix.txt,3963,42,94,1682,495,248,133,2558
1980530_NinthDoctor.txt,2355,33,71,812,322,143,101,1378
1980547_FirstDoctor.txt,1570,29,54,617,181,91,57,946
1980899_KatMoon.txt,1349,16,84,486,235,61,53,835
1980907_EdwardWilliamGodwin.txt,668,10,66,255,76,53,16,400
1981510_ScottFry.txt,820,14,58,404,61,26,16,507
198234_Digital8.txt,952,15,63,390,120,83,34,627
198299_MaundyMoney.txt,1235,16,77,516,128,72,33,749
1983032_PeptideMassFingerprinting.txt,843,11,76,344,124,68,32,568
1983033_Partygaming.txt,1481,29,51,584,211,98,38,931
1983690_KingsDomainMelbourne.txt,1267,21,60,504,157,80,17,758
1983714_RookieChallenge.txt,452,63,7,299,23,11,5,338
1983901_SkoolDaze.txt,1743,42,41,568,277,74,88,1007
1984054_TracyBrookshaw.txt,1543,29,53,704,203,50,36,993
1984866_SamJethroe.txt,1037,10,103,368,124,48,27,567
1986069_CambridgeshireCountyCricketClub.txt,636,20,31,248,80,32,16,376
1986427_CartmansMomIsStillADirtySlut.txt,855,14,61,313,131,38,35,517
1986434_TraumaCenterUnderTheKnife.txt,1523,39,39,607,200,86,32,925
1987049_DamonAllen.txt,1741,27,64,709,182,108,34,1033
198713_Willibrord.txt,670,12,55,221,105,28,17,371
198716_VirtualWater.txt,777,9,86,304,86,79,24,493
198717_LouisLeBrocquy.txt,1079,22,49,527,98,71,17,713
198725_DrinkingWater.txt,1094,19,57,422,153,112,42,729
198730_Spire.txt,958,13,73,297,127,95,48,567
198770_WhitefrontedGoose.txt,549,14,39,226,49,66,28,369
1988023_GeorgeKingaetheriusSociety.txt,2340,37,63,772,336,166,66,1340
1988236_LincoronazioneDiPoppea.txt,583,10,58,261,78,34,14,387
1988622_FemaleSexualArousalDisorder.txt,1199,37,32,494,119,153,38,804
1988636_Legaia2DuelSaga.txt,873,19,45,282,146,60,26,514
1990198_Halflife2ControversiesAndCriticisms.txt,2912,32,91,922,486,234,145,1787
1992376_IrvingJohnsontallShip.txt,745,14,53,296,90,47,14,447
1992576_YadhiraCarrillo.txt,679,27,25,292,82,25,14,413
1994778_TadeuszBoyeleski.txt,642,12,53,251,67,70,13,401
1995307_JazzChords.txt,1325,73,18,441,162,120,44,767
1995715_Damoh.txt,808,53,15,390,82,50,3,525
1995752_HistoryOfCommunistCzechoslovakia.txt,1520,17,89,538,204,120,40,902
1996923_TomsGutirrezAlea.txt,1389,21,66,596,134,122,34,886
1996967_BrianHorton.txt,922,15,61,328,120,61,30,539
1997889_PaulGreen.txt,690,8,86,280,75,55,22,432
1997929_DeutschesStadion.txt,808,15,53,307,100,48,36,491
199804_ScienceAndTechnologyInTheUnitedStates.txt,3673,48,76,1287,473,359,128,2247
199813_Fouralbum.txt,393,10,39,208,19,30,6,263
1998142_ElizabethDilling.txt,670,9,74,269,73,36,13,391
199822_Heman.txt,3056,49,62,1106,416,291,119,1932
199823_PiaKjrsgaard.txt,669,22,30,258,71,51,18,398
199824_RodgersAndHart.txt,732,8,91,330,53,52,31,466
199825_RodgersAndHammerstein.txt,1323,24,55,524,151,89,39,803
199830_LiberalCatholicChurch.txt,2176,25,87,827,273,133,70,1303
199831_TheosophicalSocietyAdyar.txt,1037,28,37,472,106,79,21,678
199832_BernadettePeters.txt,2706,46,58,1296,211,139,56,1702
1999105_SouthwestHighSchoolminneapolisMinnesota.txt,1325,27,49,548,169,88,29,834
1999112_SecondBookOfEnoch.txt,1312,14,93,445,160,86,50,741
1999117_BetseyCushingRooseveltWhitney.txt,950,19,50,430,83,51,16,580
1999119_PlasticRecycling.txt,1051,21,50,332,171,121,62,686
1999155_RobertIDukeOfParma.txt,773,12,64,331,79,38,21,469
2000074_GlengarryGlenRossfilm.txt,700,11,63,261,95,46,28,430
2000128_OnlineIdentity.txt,5106,61,83,1713,774,374,226,3087
2000305_YekaterinaRomanovnaVorontsovadashkova.txt,1032,15,68,326,142,68,32,568
2001231_Evidencelaw.txt,1366,21,65,457,197,138,46,838
2002450_HellyHansen.txt,870,17,51,288,139,87,24,538
2002497_CriticalRaceTheory.txt,957,17,56,392,109,111,23,635
2002775_1974InCountryMusic.txt,1600,16,100,1058,33,30,17,1138
2003440_UsRoute220.txt,1674,28,59,777,146,84,39,1046
2003999_SodomfinalFight.txt,1322,18,73,460,212,95,56,823
200412_AfghanistanTimelineMarch2003.txt,7420,32,231,3167,1048,396,89,4700
2004430_AndrewMcmahon.txt,1373,18,76,551,179,87,41,858
2004436_ListOfHighSchoolsInMississippi.txt,1792,88,20,1725,2,13,1,1741
2004669_BabaSali.txt,677,8,84,255,94,34,10,393
2005649_GianniRodari.txt,563,12,46,237,47,43,8,335
2005983_CatalystSwitch.txt,1071,25,42,439,142,75,45,701
2006627_OldYellerBelly.txt,644,8,80,266,96,21,18,401
2006839_PeroduaMyvi.txt,576,19,30,218,75,49,15,357
2007149_FinnishPresidentialElection2006.txt,1894,34,55,732,222,143,50,1147
2008803_KotaroShimomura.txt,811,18,45,287,117,53,24,481
200892_FritzTodt.txt,632,7,90,244,71,36,20,371
2009386_FarleighHungerford.txt,1113,13,85,407,144,69,35,655
2009387_FranceWomensNationalFootballTeam.txt,785,16,49,272,88,61,26,447
2009947_AliceSweetAlice.txt,1060,7,151,373,155,46,30,604
2010183_SirThomasBuxton1stBaronet.txt,664,15,44,266,85,28,13,392
2011160_OdinPhotonSailerStarlight.txt,1057,18,58,371,163,57,49,640
2012370_AmericanConstitutionSocietyForLawAndPolicy.txt,598,12,49,342,49,49,3,443
2012371_LouisKoo.txt,644,9,71,308,38,32,16,394
2012377_CeDoh.txt,1032,7,147,371,171,45,36,623
2012378_ListOfHighSchoolsInMinnesota.txt,2419,90,26,2351,3,32,2,2388
2012734_FloronicMan.txt,737,10,73,244,116,46,24,430
2013380_Specint.txt,654,14,46,252,102,30,22,406
2014307_UsAndCanadianLicensePlates.txt,5975,83,71,2518,714,384,217,3833
2015524_AbujaStadium.txt,1882,25,75,746,219,145,40,1150
2015560_TheKingsDemons.txt,940,13,72,388,119,35,23,565
2015570_Oscillococcinum.txt,567,13,43,251,56,48,11,366
2015573_GoldiiiChloride.txt,732,23,31,342,68,56,29,495
201562_EgyptianCalendar.txt,765,13,58,286,89,56,23,454
201568_HmsMacedonian.txt,653,14,46,223,96,51,34,404
201572_Anatta.txt,4164,57,73,1311,561,344,204,2420
201573_MareTranquillitatis.txt,695,15,46,264,83,44,10,401
201634_WhitebelliedSeaEagle.txt,573,15,38,196,70,82,22,370
2016493_Whirlmart.txt,618,13,47,210,105,48,42,405
2016505_HistoryOfPatentLaw.txt,1063,24,44,402,162,49,26,639
2016534_1950InNorwegianFootball.txt,1556,33,47,372,4,33,7,416
2016701_EmpireFalls.txt,1573,9,174,629,199,126,62,1016
2016723_RedbudWoodsControversy.txt,791,12,65,330,84,42,25,481
2018273_KoowartaVBjelkepetersen.txt,1530,26,58,513,218,103,61,895
201968_Synapsid.txt,1263,21,60,414,170,139,41,764
201969_Taif.txt,1810,31,58,650,232,111,69,1062
202008_Plagiaulacida.txt,558,23,24,220,69,25,27,341
202009_ListedBuilding.txt,1344,28,48,602,160,110,41,913
202011_ReformClub.txt,601,14,42,260,67,30,14,371
202018_TonyOreilly.txt,998,19,52,356,108,47,32,543
2020401_PulmonarySurfactant.txt,788,18,43,282,119,69,26,496
2020451_StarWarsPrequelTrilogy.txt,1253,18,69,482,170,91,41,784
2020855_TiniiChloride.txt,874,35,24,382,123,86,28,619
2020857_WinterHillGang.txt,951,10,95,487,92,29,20,628
2021081_BrandywellStadium.txt,1222,17,71,452,139,81,49,721
2022029_WandaGg.txt,1020,16,63,394,141,58,20,613
2022036_ClosedeyeHallucination.txt,1162,31,37,301,183,137,79,700
2022046_Gravion.txt,951,23,41,330,139,69,24,562
2022070_Ayyavazhi.txt,6338,94,67,2133,861,492,256,3742
2022387_PaulManz.txt,727,10,72,316,82,39,28,465
2022578_Darkhold.txt,694,10,69,240,112,45,21,418
2023247_NizhalThangal.txt,1074,28,38,407,141,59,32,639
2024225_HipHopDance.txt,673,12,56,279,89,67,33,468
2024258_WayneGretzkysRecords.txt,1581,12,131,672,99,117,27,915
2024425_LmsGarratt.txt,532,23,23,195,82,36,14,327
2024429_SomeAssemblyRequiredbuffyEpisode.txt,790,19,41,324,119,23,20,486
2024570_HistoryOfMozillaApplicationSuite.txt,1680,28,60,632,222,143,72,1069
2025378_GrecoitalianWar.txt,4165,53,78,1548,538,325,139,2550
2025379_ListOfSouthAfricanMilitaryChiefs.txt,898,17,52,645,32,11,1,689
2025381_EddieKeher.txt,661,11,60,228,71,51,16,366
2025391_PatriceBartwilliams.txt,620,8,77,267,70,42,17,396
2025394_ListOfBionicleMedia.txt,2113,17,124,876,207,79,37,1199
2025411_GarrettHardin.txt,582,11,52,269,37,29,10,345
2025781_ArgentineArmy.txt,2059,42,49,836,176,165,38,1215
2025782_JrgenBudday.txt,729,25,29,485,47,25,10,567
2025919_Patternsewing.txt,577,14,41,216,112,37,20,385
202603_AustralianContributionToThe2003InvasionOfIraq.txt,2634,36,73,999,331,227,104,1661
202639_NationalTaiwanUniversity.txt,2049,26,78,1100,88,136,22,1346
202664_DianeKeaton.txt,4073,50,81,1446,555,308,147,2456
202702_RayIran.txt,1065,23,46,396,148,68,26,638
2027920_BlowMolding.txt,1147,22,52,443,201,83,26,753
2029081_Ckdjfm.txt,897,20,44,403,94,39,26,562
2029761_RomanizationOfBulgarian.txt,670,19,35,212,73,50,30,365
2029771_Antistatism.txt,625,13,48,283,58,47,20,408
2030098_RaiseTheTitanic.txt,725,15,48,276,114,23,32,445
203056_SphericalHarmonics.txt,1429,71,20,502,152,174,35,863
2030732_AlanWalkermusicologist.txt,794,13,61,343,78,39,22,482
2030760_HomebuiltComputer.txt,979,23,42,343,140,97,58,638
203076_BrianBell.txt,666,12,55,299,73,29,14,415
203096_ThomasWentworth1stEarlOfStrafford.txt,3233,29,111,997,502,173,112,1784
203112_ThomasRoe.txt,797,7,113,295,87,33,20,435
203163_Fugaziband.txt,1697,36,47,700,210,125,75,1110
203180_Orbitalband.txt,1815,30,60,730,182,136,42,1090
2032943_SusanLewis.txt,712,8,89,240,107,43,25,415
2032944_Courtallam.txt,581,12,48,245,66,31,13,355
2032945_MatchPoint.txt,1776,32,55,627,251,106,75,1059
2033116_FairGamescientology.txt,3935,76,51,1390,596,235,154,2375
2033124_DianeticsTheModernScienceOfMentalHealth.txt,1227,28,43,468,184,78,32,762
2033126_ListOfPrimeMinistersOfSyria.txt,590,6,98,287,1,5,0,293
2034071_TecmosDeception.txt,695,26,26,240,97,43,21,401
2034084_StateBarOfCalifornia.txt,2407,39,61,923,313,160,69,1465
2034465_KissingGourami.txt,725,9,80,227,119,87,34,467
2034663_UnitedStatesSeatedLibertyCoinage.txt,666,11,60,264,77,33,12,386
2035296_BatteryPack.txt,587,9,65,233,76,55,26,390
2036254_UciWorldCup.txt,641,15,42,241,76,53,14,384
2036264_ListOfDoctorWhoMonstersAndAliens.txt,6949,269,25,2490,1012,459,242,4203
2036279_AssuranceContracts.txt,637,8,79,205,110,43,30,388
2036797_Wlup.txt,793,14,56,324,120,51,16,511
203733_TheDeptfordTrilogy.txt,592,12,49,212,79,42,12,345
2037472_UssJeannette1878.txt,842,12,70,302,112,53,31,498
2037496_SamuelGreenfreedman.txt,642,10,64,237,92,22,13,364
2037499_MaceTheDarkAge.txt,969,29,33,364,130,73,24,591
20374_Metabolism.txt,646,17,38,280,79,60,16,435
203754_Jessadabodindra.txt,619,11,56,257,100,36,19,412
203756_BhumibolAdulyadej.txt,4767,75,63,1910,603,324,120,2957
20375_MedievalInquisition.txt,1375,19,72,406,248,120,59,833
20377_Microorganism.txt,2388,50,47,790,352,242,119,1503
2037826_CommunistPartyOfNorway.txt,1942,35,55,728,242,129,69,1168
203792_ChgyamTrungpa.txt,2919,86,33,1364,265,165,63,1857
203793_MinistryOfDefenceunitedKingdom.txt,1254,20,62,621,98,61,15,795
203794_AlmaMahler.txt,1508,13,116,550,189,93,45,877
20379_Micronation.txt,5287,69,76,2062,632,461,136,3291
20381_Mining.txt,3178,52,61,1246,450,300,99,2095
20394_MyanmarArmedForces.txt,6595,117,56,3205,540,419,117,4281
20395_ForeignRelationsOfMyanmar.txt,1029,29,35,479,103,90,24,696
2039690_IsotopesOfHydrogen.txt,598,17,35,248,66,47,7,368
2040063_ListOfPeopleByNameSteasteo.txt,726,16,45,546,4,39,0,589
2040064_UssPecosao65.txt,918,12,76,371,126,41,20,558
2040595_HuaRong.txt,656,7,93,252,113,40,24,429
20405_MilesDavis.txt,6363,70,90,2386,791,504,242,3923
2040605_JohnRWinder.txt,856,15,57,339,104,35,21,499
20407_Multicast.txt,979,15,65,416,137,71,47,671
2041027_DemocraticStructuring.txt,1136,14,81,276,220,92,76,664
2041030_PacificSaury.txt,746,17,43,230,107,86,25,448
204148_UssSouthCarolinabb26.txt,1309,16,81,540,127,51,29,747
20414_MeuseRiver.txt,677,12,56,298,57,53,22,430
204154_Erlangen.txt,782,17,46,293,74,61,27,455
204157_OperationTailwind.txt,1220,15,81,452,206,57,47,762
2041767_BakMei.txt,2152,36,59,897,289,94,82,1362
20418_MichaelBentine.txt,697,15,46,283,67,38,11,399
20419_Mania.txt,979,23,42,353,142,112,51,658
204207_TheNineChaptersOnTheMathematicalArt.txt,725,11,65,258,92,70,22,442
20420_Multimedia.txt,1794,34,52,726,259,140,67,1192
20421_MaxHeadroomtvSeries.txt,2128,25,85,870,246,184,63,1363
204225_BartolomeoCristofori.txt,4173,84,49,1459,578,311,185,2533
2042384_BengalMonitor.txt,914,17,53,377,108,72,35,592
20423_Malaria.txt,6404,85,75,2218,967,642,296,4123
20424_LunarPhase.txt,1579,17,92,495,195,152,70,912
204260_Hafez.txt,1816,80,22,643,235,98,55,1031
20426_MetonicCycle.txt,739,10,73,230,80,75,34,419
20427_March26.txt,1871,6,311,1070,59,56,3,1188
20428_MarcelloMalpighi.txt,769,18,42,261,108,53,18,440
2043354_Cogliostro.txt,1433,18,79,421,247,81,75,824
2043412_Shapeshifterband.txt,598,15,39,293,59,37,14,403
2043942_DioceseOfBathAndWells.txt,822,12,68,309,101,38,21,469
2043948_WolfHoward.txt,726,12,60,248,102,54,18,422
2043956_ListOfSongsWithPersonalNamesB.txt,1570,6,261,1025,33,25,38,1121
2043968_ListOfSongsWithPersonalNamesC.txt,1615,8,201,1076,31,17,10,1134
2044316_BobbyJulich.txt,1128,13,86,452,116,77,32,677
2045160_MeredithMacrae.txt,635,14,45,242,83,33,22,380
2045162_BattleOfThreeRocks.txt,710,16,44,262,108,33,16,419
2045166_ElectroshockBlues.txt,781,17,45,338,86,54,32,510
2045342_LatinBasilians.txt,992,16,62,345,122,46,18,531
2046136_CallMeblondieSong.txt,691,13,53,256,86,68,18,428
2047379_Gaels.txt,1889,13,145,831,173,147,71,1222
204817_Heidi.txt,840,18,46,325,111,56,22,514
2048336_IrfanOrga.txt,1414,16,88,433,206,112,75,826
2048511_Udaff.txt,896,13,68,322,104,108,32,566
2048531_StLouisArsenal.txt,780,16,48,323,85,57,12,477
2048748_MillMountainStar.txt,1058,17,62,373,149,76,44,642
2050696_StarOceanEx.txt,970,17,57,321,137,61,54,573
2050699_GlobusCassus.txt,744,16,46,276,116,58,22,472
2051699_ListOfThrillerFilms.txt,492,66,7,311,4,4,2,321
2052033_ListOfSongsAboutPoliticians.txt,1807,22,82,1186,43,29,24,1282
2052094_ListOfCarnegieMellonUniversityPeople.txt,2292,20,114,1500,84,94,18,1696
2052881_ListOfTheDailyShowGuests.txt,714,14,51,480,30,51,8,569
2053065_WeblogSoftware.txt,976,22,44,398,127,87,29,641
205324_AntisatelliteWeapon.txt,1473,15,98,483,227,142,53,905
2053255_ElizabethJolley.txt,910,14,65,366,101,70,31,568
205360_ColdstreamGuards.txt,1978,36,54,826,199,99,36,1160
2056214_JosiahWarren.txt,997,13,76,364,129,55,24,572
2056222_OfferAndAcceptance.txt,2074,31,66,643,336,125,72,1176
2057185_MtvMovieAwards2005.txt,654,20,32,420,24,12,4,460
2058198_UssYosemite1892.txt,662,7,94,248,70,34,24,376
205912_MohammadRabbani.txt,880,24,36,340,111,44,22,517
2059373_DungeonsDragonsManuals.txt,2410,25,96,1143,226,188,54,1611
2059409_SilhouetteMirage.txt,2664,40,66,892,381,201,83,1557
2060588_CanonTheatre.txt,795,13,61,329,91,52,10,482
2060965_Starcom.txt,1269,19,66,697,116,61,24,898
2062566_ThreeMenOnTheBummel.txt,1164,18,64,385,155,84,51,675
2062576_BattletanxGlobalAssault.txt,796,19,41,312,96,63,36,507
206375_Cantopop.txt,2178,39,55,844,247,230,93,1414
2063780_Toyman.txt,1547,24,64,576,228,103,51,958
206391_SvenHassel.txt,1655,29,57,578,241,137,62,1018
206392_NancyWake.txt,625,14,44,246,80,26,11,363
206401_Hm.txt,1291,24,53,604,137,79,36,856
206410_Rallidae.txt,1345,16,84,840,116,116,49,1121
206423_Basildon.txt,789,23,34,349,89,54,22,514
206425_MidrashHalakha.txt,1765,20,88,541,220,127,67,955
206427_UssRangercv4.txt,1648,32,51,645,212,91,40,988
206428_JohnWilliamBurgon.txt,825,16,51,298,96,67,26,487
206430_Hyrcania.txt,959,13,73,342,131,75,35,583
206431_Southendonsea.txt,2109,48,43,913,229,170,66,1378
206448_VictorBurgin.txt,1466,109,13,961,47,36,3,1047
2064944_GonebuffyEpisode.txt,1035,21,49,308,198,52,54,612
2064959_Bartitsu.txt,1705,31,55,602,223,167,48,1040
2065094_UniversityHighSchoolfresno.txt,659,15,43,396,36,26,4,462
2065867_TheLifeAndReligionOfMohammed.txt,602,12,50,310,35,22,6,373
2066888_UndergraduateAmbassadorsScheme.txt,754,16,47,270,113,57,13,453
2067091_Izmail.txt,703,12,58,270,85,43,17,415
2067092_ClarisEmiler.txt,932,7,133,346,139,74,34,593
2067126_SubRosatngEpisode.txt,814,12,67,281,133,41,43,498
2067136_LudkPachman.txt,623,7,89,220,90,38,18,366
2067137_KrustyBurger.txt,845,12,70,314,131,55,33,533
2067477_DamageControlcomics.txt,1304,17,76,539,185,94,39,857
2068058_RedHeifer.txt,948,14,67,297,166,64,28,555
2068074_SwissLiterature.txt,5599,45,124,2020,560,532,196,3308
2069070_Wnemtv.txt,851,15,56,363,84,48,22,517
2069075_RehearsalLetter.txt,846,13,65,261,104,65,58,488
2069318_BonVoyageCharlieBrownandDontComeBack.txt,616,9,68,226,92,33,16,367
2069661_Dunboyne.txt,811,9,90,290,96,39,11,436
207009_Cohousing.txt,913,15,60,348,124,88,32,592
2070246_Chsrfm.txt,656,13,50,294,75,55,12,436
2070255_JackieSpeier.txt,724,17,42,331,88,43,6,468
2070258_TheClevelandlorettaQuagmire.txt,1472,13,113,561,231,55,64,911
207068_MuawiyahI.txt,1691,34,49,580,252,86,59,977
207074_BetaDistribution.txt,607,35,17,222,89,43,22,376
2071485_Azra.txt,563,16,35,267,40,24,10,341
2071836_BattleOfFortWilliamHenry.txt,735,13,56,260,94,59,21,434
2073617_KingsQuestMaskOfEternity.txt,1106,11,100,381,141,61,50,633
2073834_Futuh.txt,2210,48,46,777,246,213,68,1304
2074596_ListOfRahxephonCharacters.txt,6046,149,40,2197,889,384,214,3684
207463_Poole.txt,2118,33,64,904,223,146,52,1325
207480_DougGilmour.txt,1294,20,64,517,150,75,40,782
2074818_FaunaOfTheMarquesasIslands.txt,570,12,47,242,63,68,23,396
2074822_Wbos.txt,706,15,47,249,99,52,38,438
207485_Abcband.txt,1844,34,54,735,227,130,58,1150
2075054_Revision3Corporation.txt,1745,41,42,755,252,131,56,1194
207511_ListOfCitiesInSweden.txt,702,9,78,214,21,113,9,357
2075191_Hauntedalbum.txt,524,9,58,294,48,23,17,382
207521_Generalissimus.txt,800,23,34,348,61,56,24,489
207522_DrudgeReport.txt,1275,22,57,538,162,79,38,817
2075800_ListOfSchoolDistrictsInIowa.txt,1779,102,17,1690,4,53,5,1752
2075839_ArandoraStar.txt,587,13,45,227,83,29,14,353
2077988_RebirthjenniferLopezAlbum.txt,735,13,56,445,65,44,26,580
2078944_DeaconStanJesusMan.txt,673,8,84,244,120,28,25,417
2078984_WatfordGapServices.txt,580,13,44,224,78,34,14,350
2079363_PathumWan.txt,916,20,45,438,117,61,24,640
208072_GrammyAwardForBestCountrySong.txt,804,8,100,447,55,11,7,520
208073_Dundalk.txt,952,18,52,417,104,67,22,610
208074_Scummvm.txt,1065,25,42,464,151,56,44,715
20807_Merlin.txt,3429,30,114,1382,416,225,90,2113
208101_MotionOfNoConfidence.txt,1253,24,52,452,150,73,61,736
2081137_DestructionDerby.txt,1367,27,50,504,174,80,54,812
20812_Meteor.txt,741,17,43,277,98,75,23,473
20813_MichaelMilken.txt,1580,34,46,581,211,106,43,941
208142_HabaneroChile.txt,634,19,33,246,85,52,30,413
20814_Mentat.txt,1260,27,46,465,181,83,46,775
208159_7number.txt,4103,31,132,1687,348,262,74,2371
208160_BrandonLee.txt,2817,48,58,1037,443,154,106,1740
208161_4number.txt,2196,54,40,833,240,192,57,1322
20821_MillerureyExperiment.txt,1502,22,68,482,232,150,70,934
2083508_HeliAttack2.txt,1033,13,79,375,121,69,44,609
2083524_NationOfShopkeepers.txt,584,10,58,202,88,37,26,353
2083736_GemmaWard.txt,588,11,53,237,93,39,22,391
2083868_Bada.txt,608,14,43,277,79,49,25,430
2083870_Sita.txt,2052,34,60,687,324,121,93,1225
2084518_XfactorInvestigations.txt,1351,19,71,468,238,93,43,842
2084531_Baculovirus.txt,986,21,46,373,159,96,33,661
208556_PrivateMembersBill.txt,941,16,58,349,142,69,36,596
2085700_HermiteInterpolation.txt,368,11,33,98,52,16,9,175
208579_AgeOfPericles.txt,2949,50,58,921,450,233,100,1704
208580_PriscillaPresley.txt,1509,23,65,557,214,74,53,898
208586_MarieCorelli.txt,720,12,60,265,68,56,20,409
208605_Zaibatsu.txt,883,14,63,355,86,75,30,546
208612_Rattan.txt,598,10,59,201,92,60,37,390
2086678_HessCorporation.txt,791,8,98,325,97,41,22,485
2086690_TsakonianLanguage.txt,963,24,40,342,130,94,46,612
20869_MonoamineOxidaseInhibitor.txt,1210,24,50,425,191,121,69,806
2087080_SamuelVWilson.txt,1170,17,68,455,146,75,41,717
2087264_Wthr.txt,1427,28,50,664,135,78,51,928
2087269_HistoryOfLasVegas.txt,2567,34,75,1033,324,141,56,1554
2087912_AnnandaleHighSchool.txt,1260,31,40,525,148,95,30,798
2088866_WorldFoodDay.txt,2388,19,125,923,319,232,61,1535
2088905_NoMoreDrama.txt,752,13,57,320,91,46,34,491
2089043_PsychicForce.txt,1057,17,62,553,112,58,20,743
2089047_U3.txt,1485,22,67,576,244,96,63,979
2089048_JeremyKeith.txt,1500,39,38,546,260,85,42,933
2089053_FreePresbyterianChurchOfUlster.txt,1174,16,73,494,126,74,32,726
2089058_Statuesalbum.txt,717,13,55,250,110,67,27,454
2089850_SsVolunteerGrenadierBrigadeLandstormNederland.txt,1108,26,42,412,138,80,33,663
2090028_TheConstitutionIsNotASuicidePact.txt,847,12,70,315,112,64,25,516
2090039_GeologyOfMercury.txt,1669,35,47,598,198,129,67,992
2091242_McintyreFinalEightSystem.txt,708,25,28,229,94,67,27,417
209189_TheTourists.txt,684,23,29,254,77,53,23,407
209191_IsabelMartnezDePern.txt,974,16,60,341,132,66,39,578
2092229_Moonbase3.txt,2268,21,108,845,320,120,68,1353
209227_WesMontgomery.txt,1066,19,56,452,123,64,30,669
209233_FlagstaffWar.txt,3474,53,65,1101,561,225,156,2043
2092414_InternationalAgencyForThePreventionOfBlindness.txt,1150,16,71,413,151,77,23,664
2092552_PrettyBoyFloydband.txt,1302,30,43,603,153,75,32,863
2093196_ListOfAmericanTelevisionSeriesBySetting.txt,928,38,24,713,11,17,4,745
2093425_JohnnyDangerously.txt,1104,22,50,449,182,41,34,706
2093431_TransferOfTheSovereigntyOfHongKong.txt,3570,43,83,1408,413,218,114,2153
2094394_MalePregnancy.txt,1095,18,60,375,159,121,28,683
2094404_NikonFg.txt,1469,17,86,599,178,139,54,970
2095370_EnemyTerritoryQuakeWars.txt,2193,35,62,928,283,167,71,1449
2095606_JeanRouverol.txt,662,11,60,252,74,30,16,372
2095762_ChanningTatum.txt,813,14,58,310,130,39,24,503
2095956_PhantomswordOfTruth.txt,1566,15,104,528,250,69,56,903
209643_StarOfDavid.txt,1663,35,47,619,186,106,43,954
209647_SibleymonroeChecklist2.txt,1728,14,123,1396,136,163,1,1696
2096603_IpPascal.txt,3184,96,33,1278,448,264,108,2098
2096610_ListOfAlbanianCompanies.txt,800,19,42,532,42,39,7,620
2096615_TheEmpireOfGreatKesh.txt,760,7,108,363,35,40,12,450
209669_Goldfingerband.txt,555,12,46,228,80,40,18,366
2096919_ConstantinBodinpeterIii.txt,777,17,45,324,95,29,16,464
2096979_MichaelShishmanOfBulgaria.txt,1041,16,65,461,125,52,24,662
209699_ThaoMa.txt,616,5,123,202,93,39,29,363
2097760_Stylometry.txt,1000,16,62,379,126,77,32,614
2097770_MugenMotorsports.txt,1706,21,81,658,217,114,40,1029
2098151_Fountainduchamp.txt,961,17,56,344,147,56,34,581
2099307_Protoelamite.txt,919,20,45,386,100,101,34,621
2099938_Mavelikkara.txt,1071,26,41,510,121,80,19,730
2100133_TheWackyMolestationAdventure.txt,1074,10,107,391,170,35,42,638
2100904_TheOutsiderswcw.txt,736,17,43,299,104,28,27,458
2101975_TheAwakeningdoctorWho.txt,1797,19,94,607,303,73,55,1038
2102005_NoMansLandcomics.txt,1749,23,76,606,261,110,75,1052
2102370_WhitneyYoungHighSchool.txt,1181,16,73,494,150,75,22,741
2102376_WBRayHighSchool.txt,678,11,61,348,66,36,10,460
210254_Dynasty.txt,2308,66,34,1087,127,136,68,1418
210279_MakatiCity.txt,2919,94,31,1429,230,165,51,1875
210280_ExposureValue.txt,1873,79,23,754,214,160,66,1194
2102830_Lagonda.txt,927,15,61,330,115,58,17,520
210316_Gerryfilm.txt,665,10,66,219,105,39,26,389
210318_TeriHatcher.txt,937,18,52,359,128,44,36,567
210384_WilliamESimon.txt,1117,20,55,482,103,56,14,655
2103888_ArticleIAndArticleIiiTribunals.txt,922,11,83,347,123,64,28,562
2103914_ElectronTransfer.txt,622,11,56,268,81,55,23,427
210391_SocialistInternational.txt,1141,17,67,589,24,148,12,773
2104796_DavidFrostsportsAgent.txt,1326,16,82,526,201,59,44,830
2104803_Ibogaine.txt,2026,38,53,808,254,198,73,1333
2104972_CadesCove.txt,693,10,69,239,90,59,26,414
2105243_ListOfMembersOfTheCanadianHouseOfCommonsD.txt,3850,14,275,1937,10,507,2,2456
2105254_ListOfMembersOfTheCanadianHouseOfCommonsE.txt,989,1,989,512,0,118,0,630
2105259_ListOfMembersOfTheCanadianHouseOfCommonsF.txt,2667,14,190,1364,4,336,4,1708
2106319_ConstitutionalistMovementOfGilan.txt,1578,30,52,575,215,98,59,947
2106334_EmploymentInHongKong.txt,1668,26,64,656,211,129,25,1021
2107093_Enyimba.txt,1921,54,35,755,223,118,46,1142
2107174_DanShaughnessy.txt,557,19,29,280,51,9,11,351
210719_TheColbys.txt,1482,23,64,672,162,85,40,959
210721_BbGun.txt,1760,19,92,686,246,146,88,1166
210732_TakashiMiike.txt,1224,24,51,485,152,96,51,784
2107399_RepublicOfTheRioGrande.txt,1345,21,64,542,159,67,32,800
210744_UnitedStatesFleetForcesCommand.txt,763,17,44,360,65,31,21,477
2108588_ZinaDHYoung.txt,835,11,75,350,109,35,14,508
2108957_MarshallWittmann.txt,808,11,73,310,106,66,21,503
2109318_PollsmoorPrison.txt,960,15,64,344,140,66,40,590
2109330_BalticWay.txt,956,14,68,385,117,79,22,603
2109649_UniversitiesInNorthAmerica.txt,841,7,120,322,98,60,22,502
2109661_SecularGames.txt,715,10,71,236,102,44,20,402
2109666_RemoteKeylessSystem.txt,931,18,51,357,116,67,49,589
2110032_WalerianBorowczyk.txt,1021,16,63,478,81,67,18,644
2110105_MoniacComputer.txt,1087,16,67,435,164,54,17,670
2110507_FightersDestiny.txt,921,15,61,363,126,79,21,589
2111443_AlexanderRussellWebb.txt,1198,18,66,534,133,51,20,738
2111565_KhantyLanguage.txt,633,16,39,217,79,78,19,393
2111572_GeorgeCobuc.txt,619,9,68,233,82,54,16,385
2112473_UniversityOfManchesterStudentsUnion.txt,989,39,25,382,135,65,28,610
2112667_ChaosDwarfs.txt,2030,30,67,689,277,178,97,1241
211346_ListOfBritishBirdsNonpasserines.txt,2906,41,70,1714,128,134,39,2015
2113557_Modelart.txt,1381,21,65,441,217,110,92,860
2113973_NicoleVaidiov.txt,1527,35,43,537,180,118,29,864
2113976_TheHauntOfFear.txt,777,10,77,344,86,41,22,493
2113986_TwofistedTales.txt,864,11,78,337,114,61,28,540
2113994_WilliamSSadler.txt,893,14,63,373,89,58,19,539
211411_Heteroptera.txt,816,13,62,294,114,64,38,510
211453_StewartLee.txt,1675,28,59,647,202,99,47,995
211484_Populism.txt,2434,36,67,991,258,236,65,1550
211485_RadioisotopeThermoelectricGenerator.txt,3215,46,69,1034,488,311,158,1991
2115079_ShuttleInc.txt,720,11,65,362,63,48,11,484
2115080_SergeyStanishev.txt,580,7,82,217,63,28,11,319
2115466_GoldDiggercomicBook.txt,2079,11,189,743,261,166,93,1263
2115793_Wticam.txt,608,6,101,203,72,63,22,360
2115887_TheLeagueOfVillains.txt,1758,16,109,678,260,70,80,1088
2116891_AustralianServicesUnion.txt,740,13,56,331,77,55,19,482
2116972_Nkisi.txt,1212,13,93,371,188,104,54,717
2117715_RevaShayne.txt,930,16,58,415,115,68,24,622
211834_HolbornTubeStation.txt,775,24,32,298,111,38,21,468
211843_CultureOfIsrael.txt,1039,31,33,607,67,67,26,767
211845_MatthewSaadMuhammad.txt,932,18,51,369,109,41,29,548
211855_DaveArneson.txt,1389,25,55,523,213,95,41,872
211856_DogTaxWar.txt,756,13,58,227,123,55,40,445
211857_BananaSlug.txt,735,11,66,265,120,43,30,458
211899_Runcorn.txt,4590,66,69,1805,572,331,145,2853
211913_ChristianMetal.txt,1094,15,72,530,106,113,49,798
2119219_DifferentiableManifold.txt,3095,65,47,1026,416,362,90,1894
211923_LiverFunctionTests.txt,975,19,51,358,159,101,48,666
211931_Pcs.txt,2477,51,48,940,324,190,73,1527
211933_LuciferdcComics.txt,1194,20,59,449,149,84,56,738
2120147_DallasIndependentSchoolDistrict.txt,797,22,36,389,92,46,10,537
2120312_ListOfPeopleFromNewOrleans.txt,892,16,55,685,10,74,2,771
2120343_FaradayParadox.txt,1238,15,82,424,151,103,28,706
2121239_JosephJSisco.txt,697,18,38,272,85,45,14,416
2121383_Sb129.txt,1513,20,75,530,250,66,56,902
2121684_ToyotaTercel.txt,2225,38,58,736,294,286,72,1388
2122775_BellaDonnaalbum.txt,576,10,57,315,48,27,7,397
2123148_CivicVirtue.txt,2770,33,83,971,383,240,96,1690
2123473_AprilWinchell.txt,761,15,50,317,88,45,17,467
2123601_BushBand.txt,1030,11,93,775,40,40,13,868
2123606_ItsUnderstood.txt,533,12,44,305,39,23,14,381
2124549_DoctorNefariousTropy.txt,666,14,47,261,91,44,26,422
2124555_ReversibleInhibitionOfSpermUnderGuidance.txt,984,16,61,352,136,73,37,598
2124647_ForeverLivingProducts.txt,711,17,41,301,98,40,22,461
212500_KerryKing.txt,756,11,68,309,108,45,29,491
2125389_AcademyOfTheHolyNamesnewYork.txt,577,13,44,267,54,32,20,373
2125732_GiggleswickSchool.txt,782,30,26,288,103,62,17,470
2126052_LorenaOchoa.txt,612,12,51,246,68,37,9,360
2127138_PortugueseAirForceAcademy.txt,646,18,35,241,92,39,20,392
2127805_DeronWilliams.txt,683,8,85,277,73,26,9,385
2128898_Hirnantian.txt,1797,27,66,675,217,158,69,1119
2129355_TheChineseFeast.txt,638,11,58,194,99,54,36,383
2129356_EleanorLansingDulles.txt,644,9,71,266,74,35,13,388
212966_Seekers.txt,636,12,53,215,82,68,34,399
213003_PackingProblem.txt,950,53,17,387,105,79,42,613
213018_EvangelicalChurchInGermany.txt,1123,23,48,572,78,78,26,754
213019_ListOfCaptainsRegentOfSanMarino.txt,973,4,243,674,15,6,3,698
2130431_LarryHoover.txt,645,9,71,274,78,26,20,398
2130880_StrikingDistance.txt,732,12,61,269,113,32,34,448
2131904_NickBockwinkel.txt,916,18,50,442,74,45,13,574
2132225_KamayurPeople.txt,612,15,40,213,106,43,17,379
2133388_MauroBolognini.txt,633,10,63,344,31,30,6,411
2134149_Crenshinibon.txt,1338,14,95,443,200,96,57,796
2135232_Dynastysports.txt,1695,23,73,634,53,73,14,774
213600_FfestiniogRailway.txt,5376,67,80,2091,728,347,120,3286
213636_BathIronWorks.txt,632,12,52,264,73,42,9,388
213639_ArnoldSommerfeld.txt,2428,46,52,1114,214,172,41,1541
2138077_SamHinton.txt,639,8,79,268,76,32,15,391
2138092_MikeWallacenascar.txt,1451,15,96,551,187,87,35,860
2138097_DallasSportatorium.txt,680,12,56,248,87,52,32,419
2138101_MikeStern.txt,564,12,47,274,54,25,7,360
2139138_KiteBuggy.txt,1678,45,37,532,262,166,106,1066
214042_CharlesVilliersStanford.txt,930,13,71,413,79,59,17,568
214051_JohannAdolphHasse.txt,718,9,79,221,99,42,31,393
214052_PyotrStolypin.txt,890,14,63,311,147,51,31,540
214059_Aphelocoma.txt,664,13,51,268,83,70,25,446
214079_JamesFitzjames1stDukeOfBerwick.txt,552,8,69,203,60,28,13,304
214083_JosephFesch.txt,1076,9,119,369,131,67,22,589
214091_Antiwar.txt,1248,24,52,468,160,103,35,766
2141084_BilalIbnRibah.txt,1950,49,39,605,340,111,81,1137
2141109_LynnWhitfield.txt,1058,6,176,501,74,76,22,673
214114_JohnFrancisHylan.txt,738,15,49,270,93,55,21,439
2142466_JulieDaubigny.txt,748,12,62,219,121,48,17,405
2143338_EmpireBurlesque.txt,3813,61,62,1420,538,266,167,2391
2143540_BrawlInTheFamily.txt,955,11,86,305,174,34,37,550
2144250_LandmarksOfHobokenNewJersey.txt,3225,48,67,1216,438,224,87,1965
2144400_TitanicAlternativeTheories.txt,3188,46,69,1002,532,198,125,1857
2144426_GlennBeckProgram.txt,1115,22,50,492,117,74,43,726
2145324_UniformAndInsigniaOfTheBoyScoutsOfAmerica.txt,2281,34,67,976,295,154,64,1489
2145325_AshleyParkerAngel.txt,836,23,36,317,99,61,23,500
2145767_LgbtMovementsInTheUnitedStates.txt,8378,138,60,3185,1033,792,299,5309
21460_November1.txt,2660,6,443,1413,116,142,15,1686
21461_November2.txt,1580,3,526,838,74,63,12,987
2146220_SteenrodAlgebra.txt,1152,40,28,424,142,83,29,678
21462_NormalDistribution.txt,4156,144,28,1359,545,498,189,2591
21465_NiklasLuhmann.txt,1598,19,84,605,199,143,77,1024
21466_NatachaAtlas.txt,1031,17,60,399,130,72,52,653
2146808_ZaynabBintAli.txt,582,15,38,254,84,31,19,388
2146841_BlinxTheTimeSweeper.txt,1013,19,53,373,163,43,22,601
214729_HarmonicNumber.txt,581,49,11,219,66,63,21,369
214730_HenryHallam.txt,2015,12,167,611,245,192,67,1115
214731_Sheol.txt,1787,31,57,643,238,102,70,1053
2147578_38thUnitedStatesCongress.txt,2627,45,58,1534,142,91,20,1787
2147579_MithosYggdrasill.txt,2616,30,87,817,409,179,115,1520
2147637_MyFutureSelfNMe.txt,864,10,86,268,149,50,41,508
2147889_RaritiesAndBsides.txt,1038,6,173,509,60,71,43,683
2147892_Rodyle.txt,672,7,96,196,125,29,28,378
2147935_GreekResistance.txt,1416,24,59,604,159,96,41,900
21481_NotaryPublic.txt,5351,91,58,1752,726,507,192,3177
21482_Nairobi.txt,4169,98,42,1658,567,334,109,2668
2148467_NuneatonBoroughAfc.txt,1293,12,107,471,185,67,29,752
21485_Neutrino.txt,5020,76,66,1815,693,480,208,3196
2148742_GundamEvolve.txt,2244,35,64,865,296,131,77,1369
2148755_EymundsSaga.txt,1018,19,53,360,165,43,40,608
21490_Nylon.txt,1813,23,78,637,280,156,74,1147
2149822_GreekMilitaryJuntaOf19671974.txt,5874,70,83,1985,866,439,202,3492
2150120_TheTroubleWithTrillions.txt,1288,29,44,484,209,57,57,807
2150142_FishBall.txt,769,13,59,274,110,83,39,506
21504_NicoleKidman.txt,2439,38,64,1125,239,124,37,1525
2150576_IgnazAureliusFessler.txt,618,6,103,198,74,44,24,340
21506_NumericalAnalysis.txt,2437,63,38,831,324,296,124,1575
21508_Noosphere.txt,588,10,58,267,59,38,26,390
21511_NiccolPaganini.txt,2290,25,91,912,194,175,68,1349
2151240_DonskoyMonastery.txt,1074,18,59,383,148,62,18,611
2151247_MormonReformation.txt,1154,14,82,398,155,82,45,680
2151263_MyhimeSoundtracks.txt,756,20,37,546,15,33,4,598
215148_JohnMuir.txt,2252,30,75,877,300,129,67,1373
21514_Nanomedicine.txt,945,15,63,365,132,85,26,608
215153_Pastor.txt,849,16,53,312,113,51,21,497
215155_LynneCheney.txt,677,17,39,319,53,34,10,416
21516_NuclearMagneticResonance.txt,3770,77,48,1335,481,459,114,2389
215176_Infrasound.txt,1066,17,62,392,168,78,40,678
2152052_AbuLahabIbnabdulMuttalib.txt,1127,20,56,357,194,43,45,639
2152057_Klsx.txt,873,11,79,362,126,44,21,553
2152078_HubbellTradingPostNationalHistoricSite.txt,1341,18,74,526,191,79,40,836
2153155_ArchbishopOfCaesarea.txt,604,13,46,236,67,34,15,352
2154483_RandyCastillo.txt,1783,24,74,655,263,103,61,1082
2154490_Neet.txt,693,10,69,226,106,52,26,410
2155575_ErichGoode.txt,606,13,46,204,66,57,21,348
2155579_EloualiMustaphaSayed.txt,772,11,70,281,104,41,28,454
2155586_ShiraiRyu.txt,823,11,74,296,123,53,27,499
2155590_RedDragonmortalKombat.txt,633,9,70,241,111,26,19,397
2155595_BlackDragonmortalKombat.txt,998,16,62,344,164,56,39,603
2156434_Toheart2.txt,1004,38,26,441,119,52,31,643
21565_November5.txt,2208,8,276,1222,93,88,7,1410
21566_NoamChomsky.txt,6134,76,80,2371,706,476,227,3780
21573_NielsHenrikAbel.txt,626,13,48,193,99,55,25,372
2157486_HultsfredFestival.txt,608,6,101,203,103,30,19,355
21574_November19.txt,2421,6,403,1339,95,85,9,1528
215751_HenryHazlitt.txt,545,14,38,233,52,30,6,321
21575_November20.txt,2496,6,416,1377,100,86,8,1571
215761_Incesticide.txt,599,20,29,339,34,34,15,422
21576_November21.txt,2254,6,375,1189,147,82,28,1446
2157818_GraniteRailway.txt,907,15,60,373,105,53,15,546
2158246_JulesAndJim.txt,906,22,41,344,112,57,32,545
215829_Ashantisinger.txt,2051,48,42,906,251,116,50,1323
2158581_33rdUnitedStatesCongress.txt,2769,25,110,1729,144,39,15,1927
2158886_SingleEventUpset.txt,871,17,51,393,83,80,23,579
2159654_DeathsInJune2005.txt,1336,32,41,816,39,92,6,953
2160676_CoastalGeography.txt,1327,20,66,442,184,113,71,810
2160801_MerryChristmasCharlieManson.txt,739,9,82,296,107,33,31,467
2160830_MaryManinMorrissey.txt,6216,108,57,2449,898,292,197,3836
2161569_WouterBasson.txt,1250,25,50,470,187,94,30,781
216216_ConservationBiology.txt,1197,24,49,516,134,124,30,804
2162186_JamesAitkenWhyte.txt,839,14,59,300,107,39,20,466
216226_Vegetation.txt,3190,26,122,1176,315,376,206,2073
216239_ListOfRiversOfRussia.txt,1352,19,71,895,34,51,2,982
216248_IsraeljordanTreatyOfPeace.txt,2753,60,45,1130,305,160,60,1655
216278_Xscapeband.txt,1096,19,57,541,112,44,37,734
2163239_UnitedNationsStabilizationMissionInHaiti.txt,1335,32,41,605,145,71,23,844
2163246_MuslimIbnAqeel.txt,1018,13,78,399,166,37,30,632
2163254_AirforceDelta.txt,1950,109,17,727,308,118,51,1204
2163260_Swingtime.txt,616,12,51,339,29,12,6,386
2163628_BattleOfLagos.txt,607,11,55,229,83,25,7,344
2163682_CbsColumbiaSquare.txt,1117,21,53,517,140,62,25,744
2163689_TheBackyardigans.txt,2513,65,38,919,308,177,114,1518
2164128_OsvaldTeshik.txt,630,8,78,279,77,43,27,426
2165207_LimestoneCollege.txt,623,11,56,281,58,47,10,396
2165527_FireOnTheMountainnovel.txt,2932,46,63,822,535,116,150,1623
2165536_JonathanTroy.txt,1549,17,91,517,216,95,72,900
2165542_BarryWeisleder.txt,1061,15,70,405,133,71,23,632
2165551_WorcestermetrowestbostonAirport.txt,621,13,47,245,85,31,22,383
2166602_BordeauxWine.txt,1154,24,48,424,173,110,39,746
2166628_TypesOfGraffiti.txt,2119,30,70,757,267,193,112,1329
2166631_MatsudairaSadanobu.txt,1007,15,67,377,131,60,32,600
2167001_OnewingedAngel.txt,595,12,49,260,79,50,13,402
2167480_TheEssentialsOfKemalism.txt,708,14,50,237,96,63,29,425
216843_FrenchConsulate.txt,2201,33,66,753,266,177,60,1256
2168551_GrainBeltbeer.txt,1299,12,108,566,168,80,40,854
2168560_Wabitv.txt,713,15,47,324,77,44,12,457
216908_KarolinskaInstitutet.txt,536,11,48,285,28,29,4,346
216915_BritishHalfpennyCoin.txt,4549,49,92,1594,597,269,156,2616
2169442_Primitivism.txt,864,17,50,304,107,105,34,550
2169901_IanEdginton.txt,1007,42,23,494,57,55,16,622
2170962_Saussurea.txt,677,7,96,490,46,43,12,591
2170969_SupernaturaltvSeries.txt,1452,30,48,582,179,87,43,891
2170997_Tortona.txt,614,9,68,249,66,36,10,361
2171348_FranciscoPalencia.txt,645,11,58,250,73,30,15,368
2171798_KalayaanPalawan.txt,1540,35,44,582,199,99,55,935
2171817_MirandaJuly.txt,988,19,52,529,82,38,19,668
2172047_BayNews9.txt,2194,61,35,1071,161,172,42,1446
2172762_CthulhuMythosCelestialBodies.txt,1777,52,34,664,237,130,54,1085
2172768_PhilipArnold.txt,642,12,53,212,90,37,19,358
2172854_HassanRoshdiyyeh.txt,563,9,62,201,76,38,14,329
2172884_TheMeadows.txt,683,14,48,266,80,57,19,422
2172885_VampireworldOfDarkness.txt,725,14,51,206,111,73,40,430
217291_Dodgeball.txt,2133,26,82,707,300,149,121,1277
217305_Triumvirate.txt,1200,17,70,505,95,84,31,715
217313_StochasticMatrix.txt,912,39,23,308,89,83,22,502
217315_Cray.txt,2369,33,71,965,283,164,80,1492
217318_OttomanInterregnum.txt,1139,8,142,384,164,70,37,655
217320_CarlSchurz.txt,2409,25,96,889,254,152,86,1381
2173220_TheSubjectionOfWomen.txt,1772,30,59,500,299,154,92,1045
217341_ClutchingAtStraws.txt,1017,34,29,365,130,65,46,606
217345_Restrepia.txt,578,12,48,329,44,48,10,431
217346_MarkFuhrman.txt,881,16,55,344,124,38,26,532
217350_LeachOrchid.txt,4675,12,389,3207,164,107,16,3494
217352_AlfredBrehm.txt,771,9,85,323,75,32,12,442
217358_PedroCaldernDeLaBarca.txt,1442,16,90,646,158,118,24,946
2173596_RuthwellCross.txt,585,8,73,191,99,37,13,340
217362_DraculaOrchid.txt,1031,14,73,677,70,46,21,814
217364_Bravealbum.txt,532,12,44,207,73,27,20,327
217365_MontgomeryBurns.txt,3256,47,69,1353,447,162,84,2046
217366_LiberalPeoplesPartysweden.txt,1804,45,40,694,224,174,72,1164
217368_LeftPartysweden.txt,3014,71,42,1131,380,213,68,1792
2173797_StarfishPrime.txt,1341,15,89,446,188,140,31,805
2173945_Sahiwal.txt,2078,30,69,836,251,185,55,1327
2174274_VintnersQualityAlliance.txt,888,22,40,402,95,72,28,597
2175134_MahakaleshwarJyotirlinga.txt,722,8,90,247,112,35,14,408
2175370_MegaManX5.txt,2635,25,105,974,387,160,96,1617
2175376_MegaManX6.txt,2779,41,67,1002,420,177,127,1726
2175381_MegaManX7.txt,982,19,51,359,148,63,38,608
2175382_MegaManX8.txt,2646,31,85,927,404,208,123,1662
2176179_N9Road.txt,764,14,54,329,80,39,16,464
2176203_Annalists.txt,1212,9,134,440,149,85,28,702
2176214_Tubingrecreation.txt,1127,29,38,358,181,90,65,694
2177275_DomesticatedHedgehog.txt,1845,28,65,586,340,208,97,1231
2177300_Viloxazine.txt,571,11,51,259,60,49,21,389
2178636_JordanChan.txt,622,11,56,300,49,17,3,369
2179719_FortressEurope.txt,845,15,56,313,122,70,26,531
2179740_HistoryOfReligionInTheNetherlands.txt,1728,20,86,610,222,144,44,1020
218002_Composting.txt,2362,42,56,818,370,234,116,1538
218003_ElegantVariation.txt,642,9,71,209,85,56,29,379
2180063_P75Eagle.txt,583,6,97,239,71,47,14,371
218045_Ophrys.txt,4872,26,187,3374,234,227,58,3893
2180530_TheThrivingCultOfGreedAndPower.txt,647,14,46,300,73,33,9,415
2180531_Tweenerbasketball.txt,683,15,45,254,105,59,42,460
2180554_MysticCavernsAndCrystalDome.txt,1101,15,73,364,178,73,29,644
218068_Dactylorhiza.txt,2589,11,235,1868,131,65,15,2079
2181953_BlackPStones.txt,876,11,79,344,122,62,30,558
2182355_MagicTheGatheringDeckTypes.txt,1481,26,56,664,158,122,61,1005
2183017_TheAccidentalSpy.txt,1217,12,101,397,194,71,46,708
2183033_CriminalLawAmendmentAct1885.txt,2066,23,89,666,312,116,64,1158
2183052_OlderVersionsOfCartoonCharacters.txt,976,7,139,410,101,65,41,617
2183382_JeopardyvideoGame.txt,635,20,31,242,84,34,22,382
2183441_LudwikIdzikowski.txt,602,7,86,213,86,43,17,359
218382_TiMsp430.txt,648,16,40,269,78,71,19,437
2183884_PushAccessProtocol.txt,708,15,47,290,104,29,16,439
218404_RestorativeJustice.txt,2528,30,84,1047,301,196,77,1621
218407_SexualAssault.txt,1831,26,70,661,271,183,75,1190
218436_GeorgeGoringLordGoring.txt,912,13,70,296,136,36,22,490
218456_DrugParaphernalia.txt,581,11,52,233,85,55,24,397
2185875_DavidEdelstadt.txt,579,16,36,224,79,34,8,345
2187369_JohnsonsIsland.txt,573,10,57,229,80,36,14,359
2187416_NorthSydneyGirlsHighSchool.txt,1011,20,50,540,76,55,14,685
2187733_1991PacificHurricaneSeason.txt,4471,83,53,1572,618,399,153,2742
2187780_1988PacificHurricaneSeason.txt,884,31,28,332,136,77,24,569
2188240_LeadershipAndManagementOfTheChildrenOfGod.txt,799,9,88,447,42,54,20,563
2189133_ViaFerrata.txt,2340,33,70,801,334,172,76,1383
2189297_NavalElectronicsLaboratory.txt,791,21,37,351,73,56,13,493
2189304_Fusoya.txt,662,8,82,245,97,27,31,400
2189319_JugglingConvention.txt,840,15,56,319,93,76,33,521
2189636_AssetProtection.txt,2976,45,66,981,433,234,111,1759
2189642_SeasonalEnergyEfficiencyRatio.txt,937,35,26,339,104,85,31,559
2190220_TheBunker.txt,3894,52,74,1235,613,323,194,2365
21907_NoahideLaws.txt,3613,48,75,1368,453,233,130,2184
2191055_IiSsPanzerCorps.txt,1033,20,51,402,130,65,13,610
2192445_CoochBeharDistrict.txt,2658,39,68,1080,282,186,61,1609
2192451_MajorWaldemarFydrych.txt,622,12,51,227,82,32,17,358
2192615_TheDiscoveryOfAWorldInsideTheMoone.txt,720,15,48,311,88,38,19,456
2193478_MikeTeavee.txt,2252,27,83,667,350,143,140,1300
2193539_Wmucfm.txt,1572,25,62,682,189,98,40,1009
2193706_DeuxmontagnesLineamt.txt,905,21,43,341,96,79,22,538
219498_SadismAndMasochismInFiction.txt,1154,33,34,546,106,63,24,739
219503_Topos.txt,1785,53,33,726,209,160,53,1148
2195079_GreekCruiserGeorgiosAverof.txt,1202,10,120,441,146,74,32,693
219545_Rapeseed.txt,1231,17,72,486,191,91,50,818
2195460_StevenBanks.txt,760,17,44,322,102,46,21,491
21957_NuclearPore.txt,903,19,47,320,120,99,30,569
21958_Nucleolus.txt,757,15,50,309,86,62,29,486
2195909_ActorModelAndProcessCalculi.txt,3308,40,82,1360,480,166,91,2097
2198072_FranciscoBustamante.txt,663,12,55,283,63,30,22,398
2198346_LangdonBrownGilkey.txt,1085,14,77,495,81,70,17,663
2198798_SelflessbuffyEpisode.txt,1854,35,52,649,274,75,70,1068
2199814_ChepstowBridge.txt,1114,15,74,386,165,90,49,690
2199877_TheItalianEconomyUnderFascism19221943.txt,1729,18,96,515,247,206,76,1044
2200266_MonicaVitti.txt,588,7,84,309,49,33,13,404
2200312_StingAndLexLuger.txt,734,13,56,284,107,15,33,439
220160_ThierryHenry.txt,2556,38,67,963,307,168,61,1499
220187_YokoShimomura.txt,724,11,65,356,60,34,19,469
220230_BernardinoOfSiena.txt,1486,18,82,481,223,72,46,822
2203140_MisinSanMiguelArcngelDeLaFrontera.txt,690,16,43,286,93,38,15,432
2203335_ZeroPagecpm.txt,444,8,55,212,24,27,4,267
2203796_TizianoFerro.txt,666,14,47,270,84,47,13,414
2204212_GeorgeLayton.txt,681,33,20,363,45,35,17,460
2204219_TimelineOfThe2005LondonBombings.txt,1106,16,69,468,140,42,22,672
2204630_LemonOfTroy.txt,793,12,66,308,90,50,22,470
2204872_BentonFraser.txt,573,7,81,199,89,29,24,341
2204_ArabicAlphabet.txt,4612,83,55,1568,636,401,206,2811
2205557_Scania.txt,3909,57,68,1424,438,402,108,2372
220559_HenryMackenzie.txt,676,10,67,238,89,39,13,379
2205616_OhioNavalMilitia.txt,823,18,45,396,92,36,12,536
2206044_PolyandryInTibet.txt,1696,21,80,484,253,198,95,1030
2206059_ShortMusicForShortPeople.txt,922,5,184,442,25,17,15,499
2206063_LiquidNitrogenEconomy.txt,940,20,47,417,127,78,24,646
220632_JustintimeCompilation.txt,948,20,47,328,147,88,44,607
220633_PointOfSale.txt,1036,19,54,430,125,88,34,677
220635_SadaharuOh.txt,1958,27,72,626,225,100,52,1003
220636_UniversalSuffrage.txt,847,21,40,291,119,82,39,531
220637_GiovanniBattistaCipriani.txt,730,8,91,232,99,46,35,412
220642_GeometrizationConjecture.txt,2878,32,89,1052,331,295,105,1783
2206448_WestIndianNationalCricketCaptains.txt,774,26,29,294,108,54,9,465
2206450_NatanSlifkin.txt,1008,15,67,402,110,79,31,622
220657_LeadbeatersPossum.txt,821,13,63,267,101,76,43,487
2206775_DeathJr.txt,877,12,73,259,151,55,43,508
220684_ListOfInternetTopics.txt,1076,28,38,899,30,19,10,958
2207150_EmmettBrown.txt,2937,32,91,958,484,125,114,1681
2207542_PatrologiaGraeca.txt,1518,5,303,1089,21,21,6,1137
2208_ArcticFox.txt,836,15,55,310,103,91,34,538
2210111_ConventionToProposeAmendmentsToTheUnitedStatesConstitution.txt,841,14,60,246,126,68,36,476
2210131_HistoryOfTheJewsInPoland9661572.txt,4031,26,155,1260,571,310,134,2275
2210406_TorontoFireServices.txt,690,23,30,410,52,24,10,496
2210_FolkloreOfTheUnitedStates.txt,1064,19,56,484,130,70,39,723
2211448_TeachingsOfOpusDei.txt,2464,42,58,890,332,187,78,1487
2212223_CheekyAngel.txt,634,45,14,353,52,41,10,456
221249_OlduvaiTheory.txt,602,13,46,228,66,45,16,355
221256_WilliamBlackstone.txt,886,19,46,326,101,67,34,528
2212576_FireServicesDepartmenthongKong.txt,2572,39,65,1234,274,181,44,1733
221259_KurtRussell.txt,1071,15,71,499,83,45,24,651
221315_NorthAmericanX15.txt,1487,31,47,591,170,96,30,887
221319_FundamentalAttributionError.txt,960,21,45,365,112,97,38,612
2213228_AugustFriedrichGfrrer.txt,806,6,134,273,87,71,21,452
221324_CrownPrinceParty.txt,1031,7,147,448,80,85,21,634
2214480_SpringfieldModel1855Rifle.txt,684,10,68,225,93,41,22,381
2214780_SuppressivePerson.txt,1902,28,67,558,317,155,108,1138
2214785_Ghosthunters.txt,1101,7,157,508,120,52,23,703
2215874_ZacEfron.txt,937,16,58,441,98,41,20,600
2215878_ChingCheong.txt,674,15,44,286,97,31,12,426
2216235_TheBibleAndHomosexuality.txt,6797,81,83,2245,964,516,315,4040
2216709_MistakecriminalLaw.txt,791,6,131,209,140,48,39,436
2216720_ListOfCanadianSpecialtyChannels.txt,634,42,15,512,14,31,5,562
221698_TimminsOntario.txt,1634,39,41,902,116,118,28,1164
221714_BattleRoyale.txt,1076,22,48,441,134,50,25,650
221724_FundamentalJustice.txt,1035,12,86,358,138,87,43,626
221725_DonCherryiceHockey.txt,2134,35,60,843,284,132,61,1320
221746_Debrecen.txt,1208,26,46,469,143,100,38,750
221749_RalCastro.txt,1109,21,52,433,127,88,32,680
221761_NorthAmericanAviation.txt,820,17,48,361,85,42,23,511
2217639_ListOfFilmsSetInJapan.txt,643,30,21,360,87,17,6,470
221773_HumanMigration.txt,4219,79,53,1636,476,396,114,2622
2217827_NorthLuzonExpressway.txt,1634,50,32,793,173,95,33,1094
2217_ArmenianLanguage.txt,1420,33,43,539,143,170,57,909
2219133_AdolfZiegler.txt,1311,15,87,480,168,86,44,778
2219565_PulseAsia.txt,759,8,94,348,54,69,16,487
2220214_RenSohma.txt,783,12,65,230,146,45,45,466
2220218_Ktv.txt,1831,30,61,681,242,142,71,1136
2220219_KazumaSohma.txt,1094,13,84,317,205,49,66,637
2220239_Amyraldism.txt,1480,15,98,494,177,114,67,852
2222054_ForsythCountyDefenseLeague.txt,785,19,41,342,118,41,27,528
2222132_BattleOfFelucia.txt,996,18,55,340,187,50,36,613
2222146_ACGreen.txt,763,11,69,275,92,49,12,428
2222482_HelmIdentificationGuides.txt,898,11,81,440,61,24,7,532
2223222_AaronBenElijah.txt,2387,21,113,833,251,202,71,1357
222346_KamalHaasan.txt,3265,37,88,1515,224,136,52,1927
222412_Numbat.txt,924,17,54,278,105,115,45,543
222414_Bagan.txt,842,16,52,394,82,49,23,548
222417_ARRahman.txt,1464,29,50,659,152,89,33,933
2224384_HondaFEngine.txt,982,32,30,486,73,44,11,614
2224400_DickDevos.txt,1429,31,46,616,155,106,30,907
2224613_MohammadSidiqueKhan.txt,1169,21,55,489,166,36,33,724
2225381_CloughHead.txt,782,12,65,301,85,50,28,464
2225745_JoinJava.txt,709,18,39,321,107,41,24,493
2225753_GadGuard.txt,2200,38,57,716,356,119,115,1306
2225767_MaeSexton.txt,1424,27,52,486,189,107,53,835
2226053_JlioCsarDeMelloESouza.txt,1772,29,61,663,204,110,53,1030
2226060_AlphonsemariemarcellinthomasBrenger.txt,646,9,71,182,77,56,14,329
2226081_Berezhany.txt,1420,11,129,531,155,83,57,826
2226088_CsarLuisMenotti.txt,1788,36,49,682,238,137,54,1111
2227622_BauchiState.txt,1000,21,47,408,99,66,32,605
222788_Ishmael.txt,2431,46,52,866,339,114,70,1389
222789_LataMangeshkar.txt,3243,81,40,1560,304,169,70,2103
2227968_EurekaSeven.txt,1981,35,56,892,266,103,39,1300
2227977_ShowtimebuffyEpisode.txt,1625,29,56,524,245,83,63,915
222828_UnitTesting.txt,1607,35,45,594,222,122,82,1020
222839_WelfareState.txt,2316,31,74,817,283,278,97,1475
2229060_ZombiePanic.txt,854,14,61,273,124,56,38,491
2229082_Kspnam.txt,732,11,66,325,92,31,19,467
2231499_CarolynGage.txt,961,10,96,563,27,50,4,644
2232977_PeggyLipton.txt,983,15,65,439,105,36,23,603
2233745_BloodIiTheChosen.txt,644,14,46,222,97,55,33,407
2234065_LostAtSeacareBears.txt,656,20,32,227,103,27,31,388
223441_Cnbc.txt,3767,68,55,1631,412,247,125,2415
2234805_ListOfSoftDrinksByCountry.txt,2543,58,43,1527,220,229,51,2027
2234963_NothingFails.txt,907,14,64,365,130,79,16,590
223497_IanAndersonmusician.txt,1729,28,61,643,221,129,51,1044
223504_Phylloxera.txt,881,11,80,312,123,83,49,567
2235281_Tefnakht.txt,643,7,91,233,77,45,28,383
2235674_TheSiegeds9.txt,625,9,69,239,94,21,17,371
2235677_KristenBjorn.txt,1093,23,47,446,139,78,50,713
2235678_Tabn.txt,644,24,26,297,50,71,8,426
2235913_CyrusAvery.txt,795,9,88,277,127,39,26,469
2236316_BoseHeadphones.txt,1822,51,35,842,183,153,49,1227
2236764_GauleyRiver.txt,1023,17,60,446,101,80,36,663
2237408_Feralsubculture.txt,1039,19,54,338,128,141,65,672
2237831_SilentProtagonist.txt,2052,18,114,742,272,146,122,1282
2237839_SustainableBusiness.txt,640,14,45,279,78,49,13,419
2237840_DecodedFeedback.txt,722,22,32,330,66,69,20,485
223889_TwelfthNightband.txt,1910,32,59,701,256,140,64,1161
223898_IndustrialEcology.txt,642,11,58,258,60,73,17,408
223913_JanetSuzman.txt,592,7,84,281,55,21,10,367
2239170_WeatherlightmagicTheGathering.txt,722,7,103,259,109,53,36,457
2239174_OpenAccesspublishing.txt,1572,29,54,628,187,161,57,1033
2239303_AkramPahalwan.txt,654,7,93,273,78,41,24,416
223938_NuxlkLanguage.txt,575,12,47,318,28,33,13,392
2240238_FoggyMountainBoys.txt,708,7,101,399,43,23,12,477
2241056_BibhutibhushanBandopadhyay.txt,573,12,47,221,76,35,25,357
2241768_PhilippeBuchez.txt,927,11,84,274,112,79,29,494
2242140_MaryJemison.txt,577,12,48,241,74,29,13,357
2242146_ZhuChenghu.txt,582,9,64,204,72,51,24,351
2242489_Agrafa.txt,898,19,47,347,103,66,32,548
2242501_SecretOfTheSilverBlades.txt,897,21,42,343,132,39,39,553
2243562_ListsOfAmericans.txt,560,12,46,381,0,14,1,396
2243727_RalphErskinearchitect.txt,899,14,64,358,97,55,19,529
2244632_CellGroup.txt,652,8,81,228,95,48,32,403
224524_PhineasFinn.txt,790,11,71,266,112,63,43,484
224598_SarahKane.txt,1226,16,76,438,158,108,49,753
2247953_ReynardMotorsport.txt,1057,19,55,417,147,75,43,682
2248081_UssGilliamapa57.txt,751,9,83,307,85,36,14,442
2248394_SgtPeppersLonelyHeartsClubBandsong.txt,886,16,55,375,91,53,25,544
2248762_CarelessWhisper.txt,757,16,47,279,87,58,20,444
2248986_TrashcomputerGame.txt,890,16,55,279,160,69,48,556
2249426_Wsavtv.txt,763,20,38,309,90,53,28,480
224973_JohnWanamaker.txt,1094,19,57,468,142,72,24,706
2249807_HoustonPoliceDepartment.txt,2848,57,49,1296,361,152,65,1874
2249819_HichamChami.txt,972,16,60,451,103,54,16,624
2249858_YoNoid.txt,611,11,55,237,74,39,13,363
2250186_HalfbloodPrincecharacter.txt,785,9,87,282,134,54,28,498
2251272_AGatheringOfTheTribes.txt,604,13,46,250,73,30,15,368
2251415_Galleryapazine.txt,1819,122,14,842,190,77,40,1149
2251714_LarryCohen.txt,1028,14,73,423,109,81,32,645
2251724_ListOfIslandsOfAlaska.txt,1184,3,394,980,3,33,0,1016
2252316_AthaanMiere.txt,642,10,64,204,84,46,35,369
2252318_ListOfBillionaires2004.txt,3677,7,525,1601,21,41,8,1671
2252749_AlLeong.txt,1345,23,58,542,217,83,29,871
2253135_AdequateSeven.txt,749,23,32,263,99,50,38,450
2253149_EmondsField.txt,590,12,49,197,87,33,23,340
2253647_Ashover.txt,716,11,65,267,94,42,30,433
2253827_ProfessionalFraternity.txt,543,5,108,329,13,19,3,364
22543_October8.txt,2057,6,342,1157,76,58,11,1302
22544_Ostrich.txt,2510,33,76,872,325,224,92,1513
22545_October18.txt,2068,8,258,1141,65,87,11,1304
22546_Orgasm.txt,5188,88,58,1627,776,593,261,3257
22549_October9.txt,2151,5,430,1178,88,67,9,1342
22554_October13.txt,1940,5,388,1102,61,63,9,1235
22555_October15.txt,2014,6,335,1090,99,84,2,1275
22556_October16.txt,2238,6,373,1252,88,94,7,1441
22557_AnglosaxonLiterature.txt,3994,80,49,1437,533,365,107,2442
22560_MagnavoxOdyssey.txt,1299,25,51,519,143,118,49,829
225617_ThirdLawOfThermodynamics.txt,593,15,39,210,68,57,24,359
225621_SriAurobindo.txt,10804,92,117,3676,1212,972,321,6181
225622_ListOfNonHumanApes.txt,783,12,65,426,76,38,14,554
225623_ListOfFictionalApes.txt,1341,11,121,755,49,67,13,884
22565_Obadiah.txt,622,12,51,207,89,30,10,336
2256638_TheWireds9.txt,829,12,69,267,169,49,39,524
22568_October19.txt,2054,5,410,1102,90,76,6,1274
22570_October21.txt,2107,8,263,1105,114,81,15,1315
2257147_Branhamism.txt,2872,43,66,944,411,145,143,1643
22571_October22.txt,2231,6,371,1185,117,82,9,1393
225721_Honeywell.txt,1186,22,53,567,139,65,19,790
22572_October23.txt,2236,5,447,1209,112,92,16,1429
2258603_SistersOfTheLight.txt,1933,23,84,600,338,90,57,1085
2258885_ShankarNag.txt,780,31,25,324,105,42,25,496
2258903_CyclingClub.txt,657,11,59,324,74,56,25,479
2258908_Disinfo.txt,631,10,63,263,79,46,26,414
2258933_MaalimFiltariq.txt,2788,48,58,914,379,244,114,1651
2259083_PhillipFulmer.txt,960,15,64,382,110,50,23,565
2259976_TombsOfTheNoblesamarna.txt,643,41,15,236,81,35,8,360
2260420_MilitaryAssistanceCommandVietnamStudiesAndObservationsGroup.txt,6509,64,101,2699,845,357,196,4097
2260425_502ndInfantryRegimentunitedStates.txt,1233,36,34,577,94,76,17,764
226043_TimObrienauthor.txt,660,7,94,235,77,41,26,379
226045_BodhGaya.txt,715,13,55,288,87,42,9,426
22605_OilPainting.txt,1614,13,124,531,266,161,79,1037
226070_DufferinRoblin.txt,972,18,54,354,127,68,27,576
226080_TheSongOfRoland.txt,2691,21,128,979,368,192,80,1619
2260833_TheFlyingDoctors.txt,565,12,47,238,76,33,18,365
226089_VelvaleeDickinson.txt,2211,28,78,756,382,101,57,1296
226090_Cutlass.txt,580,13,44,180,80,65,32,357
226096_ListOfAircraftByDateAndUsageCategory.txt,830,49,16,586,4,13,0,603
226101_BrianTobin.txt,906,13,69,329,112,80,20,541
226119_DeHavillandHornet.txt,570,16,35,293,36,33,8,370
22611_OrlandoLetelier.txt,1118,16,69,459,134,71,26,690
226121_SecretaryOfStateForWar.txt,763,6,127,355,21,11,4,391
22613_Organism.txt,4422,83,53,1520,559,466,166,2711
2261494_VonWafer.txt,608,10,60,233,74,41,12,360
22615_Ostracism.txt,2596,36,72,814,385,214,123,1536
22616_Omega.txt,668,11,60,263,74,53,24,414
22618_OperationBarbarossa.txt,8273,85,97,2988,1108,703,353,5152
2261934_Orgrimmar.txt,644,7,92,240,92,40,23,395
22625_OrganizedCrime.txt,987,18,54,407,157,106,38,708
2263254_ListOfMembersOfTheCanadianSenateW.txt,691,1,691,380,31,5,0,416
2263255_ReturnOfTheLivingDeadPartIi.txt,653,6,108,219,103,51,20,393
2263267_RudolphBDavila.txt,1239,17,72,514,172,64,19,769
2263269_RotorsonicTheHedgehog.txt,1319,24,54,492,177,104,54,827
22637_ObjectManagementGroup.txt,632,19,33,320,78,45,11,454
2264346_ElectronConfigurationsOfTheElementsdataPage.txt,601,14,42,248,28,18,3,297
2264514_TacticalAssaultGroupaustralia.txt,869,16,54,388,103,64,15,570
2264839_GetItDone.txt,2370,40,59,739,382,130,105,1356
22649_Observation.txt,905,30,30,297,130,70,40,537
2265169_ListOfTautonyms.txt,821,9,91,609,77,89,2,777
2265392_Proselyte.txt,1352,13,104,429,193,62,59,743
22655_Ossian.txt,689,11,62,287,77,53,8,425
22657_OrderOfMagnitude.txt,989,21,47,311,113,81,39,544
2265927_ListOfFasbInterpretations.txt,1327,52,25,734,56,15,2,807
2265_AdamAndEve.txt,7039,91,77,2270,1095,436,278,4079
22660_OccamprogrammingLanguage.txt,804,31,25,314,108,68,16,506
22661_OctoberRevolution.txt,1554,22,70,578,210,89,45,922
2266222_SandboxvideoGames.txt,855,18,47,382,88,73,34,577
2266239_MidnightMadness.txt,1122,21,53,448,157,71,33,709
2266240_MissileGap.txt,759,8,94,241,109,63,47,460
2266273_SagaOfSevenSuns.txt,1947,97,20,773,239,163,64,1239
226711_TheCallOfTheSimpsons.txt,579,10,57,221,75,44,14,354
226748_Stillbirth.txt,1732,22,78,612,251,164,58,1085
226751_Kerning.txt,835,23,36,266,146,66,51,529
2267629_FlipSaunders.txt,872,16,54,336,92,47,14,489
2267640_Mitsurugi.txt,2297,33,69,779,363,157,75,1374
2267673_WrestlingObserverNewsletterHallOfFame.txt,719,16,44,590,23,11,5,629
226795_RobertQuine.txt,697,18,38,299,81,52,16,448
2268495_MaurytvSeries.txt,2397,19,126,716,404,162,123,1405
2268708_VladekSpiegelman.txt,609,8,76,210,102,28,27,367
2269540_DorothyAshby.txt,624,8,78,258,71,46,17,392
2270248_RobertOconnor.txt,763,24,31,312,99,50,13,474
2270_AsymmetricDigitalSubscriberLine.txt,1180,19,62,435,161,103,45,744
227135_StageCombat.txt,1247,19,65,453,186,128,48,815
227137_CharlesReade.txt,1294,10,129,434,160,76,30,700
227156_Tinian.txt,735,11,66,273,99,50,25,447
227160_JohnLothropMotley.txt,714,11,64,258,74,46,21,399
227161_MoncureDanielConway.txt,1036,20,51,459,96,47,23,625
227177_FrenchThirdRepublic.txt,2968,34,87,990,381,299,101,1771
227180_Brujah.txt,1137,16,71,340,160,78,70,648
227181_MultiinfarctDementia.txt,1138,24,47,437,141,152,44,774
227190_BattleOfLangside.txt,1231,15,82,400,198,69,66,733
2271992_HelpbuffyEpisode.txt,1557,26,59,496,257,80,64,897
2271998_HimbuffyEpisode.txt,1397,26,53,519,190,56,53,818
2272005_ConversationsWithDeadPeople.txt,2054,40,51,720,323,92,88,1223
2273065_YoshiakiFujiwara.txt,1036,11,94,459,118,63,35,675
2273069_AyerTawar.txt,726,7,103,299,83,85,29,496
2273087_KaifuLee.txt,770,16,48,369,78,42,5,494
2273091_HamdanVRumsfeld.txt,4921,60,82,1776,712,301,186,2975
2273100_VittorioTheVampire.txt,654,11,59,188,107,41,26,362
2273101_Stoozing.txt,1377,20,68,437,200,106,86,829
2274414_AlainVivien.txt,952,15,63,340,122,68,25,555
2274628_Optacon.txt,668,5,133,249,99,43,18,409
2275001_WordplaygameShow.txt,631,11,57,214,93,36,15,358
2275308_WwfSmackdownJustBringIt.txt,872,11,79,289,151,59,47,546
2275337_MikeBaldwin.txt,1091,17,64,368,200,54,44,666
2275501_RedWeed.txt,632,9,70,190,104,40,32,366
2276409_SteelFrame.txt,621,11,56,218,94,55,13,380
2277242_HeiarHelguson.txt,774,15,51,261,96,80,32,469
2277948_DepayinMassacre.txt,1218,14,87,350,212,92,39,693
2278346_PatCorley.txt,595,9,66,307,43,23,11,384
2278348_LukeRoberts.txt,695,17,40,401,31,21,3,456
2278820_SisterRay.txt,780,14,55,314,116,45,16,491
227915_tude.txt,1312,19,69,533,117,60,27,737
2279663_SocialCycleTheory.txt,1013,16,63,417,86,102,31,636
2279675_TracyBarlow.txt,2007,33,60,606,369,96,102,1173
2279685_ConstructionistLearning.txt,606,9,67,243,74,40,21,378
2281588_Bucktick.txt,1587,55,28,873,106,38,6,1023
228222_KurtzheartOfDarkness.txt,637,9,70,216,95,41,26,378
2282272_CarolMutter.txt,682,11,62,370,47,30,5,452
228236_BicepsBrachiiMuscle.txt,636,20,31,203,87,59,29,378
228244_HertaDublergmelin.txt,690,10,69,206,105,63,22,396
228250_IslamicStudies.txt,1207,40,30,495,135,130,41,801
228264_Shavuot.txt,2877,35,82,1058,350,156,69,1633
2282667_MountRoyalTunnel.txt,908,13,69,370,120,61,17,568
2282686_Siptah.txt,621,7,88,225,82,32,26,365
228274_TheLastSamurai.txt,2678,32,83,988,346,232,102,1668
228275_ZimmermannTelegram.txt,2093,30,69,866,262,104,55,1287
228284_RadialNerve.txt,579,29,19,212,47,71,16,346
228293_RichardDawson.txt,795,13,61,321,99,34,23,477
228309_HongKongBasicLawArticle23.txt,3452,58,59,1208,479,240,111,2038
228338_Gainax.txt,1392,25,55,612,161,105,44,922
228340_YogiBear.txt,957,24,39,413,108,63,28,612
228344_MixedMartialArts.txt,3656,57,64,1232,618,325,153,2328
228346_Yazidi.txt,3798,41,92,1436,483,264,139,2322
2284578_MorningCallcnbc.txt,741,12,61,364,60,54,15,493
2284936_DowntownCleveland.txt,3653,35,104,1500,470,279,91,2340
2285136_PerplexCity.txt,1478,23,64,525,202,129,62,918
2285280_Nhmfl.txt,2471,17,145,1121,261,220,31,1633
2285970_EdoardoMangiarotti.txt,1379,20,68,568,132,105,28,833
2285986_NedoNadi.txt,651,13,50,242,87,45,12,386
2286631_Techniscope.txt,874,11,79,344,86,58,18,506
2287364_ListOfAttractionsAndEventsInLouisvilleKentucky.txt,1319,20,65,833,81,78,14,1006
2287537_BattleOfTheBasqueRoads.txt,1869,26,71,576,298,132,70,1076
2288455_UnitedIslamicFrontForTheSalvationOfAfghanistan.txt,1186,25,47,478,141,96,48,763
2288484_HolidaymadonnaSong.txt,1165,27,43,450,120,94,41,705
2288624_SpecialStage.txt,2016,18,112,659,277,160,81,1177
2289296_GrovePress.txt,1062,18,59,482,119,69,28,698
228936_SchoolOfVisualArts.txt,1631,67,24,811,154,93,29,1087
2289648_WindowsVista.txt,6329,63,100,2660,886,491,210,4247
228980_MartinBuber.txt,2235,35,63,794,277,198,69,1338
2289950_HowardMills.txt,684,12,57,338,68,37,12,455
2290390_CharlieMcmahon.txt,4839,57,84,1928,578,320,135,2961
2290688_NationalCampusAndCommunityRadioAssociation.txt,929,11,84,405,106,75,16,602
2291063_Nuwaubianism.txt,5898,66,89,2311,837,345,186,3679
2291778_RjReynolds.txt,571,8,71,226,68,39,16,349
2291790_IndianSchoolOfMines.txt,1560,29,53,955,102,78,23,1158
2292610_DeathComesAsTheEnd.txt,961,16,60,351,152,49,32,584
2292623_MolecularDocking.txt,972,17,57,406,114,92,31,643
2292635_TakenAtTheFlood.txt,1682,19,88,576,293,89,74,1032
2293686_Metayage.txt,960,16,60,285,131,86,57,559
2293709_2BrothersOnThe4thFloor.txt,958,24,39,345,124,87,35,591
2293988_DigitalEvidence.txt,912,15,60,325,129,92,43,589
229411_Paranstate.txt,822,17,48,318,87,87,15,507
229422_SoPaulostate.txt,1019,29,35,456,81,95,33,665
229424_ListOfFictionalRabbits.txt,1552,17,91,927,67,62,21,1077
229435_EthiopianOrthodoxTewahedoChurch.txt,2517,35,71,984,309,171,77,1541
2295048_Area51firstpersonShooter.txt,3246,68,47,1058,530,208,148,1944
2295398_10Meters.txt,1012,28,36,395,104,72,44,615
2295405_LittleChildrenfilm.txt,1999,22,90,778,300,92,101,1271
2296132_2005NflSeason.txt,1410,22,64,575,164,77,45,861
2296159_PowderDiffraction.txt,1873,45,41,664,232,179,81,1156
2296160_Pregap.txt,1089,13,83,585,69,73,24,751
2296173_ThePizza.txt,783,10,78,249,138,27,20,434
2297330_UssSaratoga1780.txt,1790,19,94,617,283,117,48,1065
22984_Primate.txt,2431,32,75,990,297,245,93,1625
22986_Politics.txt,2287,37,61,805,289,241,70,1405
2298729_Cyteen.txt,1377,29,47,458,242,96,54,850
2299477_Noseband.txt,2300,24,95,666,364,162,135,1327
230004_Scratching.txt,2144,37,57,772,325,144,104,1345
230033_BattleOfTrenton.txt,1297,17,76,457,201,60,38,756
2300625_PelhamBit.txt,1184,22,53,367,154,80,61,662
230079_CrossculturalCommunication.txt,617,12,51,287,59,60,17,423
2300953_CarlAugustNicholasRosa.txt,872,11,79,397,96,54,15,562
2301361_ConstantineTikhOfBulgaria.txt,691,11,62,271,82,38,16,407
2301678_GidgetGein.txt,888,13,68,379,90,66,17,552
2302036_RaelynnHillhouse.txt,589,28,21,314,35,40,2,391
2302454_FerencJoachim.txt,3712,16,232,1450,395,233,126,2204
2302742_JeremyCamp.txt,829,19,43,409,88,45,14,556
2302751_Campfilm.txt,656,13,50,233,109,33,24,399
2303791_CitadelleLaferrire.txt,793,10,79,263,110,73,18,464
2303957_DaikyojGappa.txt,738,6,123,255,114,48,24,441
230455_Cyfra.txt,2386,56,42,1049,39,240,10,1338
230456_Mallard.txt,2249,48,46,938,248,191,104,1481
230481_Predatorfilm.txt,2981,52,57,1045,448,181,95,1769
230483_Commandofilm.txt,1826,19,96,727,254,97,70,1148
230488_MinkowskiSpace.txt,1295,38,34,445,180,121,55,801
230489_LorentzGroup.txt,3869,68,56,1372,449,366,118,2305
2304987_1990sInHongKong.txt,1823,41,44,723,201,133,23,1080
230503_Number96tvSeries.txt,1865,30,62,735,243,168,44,1190
2305690_WebleyfosberyAutomaticRevolver.txt,1100,22,50,363,162,89,52,666
2305746_MarchOfThePenguins.txt,1890,26,72,720,239,140,63,1162
2306400_DeadRingeralbum.txt,650,11,59,304,80,24,11,419
2306840_DanielRhodes.txt,812,11,73,393,81,47,5,526
2307108_Konbleach.txt,1072,14,76,375,165,70,50,660
2307120_Wqex.txt,759,15,50,258,115,61,28,462
2307134_TheCeremonialBattle.txt,4127,19,217,1476,718,107,178,2479
2307151_W88.txt,644,10,64,263,53,61,21,398
2307235_MikeBirbiglia.txt,642,17,37,299,73,30,10,412
2307404_DavidMacht.txt,1041,23,45,423,111,71,13,618
2307468_FruitbearingSociety.txt,6006,35,171,4577,23,244,14,4858
2309394_dalenShootings.txt,694,7,99,233,114,48,12,407
2310105_CedricGibbons.txt,741,12,61,316,73,29,21,439
2310173_JuanWilliams.txt,611,14,43,256,86,40,9,391
2310813_IlokanoLiterature.txt,2541,48,52,1228,230,194,67,1719
2311194_MuseumDeHallenHaarlem.txt,758,16,47,274,93,62,24,453
2311499_GallienusUsurpers.txt,612,7,87,242,73,39,9,363
231167_ArnulfoArias.txt,632,11,57,211,97,40,20,368
231169_UssTheodoreRooseveltcvn71.txt,1639,37,44,777,173,94,31,1075
231170_Fantasy.txt,1513,24,63,566,178,187,57,988
2312540_NorthWesternProvinceSriLanka.txt,1393,25,55,671,153,115,27,966
2312562_FoundationForNewEraPhilanthropy.txt,1472,24,61,534,215,97,42,888
2313624_CharlesAugustLindbergh.txt,734,13,56,264,100,36,19,419
2313629_AngieWatts.txt,3462,31,111,1046,606,177,192,2021
2314476_BradfordColliery.txt,1235,20,61,443,169,67,32,711
231551_KingsQuestSeries.txt,3178,38,83,1243,401,214,95,1953
2315531_GreenspondNewfoundlandAndLabrador.txt,1436,16,89,563,167,85,38,853
2315540_FartherPomerania.txt,610,14,43,288,45,42,10,385
231571_CarmenSandiego.txt,1414,17,83,549,198,100,39,886
231584_SurvivorTheAustralianOutback.txt,1528,13,117,481,269,103,54,907
2315859_BrunoCoulais.txt,996,11,90,405,118,76,18,617
2315912_LilaLee.txt,831,105,7,398,61,31,19,509
231591_JosNpoles.txt,1105,21,52,419,131,44,25,619
231592_SurvivorThailand.txt,1333,11,121,389,227,118,60,794
231593_WagnerTuba.txt,647,9,71,232,96,44,36,408
2317760_UnitedStatesAmbassadorToJapan.txt,670,8,83,396,22,22,0,440
2317765_RaphaelsoulCalibur.txt,1331,23,57,430,227,74,55,786
2317819_SocialDemocracyOfTheKingdomOfPolandAndLithuania.txt,1094,18,60,402,131,64,33,630
2318493_ThePrombuffyEpisode.txt,1152,32,36,380,189,34,45,648
2319157_RockCycle.txt,2044,27,75,699,277,229,63,1268
2319159_Zanpakut.txt,4590,52,88,1789,592,358,134,2873
2319323_ElizabethBennet.txt,622,9,69,227,73,40,24,364
2319491_UnaussprechlichenKulten.txt,614,18,34,258,76,49,16,399
2320224_Nipmuck.txt,930,23,40,320,131,76,37,564
2321327_JamesHadleyChase.txt,1404,11,127,595,107,49,33,784
232185_GiuseppeTomasiDiLampedusa.txt,937,11,85,319,137,43,39,538
2322108_KennedyDisease.txt,570,11,51,234,84,45,26,389
232210_RajyaSabha.txt,698,14,49,278,77,36,13,404
2322127_LanceArmstrongFoundation.txt,1572,26,60,715,185,101,28,1029
232212_EmergencyMedicalHologram.txt,1018,13,78,371,142,77,36,626
2322153_CarbonOffset.txt,2259,39,57,859,307,220,91,1477
232249_CrystalRadio.txt,1841,29,63,686,259,177,60,1182
2323197_GradNite.txt,902,21,42,384,134,70,30,618
2323198_KilbredaCollege.txt,998,36,27,526,93,42,11,672
2323233_TalesFromTheCryptcomic.txt,759,10,75,380,66,33,9,488
2323545_TnaSacrifice.txt,755,10,75,422,83,23,2,530
2323650_Tna2005SuperXCupTournament.txt,676,15,45,322,83,19,12,436
2324613_503dInfantryRegimentunitedStates.txt,612,10,61,221,73,56,11,361
2325479_GiuseppeCrespi.txt,1323,16,82,612,142,74,36,864
2325765_Ntrance.txt,801,20,40,323,86,68,29,506
232653_Hussar.txt,3242,40,81,1226,395,317,121,2059
232654_BenTurpin.txt,712,14,50,268,89,52,21,430
2326565_BloodySundayInquiry.txt,935,20,46,303,154,47,21,525
232657_HenryAddington1stViscountSidmouth.txt,675,11,61,310,57,27,10,404
232659_SusanPolgar.txt,1305,36,36,528,155,87,39,809
232669_TonyBennett.txt,3378,61,55,1320,456,232,106,2114
232674_Turntablism.txt,3684,39,94,1293,474,329,149,2245
232683_FrasierCrane.txt,1373,19,72,440,200,108,76,824
232689_ClubOfRome.txt,590,18,32,297,43,47,9,396
2327604_JoeyJordison.txt,1088,17,64,469,124,54,27,674
2327614_TheMusicTapes.txt,693,7,99,304,86,37,28,455
2327911_DannyHogan.txt,634,11,57,242,98,29,22,391
2327916_PavelSudoplatov.txt,810,21,38,278,119,55,23,475
2329108_CanalDigital.txt,609,15,40,393,39,30,9,471
2330500_BrajendraNathSeal.txt,2252,12,187,834,224,184,68,1310
2330892_UssMylesCFoxdd829.txt,973,18,54,425,109,38,7,579
2331584_MeierFrank.txt,785,16,49,359,89,23,10,481
2332287_GradyMcwhiney.txt,982,13,75,397,117,79,22,615
2332305_Wjw.txt,2351,43,54,988,264,159,88,1499
2332328_AlexanderParris.txt,720,9,80,355,68,23,11,457
2332422_Carcinogenesis.txt,1900,22,86,692,273,168,80,1213
2332610_LesCarabiniers.txt,741,6,123,218,140,47,29,434
2333145_AraGler.txt,1632,17,96,924,84,75,24,1107
233338_MatthewPerryactor.txt,1059,22,48,423,145,59,33,660
233347_AntonioPollaiuolo.txt,650,13,50,286,53,20,17,376
2333810_Vulcancars.txt,617,10,61,205,72,40,16,333
2334208_OurPrice.txt,749,8,93,282,90,50,27,449
2334536_CryToHeaven.txt,1198,20,59,376,161,89,60,686
2336822_Rainintheface.txt,4075,74,55,1055,722,234,188,2199
2336830_SpangdahlemAirBase.txt,1758,50,35,821,162,151,18,1152
233721_CommonwealthWarGravesCommission.txt,1890,32,59,702,272,92,52,1118
233760_AlexanderCameronRutherford.txt,1573,30,52,708,153,83,33,977
233761_HughTrenchard1stViscountTrenchard.txt,1122,24,46,442,143,55,33,673
233762_TwelveTables.txt,1726,72,23,683,271,90,60,1104
233763_Wig.txt,1294,23,56,387,196,141,70,794
233764_BristolConnecticut.txt,713,19,37,276,77,39,11,403
2337719_TotalNonstopActionWrestlingRoster.txt,599,15,39,458,8,25,2,493
233778_AcrylonitrileButadieneStyrene.txt,671,10,67,241,104,73,22,440
233780_PowerMacintoshG3.txt,1886,24,78,738,218,144,59,1159
2338555_ListOfBoatBuilders.txt,608,5,121,388,6,10,2,406
2339204_LaraCroftTombRaiderTheAngelOfDarkness.txt,2192,30,73,844,312,125,65,1346
2339243_ChinaNationalTobaccoCo.txt,1099,13,84,415,142,87,66,710
2339267_TeriDesario.txt,617,8,77,245,77,45,22,389
2340298_Kannur.txt,896,16,56,367,107,53,26,553
2341047_VivekanandaVidyaMandir.txt,1296,47,27,591,156,69,26,842
2341167_IbrahimAdilShahIi.txt,916,21,43,365,149,49,23,586
2341471_TheresaLopezfitzgerald.txt,2017,44,45,674,378,87,96,1235
2341493_California48thCongressionalDistrictSpecialElection2005.txt,1172,20,58,531,113,89,31,764
2341858_Ohmu.txt,682,5,136,209,107,67,35,418
2341876_JeffreyGuterman.txt,1052,9,116,461,101,90,16,668
2342514_MySummerOfLove.txt,2181,25,87,698,322,155,105,1280
234368_ComingOfAge.txt,1855,29,63,616,273,157,80,1126
234438_DasKapital.txt,1224,18,68,466,126,97,46,735
234439_ProsperOfAquitaine.txt,658,8,82,242,81,47,26,396
234474_NubianLanguages.txt,863,9,95,345,102,81,24,552
234496_UssShreveportlpd12.txt,930,17,54,423,85,37,10,555
234500_TreatyEstablishingAConstitutionForEurope.txt,6462,111,58,2096,929,518,243,3786
234506_ListOfKingsOfBabylon.txt,675,17,39,339,38,46,25,448
2345406_InfrequentlyAskedQuestions.txt,1846,13,142,677,244,130,77,1128
2345409_StatisticalProbabilities.txt,997,16,62,306,153,71,47,577
2346466_TheEssexAndKentScottish.txt,661,16,41,296,70,35,16,417
2346929_InTheDarkangelEpisode.txt,1145,24,47,383,194,27,51,655
2346931_HyPyke.txt,2106,23,91,850,210,184,92,1336
2347316_1992InAustralia.txt,693,9,77,375,46,31,14,466
2347652_HenryEelesDresser.txt,878,9,97,322,100,52,20,494
234798_Grief.txt,2302,20,115,684,342,202,133,1361
2347994_Stichometry.txt,1025,9,113,312,140,67,30,549
234827_Ridicule.txt,1760,19,92,569,264,91,73,997
234828_Tickling.txt,2217,29,76,707,397,177,99,1380
234833_Burrito.txt,1052,24,43,404,162,100,49,715
2348364_InTheCitysong.txt,690,9,76,200,68,89,34,391
2348392_KoUn.txt,776,9,86,304,89,67,34,494
234841_MaxBrod.txt,936,10,93,306,135,72,38,551
234842_Chorltoncumhardy.txt,886,21,42,377,103,62,30,572
234844_TakcsQuartet.txt,970,12,80,462,65,52,22,601
2348851_HorribleScience.txt,866,20,43,505,40,32,12,589
2349215_2005HungarianGrandPrix.txt,1438,12,119,494,189,127,57,867
2349541_BritishStandardWhitworth.txt,592,16,37,229,83,53,19,384
2351145_SkyCoyote.txt,772,12,64,233,124,61,42,460
2351780_ALittleSnowFairySugar.txt,2298,38,60,784,351,164,98,1397
2353559_Punjabindia.txt,2102,38,55,926,247,151,53,1377
2353698_SomethingBlue.txt,817,25,32,295,118,48,28,489
235465_CourtLine.txt,1043,25,41,392,143,88,23,646
2355699_AntanasSniekus.txt,858,14,61,305,134,38,26,503
235589_Axolotl.txt,1941,18,107,615,329,150,102,1196
235592_ActonTownTubeStation.txt,762,16,47,326,91,38,25,480
2356576_Phyto.txt,625,5,125,256,98,41,12,407
2357597_EternityangelEpisode.txt,1186,19,62,341,210,44,58,653
2358060_MatthewHuttonarchbishopOfYork.txt,781,8,97,284,97,39,9,429
2358061_TristanAndIseult.txt,3989,50,79,1533,463,338,132,2466
235902_Borehole.txt,1687,31,54,640,242,134,60,1076
235904_DimitriTiomkin.txt,798,10,79,323,55,67,11,456
235921_CharlotteTurnerSmith.txt,558,16,34,227,54,45,17,343
235926_DnaPolymerase.txt,1176,22,53,491,167,89,47,794
235929_PomponiusMela.txt,724,9,80,264,76,63,33,436
235981_MarcusVelleiusPaterculus.txt,684,13,52,295,71,40,17,423
2359854_BattleOfChillianwala.txt,1145,19,60,409,166,78,49,702
2360529_ScotchOakburnCollege.txt,1204,25,48,515,142,75,24,756
2360572_DivisionsOfIslam.txt,3367,107,31,1257,462,263,112,2094
2361396_CoyoteUglyfilm.txt,951,14,67,418,102,42,28,590
2362268_LekhahDodi.txt,1250,56,22,513,119,122,45,799
2362332_ColourTrademark.txt,615,11,55,229,76,57,20,382
2362337_HowToKillAMockingbird.txt,721,10,72,248,95,41,26,410
2362444_HansRobertJau.txt,794,10,79,356,60,48,13,477
2362446_TheGraveyardGame.txt,2135,23,92,741,312,141,90,1284
2362450_IdeomotorEffect.txt,607,6,101,312,32,42,9,395
2363822_Kraith.txt,690,9,76,225,96,67,28,416
2364888_AreYouNowOrHaveYouEverBeen.txt,2146,16,134,646,394,77,74,1191
2365265_ListOfNotableEdmontonians.txt,553,10,55,340,22,27,5,394
236666_Androgen.txt,874,17,51,331,116,97,25,569
2366777_JohnDeweyHighSchool.txt,1385,33,41,631,156,84,23,894
2366796_FightersHistory.txt,523,9,58,222,61,38,15,336
2367130_RunLikeHell.txt,654,9,72,232,90,43,28,393
2367529_Antishaker.txt,985,14,70,317,139,79,57,592
2367879_LostAndFoundwillSmithAlbum.txt,893,19,47,374,96,55,37,562
2368623_BornAgainKrabs.txt,612,11,55,237,95,30,25,387
23690_Phosphate.txt,1066,32,33,403,147,112,50,712
236981_Amniote.txt,636,8,79,224,85,69,25,403
236994_HubertHHumphreyMetrodome.txt,3463,40,86,1220,506,266,95,2087
2369985_RogerJWilliams.txt,579,12,48,255,50,31,5,341
237001_GoNagai.txt,619,11,56,270,63,42,16,391
237004_MetropolitanStadium.txt,932,13,71,326,129,50,36,541
23703_PotentialEnergy.txt,2944,79,37,889,398,368,102,1757
23704_Pyramid.txt,2018,42,48,668,297,159,76,1200
23705_Predestination.txt,3744,56,66,1192,553,271,203,2219
23707_Priest.txt,1926,22,87,673,228,168,103,1172
237080_Mystiquecomics.txt,6468,82,78,1959,1151,433,289,3832
237084_TheNeedles.txt,755,21,35,276,110,40,18,444
23708_Pli.txt,1355,30,45,483,215,119,55,872
2371163_PreobrazhenskyRegiment.txt,903,7,129,355,70,40,8,473
2371211_ListOfStarWarsPlanetscd.txt,4666,90,51,1887,663,286,152,2988
2371219_MaloofFamily.txt,585,12,48,269,56,37,13,375
2371221_JimmyJacobs.txt,1312,32,41,614,159,65,19,857
23712_Pentomino.txt,671,14,47,213,94,42,29,378
23715_RotationpoweredPulsar.txt,602,9,66,218,83,48,23,372
23717_PeriodicTablevertical.txt,439,36,12,189,25,18,8,240
2372596_RedboneCoonhound.txt,854,18,47,265,137,80,46,528
23733_Periodization.txt,1750,19,92,540,222,192,84,1038
2373609_PitfallIiLostCaverns.txt,842,12,70,304,107,62,25,498
2373639_WestOaklandOaklandCalifornia.txt,882,11,80,376,110,58,14,558
23738_Propeller.txt,2731,42,65,990,394,241,105,1730
23739_PeterDuesberg.txt,1463,24,60,614,179,88,41,922
23741_PhiladelphiaPhillies.txt,5808,58,100,2108,616,331,152,3207
2374338_Kovin.txt,727,29,25,282,61,36,6,385
2374455_PortageTrailConference.txt,813,21,38,497,61,31,12,601
23745_Pokmon.txt,5644,81,69,1912,748,663,194,3517
23746_PaulTheDeacon.txt,958,11,87,387,113,34,27,561
23748_Photolithography.txt,1752,27,64,576,291,166,63,1096
2375453_AriffinMohamed.txt,582,22,26,227,85,33,15,360
2375548_EastHighSchooldesMoines.txt,579,14,41,216,85,40,17,358
2375877_SijilTinggiPersekolahanMalaysia.txt,1359,25,54,533,165,106,73,877
2376286_62ndVeniceInternationalFilmFestival.txt,1832,25,73,1164,58,72,14,1308
237685_Kitsune.txt,3943,64,61,1320,602,329,167,2418
2376994_BritishHockeyLeague.txt,622,9,69,283,17,12,12,324
237754_PubliusClodiusPulcher.txt,1151,13,88,463,168,40,28,699
237757_NorthAmericanSoccerLeague.txt,1100,24,45,529,106,62,38,735
2378873_CompendiumOfPostageStampIssuerstoTz.txt,1242,129,9,606,12,48,15,681
2378876_SavageAndNoble.txt,732,8,91,231,119,66,46,462
2378911_LesothoHighlandsWaterProject.txt,827,19,43,323,105,50,22,500
2379617_BrianMclaren.txt,783,15,52,365,82,70,15,532
2380646_PhineasFBresee.txt,772,8,96,309,86,37,17,449
2380701_LisaGrimaldi.txt,1245,24,51,532,148,70,46,796
2381268_FlyingSpaghettiMonster.txt,1413,36,39,584,175,88,31,878
238148_ListOfModernWeapons.txt,1584,9,176,919,87,82,11,1099
238150_Furnace.txt,2316,37,62,806,360,172,84,1422
238156_PatrickEwing.txt,1423,18,79,569,146,74,33,822
238175_HoraceSilver.txt,680,12,56,315,64,46,14,439
238190_CircleOfFifths.txt,1297,17,76,407,126,125,44,702
238192_UsRoute27.txt,706,19,37,293,85,26,24,428
2382047_SuziRawn.txt,595,25,23,331,50,25,15,421
2382902_Burtonsnowsports.txt,772,14,55,360,89,51,25,525
2384576_GeorgeStreetDunedin.txt,640,8,80,241,62,61,14,378
2384627_NewYorkUniversitySchoolOfContinuingAndProfessionalStudies.txt,649,18,36,392,18,16,2,428
2384635_SteinhardtSchoolOfEducation.txt,712,21,33,351,45,38,8,442
2385482_Wileyrapper.txt,1315,23,57,570,179,47,50,846
2386360_HardToBeAGod.txt,1901,27,70,666,280,104,90,1140
2386544_2002FifaWorldCupQualificationconmebol.txt,976,95,10,355,10,18,2,385
2386575_NorthRussiaCampaign.txt,1972,35,56,774,255,139,51,1219
2387256_EagleStrike.txt,643,7,91,220,104,35,22,381
238777_Ghostwriter.txt,2928,36,81,981,424,268,100,1773
2388373_RoderickJMcdavis.txt,605,10,60,261,58,42,7,368
238839_Tetrodotoxin.txt,1401,27,51,505,210,150,63,928
238840_ShimerCollege.txt,750,15,50,337,71,64,15,487
238846_Doa1950Film.txt,751,22,34,267,102,45,24,438
238849_PermutationMatrix.txt,941,46,20,342,96,44,28,510
2388930_PlanPueblaPanama.txt,1038,31,33,421,130,63,21,635
2389004_NorthernCounties.txt,840,17,49,372,111,57,17,557
2390052_720AbcPerth.txt,655,13,50,330,73,23,4,430
2390053_FairytaleFantasy.txt,930,16,58,448,78,72,25,623
2390056_BicyclingTerminology.txt,4132,106,38,1334,681,277,206,2498
2390057_PhilipSimonsson.txt,840,10,84,314,127,66,19,526
2390069_NurpashiKulayev.txt,1266,23,55,393,245,66,32,736
2390072_LaurasLaw.txt,1555,31,50,616,210,114,55,995
2390885_WhiteRajahs.txt,1199,19,63,457,146,92,30,725
2390929_OverSoul.txt,1448,20,72,571,156,101,57,885
2391961_PatTanaka.txt,639,21,30,310,59,25,15,409
2391980_hackaiBuster.txt,575,12,47,184,97,36,18,335
2391985_GaryBrecher.txt,1075,21,51,373,143,80,46,642
2391986_AlessandroGalilei.txt,608,8,76,253,62,49,14,378
2392280_Syriana.txt,3030,36,84,1197,427,226,79,1929
239229_OathAgainstModernism.txt,1217,20,60,325,188,93,73,679
239246_DCStephenson.txt,663,10,66,238,97,32,20,387
239249_MissSaigon.txt,3928,40,98,1402,590,218,117,2327
239253_CrushingByElephant.txt,2760,39,70,848,445,204,100,1597
239255_TheHistoryOfTheLordOfTheRings.txt,1697,20,84,492,236,159,93,980
239266_Mahamudra.txt,1106,26,42,466,129,60,40,695
2392751_Minturno.txt,744,20,37,273,86,48,21,428
2394191_WilliamStewartHalsted.txt,1439,11,130,661,173,107,40,981
2394415_DeathRoll.txt,709,9,78,185,113,63,45,406
2395299_AllStarSuperman.txt,2121,20,106,801,277,141,60,1279
2395995_FredTitmus.txt,1379,23,59,470,172,90,39,771
2396211_IceHockeyCountry.txt,647,7,92,277,74,52,25,428
2396633_JohnLovewelljunior.txt,1515,30,50,464,252,82,72,870
2396634_HouseOfDarkShadows.txt,1109,31,35,497,153,48,27,725
2397045_RobertStonerugbyLeagueFootballer.txt,907,15,60,377,115,44,18,554
2397101_Kocotv.txt,1369,26,52,677,92,82,14,865
2397733_TurtleTracks.txt,1099,16,68,402,169,47,33,651
2398137_TheChildrensChannel.txt,930,9,103,443,92,54,31,620
2398545_EdwardBancroft.txt,1128,16,70,386,187,58,40,671
2398553_LaniMisalucha.txt,1217,31,39,486,136,91,41,754
2398554_AbraamBishopOfFayoum.txt,1630,29,56,532,241,88,44,905
239863_Distributionbusiness.txt,1784,41,43,585,224,171,86,1066
239870_UniversityOfPittsburgh.txt,2108,38,55,1062,178,140,46,1426
239909_AmeliaVega.txt,618,19,32,301,67,29,17,414
239914_ProvidenceCollege.txt,3712,58,64,1639,359,282,84,2364
2399643_KupaEShqipris.txt,723,3,241,453,15,55,0,523
2399655_TheMerseySound.txt,1555,27,57,508,225,103,58,894
2401017_StaceyReile.txt,793,15,52,322,108,45,24,499
2401049_HungarianCarNumbers.txt,757,26,29,230,106,77,32,445
2401476_CfbComox.txt,747,23,32,376,70,45,13,504
2402111_Cryptomnesia.txt,1165,18,64,346,181,79,67,673
240312_LasVegasPosse.txt,786,16,49,316,93,49,29,487
240314_UniversityOfExeter.txt,3293,60,54,1572,315,178,60,2125
240315_OttawaRenegades.txt,863,18,47,374,105,27,14,520
240317_MemphisMadDogs.txt,638,17,37,262,71,43,25,401
240318_MobileSuitGundamZz.txt,738,13,56,391,64,50,20,525
240320_SacramentoGoldMiners.txt,948,18,52,370,127,54,32,583
240323_ShreveportPirates.txt,740,11,67,279,100,43,13,435
240326_BritishColumbiaLions.txt,10429,92,113,4356,1087,662,218,6323
240335_TheTurnOfTheScrew.txt,1375,19,72,503,178,98,45,824
240336_Warthog.txt,807,22,36,288,118,68,27,501
240339_LucaMndez.txt,944,13,72,448,91,45,17,601
240340_IllinoisJacquet.txt,634,12,52,244,80,33,16,373
240342_MarketSegment.txt,1049,17,61,399,157,100,41,697
2403917_BateauBayNewSouthWales.txt,1338,42,31,644,171,56,35,906
2404334_PhilipBrophy.txt,554,11,50,267,55,41,8,371
2404705_StateTradingOrganization.txt,614,17,36,281,59,48,10,398
2405382_LookingForAlibrandi.txt,579,14,41,232,67,34,25,358
2406177_AnimalYokocho.txt,1645,25,65,624,203,106,62,995
2406482_JohnLottsandbox.txt,3559,42,84,1104,572,271,177,2124
24069_PopePiusIi.txt,2306,20,115,741,319,175,96,1331
2407299_FancyCrane.txt,6712,80,83,1968,1310,285,305,3868
24074_PopePiusV.txt,1105,11,100,401,113,61,23,598
24075_PeripheralComponentInterconnect.txt,1457,28,52,586,191,122,54,953
24077_PortableDocumentFormat.txt,1996,44,45,775,310,139,88,1312
24080_Postscript.txt,3706,70,52,1344,521,280,135,2280
2408401_TinyWebServers.txt,1710,56,30,752,222,152,60,1186
240961_TrungSisters.txt,1952,24,81,751,289,123,64,1227
240964_DetectiveInspectorJohnRebus.txt,849,13,65,307,111,62,31,511
2409824_Zelenchukskaya.txt,592,10,59,202,63,61,12,338
240999_DBoon.txt,572,7,81,253,63,42,15,373
2410152_MiguelLopezfitzgerald.txt,628,17,36,262,101,20,28,411
241025_ShadowOfTheHegemon.txt,680,11,61,270,92,38,27,427
241029_TopQuark.txt,1138,24,47,433,136,98,33,700
2410712_AntonioLopezfitzgerald.txt,550,23,23,270,83,22,18,393
24126_PanFlute.txt,625,9,69,276,82,54,18,430
24131_Php.txt,2534,68,37,979,367,218,93,1657
24133_PrincipiaMathematica.txt,667,18,37,224,87,72,30,413
24135_PrimeMinisterOfCanada.txt,2570,37,69,985,301,188,82,1556
24136_ProcessTheology.txt,851,13,65,404,95,53,28,580
24138_ProtonDecay.txt,1003,24,41,339,141,96,44,620
241390_DonAdams.txt,739,13,56,295,81,45,24,445
2413954_AntoineDeLaSale.txt,1952,13,150,737,237,112,53,1139
2413962_NokotaHorse.txt,773,8,96,247,126,68,23,464
241405_StateOfPalestine.txt,991,19,52,478,91,42,28,639
241408_RadersFftAlgorithm.txt,666,14,47,244,78,56,36,414
241409_Astroturfing.txt,2776,43,64,1189,374,190,68,1821
241411_Omniweb.txt,635,9,70,255,90,45,23,413
241420_Pyromania.txt,752,11,68,244,123,72,28,467
241425_Avalokitevara.txt,917,17,53,354,130,55,30,569
241431_BluesteinsFftAlgorithm.txt,837,17,49,313,80,69,40,502
2415039_AntnioFortunatoDeFigueiredo.txt,844,16,52,388,68,32,17,505
2415045_PaulKammerer.txt,707,11,64,221,128,40,28,417
2415342_CompendiumOfPostageStampIssuersvaVz.txt,728,91,8,361,13,22,14,410
2415360_CompendiumOfPostageStampIssuersuaUz.txt,976,125,7,520,16,40,15,591
2416083_Condesa.txt,1131,21,53,434,140,95,36,705
2416408_Qbz95.txt,1175,26,45,448,143,102,40,733
2416795_PyramidSong.txt,1230,12,102,432,151,106,52,741
2416986_ThePlasticPeopleOfTheUniverse.txt,662,12,55,259,89,43,15,406
2416992_Selfarrest.txt,1055,26,40,329,156,83,40,608
2419226_NewBrunswickConfederationOfRegionsParty.txt,1005,18,55,376,129,81,24,610
2419393_Myzery.txt,629,10,62,224,107,30,26,387
24197_PopeGregoryVi.txt,828,15,55,268,124,33,26,451
2420257_BritishKnights.txt,794,25,31,334,108,61,18,521
242026_Hardees.txt,1483,21,70,532,209,128,66,935
2420313_CarltonPlayersBirkenhead.txt,998,11,90,299,167,64,38,568
242056_HouseOfBurgesses.txt,1351,38,35,548,143,88,40,819
2420742_UnitedStatesSupremeCourtBuilding.txt,1367,24,56,561,143,91,35,830
2420783_PhyllisChesler.txt,634,11,57,277,56,37,10,380
242099_HistoryOfBerlin.txt,5639,76,74,2131,724,389,166,3410
242119_JohnHenryhorse.txt,1056,19,55,411,134,62,39,646
242157_ListOfOrganicGardeningAndFarmingTopics.txt,657,16,41,457,48,29,11,545
2421827_KingAndPawnVersusKing.txt,2442,70,34,729,345,165,90,1329
2421843_OakeshottTypology.txt,1033,21,49,413,97,113,53,676
2422579_WhoMournsForMorn.txt,572,11,52,237,75,17,18,347
2422656_ScholasticScrimmage.txt,1777,30,59,561,209,146,71,987
2422662_Cibo.txt,596,9,66,207,88,32,21,348
2422686_ListOfSchoolsInTheNorthernTerritory.txt,605,15,40,574,3,4,1,582
2423662_WilliamBeldam.txt,949,9,105,385,102,63,23,573
2423762_BegumpetAirport.txt,655,15,43,355,68,43,13,479
2424112_NetworkedBook.txt,1054,12,87,355,165,71,43,634
2424463_Astrosmash.txt,630,13,48,198,105,50,27,380
242476_JackStrawpolitician.txt,2277,28,81,866,332,112,61,1371
242495_Diffusionbusiness.txt,548,8,68,247,55,52,17,371
242497_JarrowMarch.txt,632,8,79,275,55,20,17,367
242502_BoysBrigade.txt,1334,22,60,560,152,83,40,835
2425212_UniversityOfWestAlabama.txt,1772,52,34,810,230,95,55,1190
2428476_MassBalance.txt,1239,37,33,442,171,100,53,766
2429533_LouisClaudeDeSaintmartin.txt,591,13,45,206,82,42,12,342
2430362_StephanieHoyland.txt,1376,15,91,427,265,68,76,836
2430573_Orlan.txt,673,23,29,226,80,45,20,371
2431323_Mudflow.txt,700,11,63,254,91,60,38,443
2431431_HurricaneAlicedecember1954.txt,1299,13,99,429,163,127,37,756
2431770_WeiQing.txt,1934,16,120,700,270,132,67,1169
2432829_DormanLong.txt,1542,65,23,777,122,59,19,977
2433249_ShotgunHouse.txt,2525,33,76,844,358,251,143,1596
2434756_Gynecomastia.txt,807,13,62,284,136,71,38,529
2434796_ItsAlwaysSunnyInPhiladelphia.txt,2444,29,84,934,344,148,87,1513
2435634_Jocastacomics.txt,1082,18,60,361,203,53,38,655
2435810_RickTocchet.txt,899,14,64,350,92,44,19,505
243594_SocialistPartyOfAmerica.txt,2410,39,61,1094,217,129,70,1510
243605_DonaldRegan.txt,594,11,54,253,74,20,18,365
243627_PhysicalInformation.txt,2048,18,113,720,275,178,92,1265
2436741_ListOfMethodsOfConstitutionalAmendment.txt,1073,21,51,314,173,70,32,589
2437200_VampireHunter.txt,1053,15,70,507,94,70,33,704
2438259_ListOfVideoGamesDh.txt,1706,11,155,1351,13,34,0,1398
2438660_LufthansaHeist.txt,2050,28,73,774,331,86,62,1253
2439096_BucksRock.txt,909,25,36,405,109,62,19,595
2440086_StMarksSchool.txt,1481,25,59,732,154,89,23,998
2440176_BlackWidower.txt,673,10,67,242,115,32,17,406
2440479_Rampagetransformers.txt,1499,23,65,506,250,87,55,898
2440498_Boutsrims.txt,718,10,71,213,114,46,29,402
2441591_UdoLattek.txt,1386,15,92,509,136,106,48,799
2441608_ForeverbuffyEpisode.txt,996,14,71,322,166,52,38,578
2441631_SpiderSlayers.txt,913,14,65,330,132,63,26,551
2442414_ChessOpeningTheoryTable.txt,854,13,65,405,84,27,34,550
244318_AeronauticaMilitare.txt,2178,50,43,1196,83,157,15,1451
244321_Matroid.txt,1413,36,39,536,164,112,36,848
244325_Favela.txt,1145,21,54,419,155,110,50,734
244345_MargaretSmithCourt.txt,3104,60,51,1296,336,186,58,1876
244349_JohnJosephOconnor.txt,1933,26,74,749,248,127,59,1183
2443542_Muqawqis.txt,1472,30,49,479,230,64,57,830
2444557_ParsifalBell.txt,622,11,56,226,78,54,10,368
2444848_UniversityrugbyLeague.txt,689,24,28,257,85,38,16,396
2444894_HarryStradling.txt,611,5,122,307,23,9,6,345
2444903_Blockbustercomics.txt,957,18,53,338,152,68,36,594
2446301_PamelaRogersTurner.txt,577,10,57,205,73,40,17,335
2446313_WordWrap.txt,881,24,36,278,142,76,46,542
244659_TheirEyesWereWatchingGod.txt,1585,22,72,535,232,120,59,946
244664_RipVanWinkle.txt,788,17,46,323,96,43,32,494
2446773_FortNisqually.txt,634,10,63,271,78,39,18,406
2446811_DiscworldCharacters.txt,10688,127,84,3404,1668,720,549,6341
244691_DavidBrinkley.txt,1031,20,51,423,121,63,38,645
2446996_BimaranCasket.txt,1202,24,50,443,143,85,59,730
244703_MusicOfFrance.txt,2755,65,42,1151,299,314,108,1872
244720_SanDiegoConquistadors.txt,638,9,70,245,78,31,16,370
244732_SubminiaturePhotography.txt,613,15,40,225,67,73,34,399
244733_BobbyBonds.txt,967,11,87,333,128,56,22,539
244737_3030Club.txt,896,10,89,323,116,48,44,531
244741_DxCenturyClub.txt,639,12,53,268,77,42,10,397
244742_DutchFamineOf1944.txt,614,6,102,234,82,35,17,368
244747_Brahmin.txt,3184,48,66,1440,378,178,83,2079
2447857_BattleOfOrmocBay.txt,1276,25,51,519,149,70,28,766
2447878_ListOfPublicReitsInTheUnitedStates.txt,766,18,42,576,8,9,1,594
2448939_ElvaHsiao.txt,759,21,36,344,102,48,18,512
2448941_CancerStemCell.txt,1333,21,63,499,211,128,57,895
2449242_BerkeleyHighSchoolberkeleyCalifornia.txt,1765,24,73,886,124,125,15,1150
2450727_UssTwiningdd540.txt,3308,48,68,1280,438,185,46,1949
2452224_Horseclans.txt,606,11,55,230,63,48,14,355
2452248_WeekendToday.txt,793,20,39,373,81,36,20,510
2452565_HallsandsDevon.txt,691,18,38,257,93,40,21,411
2453562_EphesianTale.txt,2931,48,61,906,531,118,120,1675
2453948_GregLand.txt,729,14,52,280,94,59,30,463
245439_Christopher.txt,898,26,34,664,24,77,6,771
2455041_Dhara.txt,613,7,87,197,91,36,31,355
2455439_ListOfSonicXEpisodes.txt,11519,172,66,4735,1691,450,421,7297
2455491_CarloPassaglia.txt,596,11,54,214,61,26,9,310
2455541_ChrisJansing.txt,1041,32,32,466,120,42,22,650
245794_Salyut1.txt,752,11,68,292,88,61,10,451
245795_Wairarapa.txt,648,18,36,285,81,41,7,414
245834_BlackPower.txt,1440,20,72,608,166,115,61,950
245835_MusicOfTanzania.txt,1100,21,52,480,134,102,33,749
2458845_BorisKarloffFilmography.txt,856,2,428,357,14,8,0,379
2458852_Jugging.txt,578,9,64,181,89,44,22,336
2458875_DataAssimilation.txt,1106,25,44,395,149,114,39,697
2460827_ChittyChittyDeathBang.txt,1070,24,44,409,151,49,43,652
2461318_ListOfMinorCharactersInXenosaga.txt,9145,131,69,3245,1324,592,344,5505
2462346_MinnesotaTwinsAwardWinnersAndLeagueLeaders.txt,633,29,21,315,5,5,0,325
2462768_KokeeStatePark.txt,708,5,141,371,54,51,6,482
2463183_KrabBorg.txt,674,8,84,262,119,34,26,441
2463200_FrenchArtOfThe19thCentury.txt,773,14,55,299,67,79,18,463
2463789_ThorntonHall.txt,979,17,57,391,100,104,19,614
2464121_AsraQNomani.txt,761,16,47,359,75,37,8,479
246437_MusicOfCapeVerde.txt,1173,14,83,486,167,87,46,786
2464592_HayatedeadOrAlive.txt,1215,17,71,389,184,66,51,690
246507_Silage.txt,1052,20,52,330,194,79,44,647
2466103_ClevelandBrown.txt,668,8,83,224,109,40,40,413
2466751_TwentiethConvoy.txt,686,6,114,263,83,40,8,394
2467150_IntelCoreMicroarchitecture.txt,1243,20,62,538,113,102,35,788
2467576_1990FifaWorldCupQualification.txt,625,15,41,262,79,25,9,375
2467585_Dwarveswarcraft.txt,1880,28,67,625,279,118,74,1096
2467635_GayRightsInSaudiArabia.txt,1070,27,39,372,190,71,31,664
2468554_UssHulbertdd342.txt,843,13,64,334,122,36,18,510
2468683_HighavailabilityCluster.txt,1103,15,73,405,169,96,55,725
2468688_MichaelTheBrave.txt,888,15,59,346,106,57,25,534
246891_YChromosome.txt,1836,34,54,703,233,191,70,1197
246903_Apologetics.txt,2058,29,70,897,224,188,47,1356
246920_VisaInternationalServiceAssociation.txt,2216,45,49,881,302,144,72,1399
246921_Levi.txt,811,12,67,298,111,40,19,468
2469580_MissionAccomplished.txt,1348,27,49,527,190,58,48,823
2470028_Nupe.txt,2421,140,17,1362,91,136,30,1619
2470063_LondonTipton.txt,904,11,82,314,149,56,48,567
2470414_GershgorinCircleTheorem.txt,608,19,32,227,73,39,20,359
2471118_TheOmacProject.txt,1087,17,63,447,165,47,28,687
2471934_ConstraintCounting.txt,642,16,40,188,81,89,26,384
2471964_PoliticalEntrepreneur.txt,754,13,58,267,84,105,22,478
247273_KoreanPeninsula.txt,715,15,47,272,81,73,26,452
247279_Autobianchi.txt,1430,21,68,473,205,138,60,876
2474199_HenryStaunton.txt,776,17,45,343,86,41,12,482
2475017_JimmyQuinnscottishFootballer.txt,1319,14,94,399,199,105,74,777
2475030_Tianeptine.txt,872,21,41,305,123,99,41,568
2475035_LeastCostRouting.txt,1317,15,87,475,186,108,50,819
2475038_ListOfMaxillariaSpecies.txt,1596,2,798,1218,62,62,5,1347
2475741_ShannaraArtifacts.txt,2167,21,103,653,359,124,58,1194
2476072_TimelineOfPhilippineHistory.txt,1177,24,49,583,143,69,11,806
2476083_ForasArmadasDeCabinda.txt,1144,38,30,754,75,37,6,872
2476120_ShwachmandiamondSyndrome.txt,1155,11,105,410,153,146,34,743
247616_Picnic.txt,1005,17,59,366,119,98,37,620
2476395_CdcClassificationSystemForHivInfectionInChildren.txt,908,16,56,348,98,123,15,584
2476452_Marsmanga.txt,1097,29,37,388,145,66,45,644
247655_BridgewaterNovaScotia.txt,845,10,84,302,112,72,30,516
2477490_OwnedandoperatedStation.txt,4712,75,62,1940,597,271,258,3066
2477500_TimeBombangelEpisode.txt,2728,47,58,1056,483,95,106,1740
2477593_BrianWallowsAndPetersSwallows.txt,741,13,57,274,93,53,30,450
24777_Psychokinesis.txt,1475,54,27,683,152,138,47,1020
24782_Pente.txt,1066,17,62,359,154,75,46,634
2478339_EstimateOfTheSituation.txt,1171,17,68,449,180,89,36,754
2478343_MisterTtvSeries.txt,551,42,13,303,41,22,4,370
2478364_HistoryOfSouthTyrol.txt,1823,18,101,621,251,166,87,1125
24787_Ugm27Polaris.txt,2578,33,78,921,364,233,78,1596
24795_Privaterank.txt,1264,35,36,580,130,92,38,840
24797_Proclus.txt,3677,44,83,1270,475,239,123,2107
2480781_KatharineSusannahPrichard.txt,703,28,25,292,61,52,11,416
2481814_PaulaHitler.txt,750,9,83,217,126,52,36,431
2481817_AssCobra.txt,663,7,94,313,59,32,23,427
24821_Playstation2.txt,3994,53,75,1638,479,325,130,2572
2482303_MagicalStela.txt,1559,27,57,499,232,102,46,879
24824_Pterosaur.txt,2419,39,62,837,358,215,103,1513
24825_Pteranodon.txt,950,15,63,340,158,71,46,615
248269_MusicOfCanada.txt,5912,115,51,2538,631,619,212,4000
248279_ParamountRecords.txt,675,12,56,285,96,44,24,449
248285_FrankfurtInternationalAirport.txt,1668,27,61,1121,92,101,16,1330
24829_PrimitiveRecursiveFunction.txt,2400,54,44,882,300,310,85,1577
24830_Peisistratus.txt,693,9,77,244,107,34,22,407
248331_CliffordBrown.txt,807,22,36,357,86,48,30,521
248332_AztalanStatePark.txt,1933,31,62,665,281,121,52,1119
248333_MichailAleksandrovichSholokhov.txt,860,11,78,360,89,38,5,492
248334_YarmouthNovaScotia.txt,1000,52,19,507,90,49,19,665
24833_PrimeMinisterOfJapan.txt,639,12,53,249,64,44,25,382
248342_UpperCanadaRebellion.txt,1106,12,92,411,151,77,36,675
24834_ProteinTargeting.txt,1678,26,64,619,259,144,41,1063
248351_MarioIsMissing.txt,667,7,95,231,113,38,26,408
248353_WouterBos.txt,1055,12,87,393,113,83,24,613
248356_WorldWideAssociationOfSpecialtyProgramsAndSchools.txt,958,15,63,453,123,53,16,645
248364_TheBlindAssassin.txt,575,10,57,185,74,30,24,313
2484827_1954FifaWorldCupFinal.txt,933,12,77,337,142,62,46,587
2484839_JohnWenham.txt,638,9,70,269,72,31,19,391
2485145_AndrBauer.txt,947,20,47,404,106,53,28,591
2485172_1994FifaWorldCupQualificationconmebol.txt,498,38,13,197,23,11,4,235
2485205_1994FifaWorldCupQualificationafc.txt,1315,131,10,498,21,8,1,528
2485243_1994FifaWorldCupQualificationcaf.txt,1107,110,10,408,51,24,4,487
2485308_GaryTeichmann.txt,716,12,59,266,86,21,22,395
2485649_Lumpawarrump.txt,941,16,58,382,124,47,37,590
248685_TheMorningStar.txt,1042,17,61,391,120,89,45,645
248705_HoaHao.txt,696,9,77,283,89,50,16,438
2487079_Rfactor.txt,3034,59,51,1206,440,247,130,2023
248708_RedSkelton.txt,1940,20,97,760,260,109,45,1174
248709_LagunaDeBay.txt,2003,26,77,793,244,150,38,1225
248752_ListOfFictionalAnimalsother.txt,1811,12,150,1018,57,86,20,1181
2488160_PeeblesRoversFc.txt,652,12,54,196,90,36,25,347
2489512_Anamorphosis.txt,959,17,56,459,93,80,18,650
2489534_AlbertLuque.txt,909,24,37,335,112,52,26,525
2489557_WildInTheStreets.txt,966,20,48,385,117,54,38,594
2490603_VillainsInPowerRangersTurbo.txt,1402,36,38,537,204,58,54,853
2491401_VillainsInPowerRangersWildForce.txt,2631,59,44,990,442,114,95,1641
2491403_SajidHameed.txt,632,13,48,218,104,36,33,391
2491422_VillainsOfJasoosiDunya.txt,2031,28,72,705,335,122,105,1267
2492141_RichardBozulich.txt,650,8,81,300,51,36,11,398
2492511_TimelineOfTheMarvelUniverse.txt,5361,69,77,1827,814,415,167,3223
2492527_Wkcr.txt,1027,36,28,464,115,57,21,657
2493166_CpShips.txt,789,16,49,333,97,45,17,492
2493928_Weever.txt,1059,26,40,364,171,94,51,680
249401_EdvardBene.txt,656,12,54,264,56,26,11,357
249417_Chepstow.txt,1511,25,60,589,201,101,37,928
249425_Hastur.txt,927,28,33,370,116,65,22,573
249427_IrmaGrese.txt,696,13,53,257,89,48,12,406
249432_Tsathoggua.txt,1631,64,25,617,200,106,50,973
249438_PrincipleOfLeastAction.txt,1083,19,57,354,139,99,40,632
249458_TibetanPeople.txt,2381,37,64,816,348,211,102,1477
2494745_JeremyBorash.txt,597,11,54,254,86,26,10,376
2494766_HistoryOfVladivostok.txt,2264,39,58,812,272,164,39,1287
2495086_EyeTracker.txt,1090,25,43,445,126,94,49,714
2495882_NewYorkCityDepartmentOfEducation.txt,1021,18,56,428,112,99,22,661
2496310_Leftlibertarianism.txt,1287,21,61,468,169,125,53,815
2497342_VillainsInMightyMorphinPowerRangers.txt,2378,63,37,930,383,123,71,1507
2497347_PromNightfilm.txt,709,14,50,343,79,32,21,475
249773_Killifish.txt,901,12,75,321,100,124,38,583
249774_Dollywood.txt,1488,32,46,804,155,61,26,1046
249779_Camberley.txt,1165,23,50,524,137,77,28,766
2498224_MarkFurze.txt,955,13,73,318,176,70,30,594
2498236_PeoplesDemocracy.txt,626,11,56,249,72,33,16,370
2498274_NickRoss.txt,659,11,59,262,82,41,13,398
249844_ListOfSlovenianMathematicians.txt,550,43,12,292,1,17,2,312
249846_ListOfSlovenianLanguagePoets.txt,1247,53,23,598,1,25,1,625
249847_Maracaibo.txt,2067,44,46,881,235,145,44,1305
2500151_EasternProvinceCricketTeamIn197172.txt,773,16,48,263,102,26,26,417
2500164_WesternProvinceCricketTeamIn197172.txt,845,19,44,297,115,32,29,473
2500181_GriqualandWestCricketTeamIn197172.txt,630,16,39,246,74,25,15,360
2500503_1893AtlanticHurricaneSeason.txt,989,30,32,335,117,67,24,543
2503128_ProfessorFinbarrCalamitous.txt,956,11,86,368,133,63,28,592
2503131_EmpressXucheng.txt,969,7,138,333,156,49,42,580
2504158_192728NhlSeason.txt,803,15,53,328,105,32,30,495
250491_Treeplanting.txt,966,15,64,311,164,89,42,606
250493_ParisOrlyAirport.txt,1068,24,44,597,92,60,19,768
250507_IvanMetrovi.txt,1391,23,60,576,140,73,33,822
250514_Koolaid.txt,1702,35,48,627,247,167,60,1101
250515_Landform.txt,571,17,33,299,66,52,18,435
250516_MerHayrenik.txt,547,22,24,224,68,50,17,359
250527_MyBelarusy.txt,1026,21,48,361,154,74,23,612
250534_NationalAnthemOfYemen.txt,588,24,24,355,27,15,4,401
250535_HistoryOfZoologybeforeDarwin.txt,3387,30,112,1000,410,342,135,1887
250537_Anthocyanin.txt,1167,21,55,428,169,106,52,755
250548_FreeLove.txt,3258,42,77,1250,388,306,111,2055
2505924_HildaMorley.txt,577,9,64,217,80,27,13,337
2505975_R33.txt,926,14,66,341,142,46,28,557
2506092_YuhoIwasato.txt,982,18,54,427,101,54,40,622
2506812_UssGettysburg1858.txt,856,15,57,331,116,38,12,497
2506816_TheChristmasSong.txt,1001,16,62,495,95,74,21,685
2507430_VietnameseMartialArts.txt,955,22,43,385,108,92,41,626
2507834_PerkinMedal.txt,603,16,37,376,28,23,2,429
2507851_Wenn.txt,1022,12,85,371,109,92,22,594
2507857_Kmel.txt,1783,31,57,821,196,124,45,1186
2507900_Spritsail.txt,850,10,85,257,129,52,46,484
2508911_IanFreeman.txt,1272,14,90,467,114,64,30,675
2508935_Wwtv.txt,1141,26,43,491,128,86,33,738
250910_Ouija.txt,3173,48,66,1177,475,194,74,1920
250936_RogerNeilson.txt,1215,22,55,462,151,54,36,703
250972_JimmyOlsen.txt,2394,36,66,945,329,151,83,1508
2511160_JaimeGilDeBiedma.txt,692,7,98,227,84,63,31,405
2511207_TheArmyGame.txt,1732,14,123,747,65,29,15,856
2511686_FamousPeopleConnectedWithPrague.txt,617,3,205,261,52,41,16,370
2513630_Cyborgfilm.txt,1328,17,78,453,206,75,44,778
2513744_NissanMotorManufacturingukLtd.txt,2369,59,40,846,369,165,60,1440
2513801_ChristianApologetics.txt,3882,55,70,1664,436,327,126,2553
2514694_UniversalTransverseMercatorCoordinateSystem.txt,1236,21,58,482,159,81,36,758
2515509_Bacchuscomics.txt,987,19,51,454,106,43,27,630
2515529_Transdanubia.txt,898,17,52,371,93,92,25,581
251582_ElephantShrew.txt,575,9,63,231,77,52,25,385
251591_QuarticEquation.txt,2273,85,26,605,338,199,84,1226
251592_GeorgesPompidou.txt,1511,24,62,793,83,51,18,945
251598_Waikato.txt,1005,19,52,457,91,75,30,653
251600_WaikatoRiver.txt,720,21,34,278,96,63,20,457
251626_WinnieEwing.txt,576,10,57,204,74,29,7,314
2516580_AmonDl.txt,890,16,55,394,89,67,27,577
2516583_MiraCostaHighSchool.txt,1664,33,50,882,168,88,35,1173
2516612_Pseudo3d.txt,1095,14,78,338,179,119,59,695
2516627_MinnesotaUnitedStatesSenateElection2006.txt,749,18,41,320,86,49,25,480
2516929_TheClubDumas.txt,3055,34,89,1377,280,135,71,1863
2517981_MikeCarona.txt,632,17,37,286,75,35,13,409
2518850_NationalHighSchoolBaseballChampionship.txt,592,11,53,215,79,33,9,336
2519077_MarquetaliaRepublic.txt,1957,30,65,708,245,154,60,1167
2519528_PlitviceLakesIncident.txt,1052,16,65,395,149,74,38,656
2519601_MarinusVertregt.txt,662,11,60,214,82,54,11,361
252000_MammothMountain.txt,758,11,68,294,86,59,24,463
252067_Merv.txt,2129,28,76,789,261,148,59,1257
2521006_ListOfUniversityOfGeorgiaPeople.txt,1852,17,108,1264,52,84,13,1413
2521009_MissAdventure.txt,4866,76,64,1762,805,257,181,3005
2521458_GtrFiaGtRacingGame.txt,654,12,54,282,78,57,20,437
25215_QuakeIiiArena.txt,6989,99,70,2447,1087,542,298,4374
25217_Qi.txt,1638,30,54,704,171,183,36,1094
25220_QuantumComputer.txt,3721,49,75,1447,480,324,136,2387
25223_Quasigroup.txt,1409,37,38,495,155,86,60,796
2522547_OneworldDestinations.txt,3609,24,150,3377,11,89,0,3477
2523402_WalterHumphriesMontague.txt,757,13,58,269,109,39,21,438
2523849_PresidentialElectionInNewYork1996.txt,808,62,13,250,0,62,0,312
2524276_SteveOwen.txt,760,12,63,246,147,32,20,445
2524316_ByzantineLiterature.txt,9467,78,121,3251,930,1067,385,5633
2524939_FriendlyNeighborhoodSpiderman.txt,724,10,72,246,112,63,40,461
2525698_OdleMiddleSchool.txt,716,16,44,320,70,56,11,457
252670_AbsoluteContinuity.txt,570,22,25,143,63,66,54,326
252671_MikoyanMig31.txt,1669,31,53,536,227,193,60,1016
2526734_CrossCityTunnel.txt,2112,32,66,724,312,146,73,1255
2526736_Lambrettamotorscooter.txt,980,12,81,378,139,72,34,623
252674_Kaaba.txt,1933,35,55,697,257,129,46,1129
252677_CourtneyWalsh.txt,860,13,66,303,97,55,27,482
2526781_Trancers.txt,637,15,42,257,85,34,21,397
2526868_KissMeetsThePhantomOfThePark.txt,1814,23,78,696,259,103,52,1110
252689_LesterMaddox.txt,1738,29,59,580,245,137,56,1018
252690_Lancia.txt,800,13,61,307,93,61,20,481
252696_Saab900.txt,3211,51,62,1118,401,267,102,1888
252701_MisterEd.txt,1128,23,49,417,182,53,43,695
252707_SammiCheng.txt,1850,19,97,717,186,118,62,1083
252712_Safety.txt,1048,15,69,441,147,91,27,706
2527591_OmarPasha.txt,781,9,86,256,106,48,24,434
25280_QuantumTeleportation.txt,2066,86,24,791,287,117,72,1267
2528282_HistoryOfWiltonConnecticut.txt,1278,23,55,461,164,109,42,776
2528289_GrantMitchelleastenders.txt,2388,33,72,821,440,97,96,1454
25284_Qubit.txt,1021,29,35,304,145,79,36,564
25286_Quechua.txt,2317,59,39,896,306,211,84,1497
2530212_BelgradeArena.txt,1009,23,43,403,114,53,27,597
253093_GovernorOfVirginia.txt,889,20,44,304,132,56,32,524
253116_SanFranciscoMunicipalRailway.txt,3366,51,66,1341,403,265,104,2113
2531619_DanielCoburn.txt,1010,16,63,352,195,35,27,609
2531630_ChrisBrownbaseballPlayer.txt,595,10,59,225,72,28,9,334
2531923_JanParandowski.txt,695,11,63,283,63,47,6,399
2533031_ArcWeeklyTop40.txt,1858,52,35,824,143,91,39,1097
2533033_MohammadTaqiMesbahyazdi.txt,1109,17,65,447,151,66,30,694
2533362_NavyOfVenezuela.txt,1146,44,26,629,63,63,14,769
2534455_RedRingRico.txt,1027,14,73,359,146,61,45,611
2534463_Sodepur.txt,751,8,93,366,76,46,19,507
2534580_ScorpionssouthAfrica.txt,634,19,33,247,89,51,13,400
2534581_OperationTridentindopakistaniWar.txt,611,9,67,249,92,26,19,386
2536391_LucaPitti.txt,673,6,112,203,113,44,33,393
253746_BlackJackmanga.txt,2656,33,80,955,384,193,102,1634
253763_GoldenJubilee.txt,583,15,38,259,62,26,6,353
253767_OperationDynamo.txt,1433,21,68,562,157,102,36,857
2537707_AirePointToCarrickDuSssi.txt,1083,22,49,534,142,77,32,785
2537754_QueenSnake.txt,1096,14,78,356,153,94,45,648
253776_AmenhotepIii.txt,2200,23,95,807,269,165,61,1302
253783_NumberOneDime.txt,685,5,137,217,114,35,32,398
2538046_FifteenMinutesOfShame.txt,857,27,31,356,113,41,19,529
2538051_CompasssampleCode.txt,1214,2,607,979,17,8,2,1006
2539633_JosipaLisac.txt,3521,17,207,1271,325,261,124,1981
2539671_TenCommandments.txt,7904,81,97,2520,1081,534,329,4464
2541028_ModiboAdama.txt,2097,34,61,760,291,156,87,1294
2542158_CompendiumOfPostageStampIssuersraRz.txt,1330,156,8,686,32,72,8,798
2542963_TwrchTrwyth.txt,597,17,35,226,88,28,15,357
2544048_1975InBaseball.txt,1711,36,47,833,112,101,18,1064
2544051_Adyaman.txt,660,13,50,237,99,40,19,395
2546547_TheTemptationsWithALotOSoul.txt,877,20,43,447,77,49,29,602
2546665_DavidSahadi.txt,1092,13,84,445,157,54,23,679
2548376_BlueBulls.txt,2189,28,78,757,277,129,73,1236
2548412_StarValley.txt,700,18,38,297,82,42,15,436
2548418_Bosmer.txt,1246,18,69,413,174,95,65,747
254865_EastCapeWar.txt,1663,21,79,611,220,98,80,1009
254867_Voicemail.txt,8022,64,125,3144,1172,591,310,5217
254878_AudioMastering.txt,1913,28,68,620,269,187,105,1181
2548986_Toddpokmon.txt,1363,22,61,434,219,79,78,810
2549462_AndromedamarvelComics.txt,625,10,62,227,80,24,15,346
2549793_KentaKobayashi.txt,2297,27,85,981,253,116,70,1420
2549827_AbramPetrovichGannibal.txt,1166,13,89,437,164,66,26,693
2550665_GreatestLoveOfAll.txt,641,16,40,245,67,66,15,393
255272_WestFlorida.txt,1301,22,59,537,143,68,28,776
255275_AppleIic.txt,3409,50,68,1301,419,341,120,2181
255341_NorwegianLabourParty.txt,578,12,48,212,58,47,16,333
2554109_SimeonSolomon.txt,559,13,43,229,69,33,8,339
2555674_TwicetoldTales.txt,6378,77,82,1713,1010,442,312,3477
2557132_VeteransOfTheFirstWorldWarWhoDiedIn2003.txt,1332,30,44,779,9,17,1,806
2557138_ChiChiLarue.txt,1438,13,110,907,87,63,26,1083
2557160_VeteransOfTheFirstWorldWarWhoDiedIn2001.txt,1500,26,57,918,7,14,2,941
2557599_MyrtlesPlantation.txt,1298,17,76,415,224,52,57,748
2557792_Disraeli.txt,597,18,33,286,35,32,10,363
255932_BuenosAiresProvince.txt,1273,27,47,726,91,93,29,939
255954_DnaMicroarray.txt,1593,33,48,659,240,142,44,1085
255964_MahathirBinMohamad.txt,11431,100,114,4431,1514,741,374,7060
255966_BarBilliards.txt,597,12,49,184,97,35,29,345
255968_HighExplosiveAntitank.txt,1738,18,96,604,251,184,86,1125
255971_DeathInVenice.txt,1757,24,73,581,258,119,80,1038
255979_Lianjiang.txt,644,27,23,328,48,29,5,410
255997_GonzaloSnchezDeLozada.txt,1464,18,81,548,180,141,37,906
255999_StairwayToHeaven.txt,2642,41,64,1024,319,201,85,1629
256003_CerebusTheAardvark.txt,6101,66,92,2281,770,463,247,3761
2560048_SandugoFestival.txt,2483,34,73,1105,233,176,54,1568
256004_MichelleTrachtenberg.txt,511,16,31,211,66,32,12,321
2560052_BarbaraGolemanHighSchool.txt,1116,17,65,432,155,77,28,692
256010_MuskDuck.txt,1094,17,64,334,147,103,89,673
256015_Stairway.txt,3734,40,93,1168,548,330,192,2238
256017_Hepcats.txt,568,10,56,196,80,44,15,335
256024_AbortionInTheUnitedStates.txt,4775,63,75,1654,673,374,189,2890
256026_PermanentRevolution.txt,3408,36,94,1054,460,235,144,1893
2562953_EmperorsOfSoul.txt,1106,20,55,741,48,30,20,839
256344_TrevorMcdonald.txt,768,15,51,294,94,43,22,453
256369_HakeemOlajuwon.txt,4391,47,93,1554,564,298,141,2557
2563739_MirskysWorstOfTheWeb.txt,606,10,60,223,85,54,22,384
2563952_TahitianSandpiper.txt,713,19,37,291,88,50,21,450
256406_ChristopherLloyd.txt,659,12,54,324,34,33,11,402
2564426_IntoTheWoodsbuffyEpisode.txt,786,15,52,236,143,36,29,444
2564821_Zeliard.txt,1935,48,40,642,316,177,87,1222
2566240_Aasiaat.txt,770,17,45,294,98,56,20,468
2566254_SaintIgnatiusCollegeRiverview.txt,3133,57,54,1329,337,145,82,1893
2566535_Leve.txt,1029,13,79,317,157,67,42,583
2567092_Oosterscheldekering.txt,686,13,52,207,112,61,25,405
2568180_JosephfranoisKremer.txt,1252,13,96,609,80,82,25,796
2570536_ManitobaGeneralElection1910.txt,643,102,6,478,21,22,1,522
2570569_BambiyoungOnesEpisode.txt,702,17,41,302,78,32,21,433
257098_Anglonorman.txt,878,12,73,307,103,97,39,546
2572496_TokyoMetropolitanGovernmentBoardOfEducation.txt,864,61,14,815,6,5,5,831
2573580_ReligiousMinistrychristian.txt,667,11,60,254,77,68,24,423
2575000_Wdaftv.txt,1224,26,47,575,127,74,30,806
2575101_LeanderPerez.txt,1510,32,47,636,201,95,36,968
2576518_BattleOfChemulpoBay.txt,1383,18,76,481,217,103,36,837
2576842_GlobalExchange.txt,757,13,58,332,85,54,20,491
2577538_StellaParton.txt,607,8,75,245,76,36,28,385
2579291_AdvancedCrewEscapeSuit.txt,1250,11,113,475,165,73,25,738
2579332_StClairNewSouthWales.txt,851,17,50,400,103,48,21,572
2580162_YouBet.txt,1803,123,14,855,135,52,35,1077
2580877_1stFighterWing.txt,2509,38,66,1124,191,152,28,1495
2581250_NarweeNewSouthWales.txt,1241,17,73,456,194,62,48,760
2581251_CliveCaldwell.txt,902,14,64,324,133,49,26,532
2581260_MeierFrankBuilding.txt,741,13,57,270,90,76,16,452
2581559_CorsetPiercing.txt,823,12,68,264,156,71,44,535
2581903_NovellZenworks.txt,1052,31,33,555,94,55,17,721
2582294_ListOfMennonites.txt,948,8,118,534,60,58,15,667
2583508_WinthropWesternAustralia.txt,695,20,34,299,87,57,14,457
2584867_GinettaCars.txt,929,20,46,342,140,53,30,565
25866_RuthGordon.txt,793,22,36,326,90,52,19,487
2587122_DutchRabbit.txt,772,23,33,240,110,82,40,472
2587127_SimonDee.txt,837,11,76,315,120,41,28,504
25871_CodeRefactoring.txt,1060,23,46,370,166,81,57,674
25873_RelationalDatabase.txt,1902,39,48,550,323,169,100,1142
25874_RuleOfStBenedict.txt,4428,35,126,1466,533,282,164,2445
25875_RheumatoidArthritis.txt,3336,58,57,1164,477,444,151,2236
25876_AnastasiusIemperor.txt,603,11,54,190,81,37,15,323
2587870_HistoryOfWashington.txt,1526,22,69,602,178,121,37,938
25878_RomanMissal.txt,955,11,86,344,110,76,28,558
25879_RogerBacon.txt,2122,34,62,713,297,161,87,1258
2588078_109thUnitedStatesCongress.txt,3737,140,26,2675,49,67,8,2799
2588079_GuardRail.txt,700,16,43,226,106,66,24,422
25880_RefractiveIndex.txt,1482,37,40,457,202,178,66,903
25882_RomanKingdom.txt,3848,50,76,1307,534,236,126,2203
2588869_LegacystargateSg1.txt,614,11,55,181,99,41,31,352
2590001_QueenValentina.txt,685,21,32,230,106,42,33,411
25901_RobertoClemente.txt,2434,30,81,896,315,132,65,1408
2590288_RoystonMaldoom.txt,564,11,51,259,56,43,14,372
2590330_MamasBoys.txt,858,12,71,342,114,57,22,535
2590334_Metaphysicsaristotle.txt,1779,17,104,564,247,153,95,1059
25908_RangeVoting.txt,1754,28,62,598,251,153,58,1060
25912_TheRenAndStimpyShow.txt,5002,81,61,2074,631,316,205,3226
25913_Rtype.txt,2148,51,42,676,295,179,87,1237
2591494_ListOfMountainsOfNewZealandByHeight.txt,935,7,133,513,5,28,1,547
25914_ReinhardHeydrich.txt,3553,55,64,1356,473,214,129,2172
25915_Ralism.txt,2166,55,39,682,312,217,92,1303
25916_RomanticMusic.txt,3173,46,68,1107,388,390,121,2006
2592221_ChristinaMoore.txt,583,11,53,302,45,26,2,375
259244_BarHarbortownMaine.txt,959,15,63,415,113,51,13,592
259264_WiscassettownMaine.txt,749,13,57,266,92,41,15,414
259270_MexicotownMaine.txt,633,11,57,203,72,45,13,333
259276_RumfordtownMaine.txt,918,16,57,340,105,59,23,527
2593291_Bioforge.txt,1758,32,54,597,269,136,82,1084
2594648_GeorgKeppler.txt,791,12,65,336,83,43,11,473
2594654_WilfredTheHairy.txt,2501,44,56,963,297,121,77,1458
2594662_CharlesRowan.txt,1107,11,100,388,158,61,28,635
2595727_HomerVsPattySelma.txt,715,12,59,225,127,35,26,413
259682_ElmiratownNewYork.txt,671,16,41,238,61,28,4,331
259683_ElmiraNewYork.txt,2828,59,47,1182,323,129,48,1682
259685_HorseheadstownNewYork.txt,714,17,42,259,74,38,6,377
259688_SouthportNewYork.txt,652,12,54,236,64,26,3,329
259690_VanEttentownNewYork.txt,594,13,45,212,63,23,4,302
2597429_BritishSmallPressComics.txt,2468,66,37,1000,313,264,73,1650
259750_FishkilltownNewYork.txt,779,16,48,295,77,33,7,412
259752_PawlingtownNewYork.txt,861,14,61,359,77,42,9,487
259754_PinePlainstownNewYork.txt,584,12,48,202,64,30,4,300
2597718_1997ThredboLandslide.txt,1043,30,34,366,175,64,23,628
2599531_HawkeyeMihawk.txt,1215,23,52,372,199,85,71,727
2600635_WeddingVideography.txt,1275,24,53,420,197,109,61,787
2601793_BurtonGarranHall.txt,928,35,26,455,77,45,12,589
2601805_JohnBeecher.txt,626,9,69,308,64,20,10,402
2601806_TenjikuShogi.txt,2650,78,33,873,417,184,106,1580
2602113_LearningKanji.txt,592,9,65,257,70,55,31,413
2603212_195859NhlSeason.txt,905,16,56,367,111,51,20,549
260356_PrairieDuChienWisconsin.txt,1877,26,72,748,201,121,42,1112
2605127_SamawalIbnadiya.txt,825,8,103,306,118,41,19,484
2605136_JakobPiil.txt,646,8,80,231,69,40,25,365
2607261_ListOfInternetSlangPhrases.txt,1876,54,34,857,155,93,70,1175
2608418_AlanMooresTheCourtyard.txt,559,21,26,256,55,27,16,354
2611302_OnceUponAForest.txt,906,23,39,339,113,55,40,547
2612804_ElectronBubble.txt,633,14,45,243,76,48,26,393
2613497_Paycheckfilm.txt,854,16,53,338,102,40,32,512
2613851_DnaBarcoding.txt,1721,29,59,668,230,145,75,1118
2613854_North24ParganasDistrict.txt,441,52,8,249,17,16,3,285
261407_PlasmaCosmology.txt,2004,23,87,708,265,240,77,1290
261440_KemalDervi.txt,786,12,65,322,79,55,11,467
261441_Yantai.txt,1235,35,35,508,130,101,31,770
261444_ZhifuIsland.txt,570,11,51,245,62,29,12,348
261447_WilliamDunbar.txt,1259,15,83,442,152,96,32,722
261450_PlatonicEpistemology.txt,1112,14,79,327,148,98,54,627
261452_GeorgeColley.txt,1197,17,70,413,163,59,36,671
2614588_ShorehamAirport.txt,591,20,29,263,71,47,12,393
261463_Tilia.txt,1271,20,63,527,155,99,57,838
261479_Quipu.txt,1650,23,71,609,243,113,55,1020
2615204_LucienLison.txt,753,10,75,307,80,61,21,469
2615278_VillainsOfPugadBaboy.txt,1219,2,609,508,174,65,33,780
2617126_GetRichOrDieTryin2005Film.txt,2359,32,73,736,395,146,97,1374
2617175_NarutoUltimateNinja.txt,1088,24,45,620,92,43,22,777
2617867_Fallin.txt,1000,12,83,383,135,76,39,633
2617868_ValveAnticheat.txt,1231,19,64,392,227,88,67,774
2618530_Jamaatulmuslimeen.txt,804,18,44,313,102,54,34,503
2618531_DysonPerrins.txt,580,11,52,237,63,33,11,344
2618553_Diz.txt,904,11,82,301,160,28,32,521
261871_GaulishLanguage.txt,1609,36,44,668,208,135,48,1059
261908_GilHodges.txt,3096,22,140,1041,367,206,96,1710
2619281_NitinSawhney.txt,981,26,37,506,95,54,13,668
2620374_CantoneseGrammar.txt,475,22,21,143,89,37,33,302
2620499_GermanUnitsOfMeasurement.txt,932,27,34,353,59,73,26,511
2620502_NorwegianUnitsOfMeasurement.txt,633,10,63,264,49,35,13,361
2621344_BlackFriday1921.txt,651,8,81,233,93,36,16,378
2621562_FreeAtLastfreeAlbum.txt,1144,20,57,376,147,103,60,686
2622853_Beemythology.txt,797,10,79,293,101,64,32,490
2622893_AbdullaMajidAlNaimi.txt,910,22,41,346,143,23,37,549
2622904_VirtualConsole.txt,1668,30,55,646,241,97,65,1049
262515_SimonFuller.txt,668,14,47,257,84,27,26,394
262533_RichardDeanAnderson.txt,824,22,37,310,105,52,33,500
262536_JadeGoody.txt,2762,43,64,998,443,146,89,1676
262540_MccarranInternationalAirport.txt,2047,37,55,1173,196,114,31,1514
262542_AustinbergstromInternationalAirport.txt,988,20,49,467,98,60,12,637
262544_Marshal.txt,1368,15,91,581,170,110,58,919
262559_PhiladelphiaInternationalAirport.txt,1707,32,53,961,155,95,21,1232
262573_CardiacTamponade.txt,756,14,54,275,98,84,39,496
2625907_Contactor.txt,930,19,48,341,152,94,32,619
2627242_AgincourtCollegiateInstitute.txt,1132,27,41,605,102,87,16,810
2627309_Cyanotic.txt,577,14,41,305,48,57,7,417
2629164_MarkHildrethactor.txt,625,7,89,331,22,13,9,375
262964_KevinBoland.txt,852,11,77,279,119,58,33,489
26301_Rocket.txt,3629,66,54,1397,453,328,135,2313
26308_RudyardKipling.txt,6592,74,89,2285,892,453,260,3890
26309_RegencyDance.txt,1067,15,71,368,133,99,41,641
26310_BiologicalReproduction.txt,1731,36,48,589,221,211,78,1099
26311_WorksOfRudyardKipling.txt,1994,5,398,1160,13,89,10,1272
2631596_HistoryOfHipHopMusic.txt,3357,50,67,1390,351,306,125,2172
2631597_BobHopeChryslerClassic.txt,1463,25,58,570,125,71,36,802
2632037_TaxationInIndonesia.txt,1443,41,35,637,170,117,22,946
2633512_Guildpact.txt,1214,24,50,425,163,94,43,725
2633597_PonipateLesavua.txt,773,15,51,268,129,40,21,458
2633607_AseselaRavuvu.txt,726,12,60,231,115,52,22,420
2634270_AnthonyBennettenglishPolitician.txt,1278,24,53,506,157,66,25,754
2634592_JuliusEastman.txt,895,10,89,405,69,52,21,547
2634917_Circumscription.txt,2572,61,42,737,424,210,134,1505
2634919_HealthCareInJapan.txt,809,13,62,278,113,104,23,518
263588_DeathRowRecords.txt,3170,42,75,1359,473,152,105,2089
263611_MontralpierreElliottTrudeauInternationalAirport.txt,2289,42,54,1136,227,182,42,1587
263613_JacquesBarzun.txt,1046,12,87,441,86,62,22,611
263616_MinneapolissaintPaulInternationalAirport.txt,2128,27,78,1180,192,139,31,1542
263622_TeodoroObiangNguemaMbasogo.txt,1037,30,34,349,150,95,33,627
263623_RadicalBehaviorism.txt,1755,38,46,618,249,196,81,1144
263625_InternationalFolkDance.txt,603,9,67,239,75,56,28,398
263633_ListOfTransportMuseums.txt,1269,37,34,984,25,38,7,1054
263636_Connectionism.txt,2180,35,62,837,287,181,93,1398
263637_OrlandoInternationalAirport.txt,1263,19,66,717,105,75,20,917
263638_MemphisInternationalAirport.txt,690,14,49,455,49,24,8,536
263667_Tarkan.txt,1166,30,38,483,147,68,24,722
26368_RichardIOfEngland.txt,6655,60,110,2478,980,314,232,4004
263692_GhostWorldfilm.txt,1294,12,107,470,170,82,46,768
2637940_Hayle.txt,2867,44,65,987,431,199,103,1720
2637941_JohnPerryphilosopher.txt,673,13,51,336,41,30,11,418
2638285_CardSecurityCode.txt,815,13,62,275,131,46,47,499
2638679_ShamShuiPoDistrict.txt,586,18,32,313,49,44,17,423
2638733_Kamaitachi.txt,658,24,27,250,93,39,16,398
2640139_TroyBayliss.txt,1231,15,82,381,184,99,57,721
264015_Electrocomics.txt,2136,31,68,725,346,151,94,1316
264017_Cracidae.txt,870,16,54,466,76,86,21,649
2640370_YuriyYekhanurov.txt,819,12,68,326,108,37,26,497
2640407_Medlar.txt,779,17,45,266,103,74,43,486
2642659_SethuramaIyerCbi.txt,713,8,89,275,110,33,19,437
2643692_LordOfWar.txt,2641,27,97,990,395,147,111,1643
2643755_CarburetorHeat.txt,704,9,78,216,115,46,46,423
2644433_Zeroexe.txt,641,13,49,236,98,28,20,382
2644439_SwamiRamdev.txt,1552,27,57,603,236,97,32,968
2644584_BattleOfHayesPond.txt,1086,10,108,469,123,53,30,675
2644585_Enforcerscomics.txt,594,10,59,208,84,44,29,365
2645453_CityLightsPocketPoetsSeries.txt,534,5,106,355,19,17,2,393
2645512_Skydiver.txt,959,16,59,302,163,64,55,584
2645522_HikariSentaiMaskman.txt,3872,41,94,1609,453,154,83,2299
2645524_CaringbahHighSchool.txt,868,35,24,325,124,72,29,550
2645657_EllisRKerley.txt,599,7,85,234,79,25,18,356
2645668_PrehistoryOfAustralia.txt,1683,22,76,569,236,174,72,1051
2647006_SenecaLakeWineTrail.txt,788,15,52,335,109,44,14,502
2647021_ListOfBritishTownsWithNoRailwayStation.txt,658,14,47,413,50,27,13,503
264748_UnsaturatedFat.txt,604,13,46,203,104,87,26,420
264756_PeninsulaCampaign.txt,2762,26,106,1227,342,125,87,1781
264762_ListOfSoftwareEngineeringTopics.txt,2121,37,57,1469,131,114,27,1741
264779_AnalogHole.txt,1480,25,59,502,232,140,59,933
264782_WhitecollarCrime.txt,1600,8,200,627,171,179,64,1041
264783_JohnCheke.txt,817,9,90,308,102,32,26,468
2648004_HyundaiGrandeur.txt,636,19,33,263,72,49,9,393
2648009_InsurrectionAct.txt,2451,45,54,885,280,221,90,1476
2648055_JohnUDPage.txt,639,4,159,257,86,29,16,388
264805_HaroldHorwood.txt,599,12,49,237,64,27,16,344
2648087_NicHypolite.txt,645,2,322,289,46,25,25,385
2648839_QuantumCascadeLaser.txt,704,13,54,271,90,70,19,450
2650011_JeanlouisLefebvreDeCheverus.txt,781,9,86,259,107,49,30,445
2650691_JointTaskForceglobalNetworkOperations.txt,794,11,72,439,54,38,7,538
265105_NewYorkCourtOfAppeals.txt,905,10,90,506,70,34,15,625
265142_HistoryOfTheSovietUnion19531985.txt,3414,56,60,1203,451,343,144,2141
265143_RedDawn.txt,4675,70,66,1600,716,327,157,2800
265164_JohnDrake.txt,763,8,95,239,131,56,48,474
2652260_StarCinema.txt,5184,140,37,2372,620,286,160,3438
2652438_Trimulgherry.txt,638,23,27,271,71,47,21,410
2654342_GeoffStrong.txt,799,17,47,277,102,59,26,464
2655103_TricalciumPhosphate.txt,479,43,11,211,56,44,19,330
2657664_AfterManAZoologyOfTheFuture.txt,2344,4,586,865,272,291,47,1475
2658000_StreetArt.txt,689,9,76,349,73,60,27,509
2658052_ListOfMcmasterUniversityPeople.txt,1867,13,143,1105,29,170,2,1306
265811_LockheedL2000.txt,1906,17,112,605,283,193,70,1151
2658437_AlpineSkiingAtThe2006WinterOlympics.txt,1346,22,61,552,175,76,36,839
265848_TupolevTu16.txt,1383,22,62,509,152,129,25,815
2658630_LeviStewart.txt,855,20,42,359,107,39,11,516
265868_MahadevDesai.txt,3205,26,123,1039,504,151,125,1819
265891_TheGreatRace.txt,1212,17,71,487,145,89,32,753
265893_BlankVerse.txt,1571,26,60,596,170,147,62,975
2659141_Modinagar.txt,576,14,41,257,73,30,24,384
2659918_PowerMosfet.txt,2594,55,47,898,357,253,81,1589
2659956_TheDistortedViewShow.txt,1092,26,42,494,130,83,38,745
2662387_Gyrobus.txt,1102,18,61,327,189,81,54,651
2662403_UryIshida.txt,3672,42,87,1200,605,235,174,2214
266313_KingsfordSmithInternationalAirport.txt,1192,23,51,631,117,83,37,868
266344_SpaceDebris.txt,1350,26,51,515,193,109,45,862
2664310_SimonGruber.txt,747,6,124,262,123,24,26,435
2664311_ResultsOfTheJapaneseGeneralElection2005.txt,1109,32,34,461,119,72,25,677
2664320_AlexArrowsmith.txt,1425,22,64,735,123,89,49,996
2665280_LittleBigStar.txt,554,18,30,284,42,31,14,371
2666722_GoldenArcher.txt,645,10,64,249,97,32,20,398
2666733_SonyEricssonW800.txt,646,10,64,273,75,38,21,407
2666735_YusupovFamily.txt,1108,12,92,443,127,60,22,652
2667131_908thAirliftWing.txt,759,16,47,317,83,36,17,453
2667812_JohnSerrySr.txt,2355,29,81,1105,154,148,18,1425
2667815_MichaelDawsonlost.txt,1934,19,101,585,341,89,101,1116
2667832_MountainBikeRacing.txt,1068,7,152,455,129,77,47,708
2668642_PanglimaLat.txt,1253,15,83,502,166,119,66,853
2668748_AbigailabbySciuto.txt,633,10,63,225,98,43,27,393
266899_ThirdEye.txt,1591,30,53,546,212,161,56,975
266940_Capiz.txt,1294,29,44,507,198,79,26,810
266946_RichmondInternationalAirport.txt,760,16,47,385,85,52,11,533
266955_RaleighdurhamInternationalAirport.txt,2413,33,73,1237,265,141,45,1688
2669755_ViennaConventionOnCivilLiabilityForNuclearDamage.txt,788,8,98,313,84,55,18,470
2669783_AlanFletchergraphicDesigner.txt,730,14,52,287,84,33,18,422
266982_BillySunday.txt,4312,58,74,1590,578,307,195,2670
2671100_LutzRathenow.txt,919,9,102,457,83,60,9,609
2672171_AncientEgyptianArchitecture.txt,1258,20,62,457,167,106,39,769
2672176_Pehlwani.txt,1960,31,63,889,253,132,57,1331
267346_LevanteUd.txt,899,20,44,349,106,40,33,528
267366_MaunaKea.txt,690,11,62,266,82,58,24,430
267370_Alligator.txt,1054,19,55,338,162,94,54,648
2673910_ArmeniansInEgypt.txt,1821,25,72,738,177,155,34,1104
2674117_WildernessAct.txt,614,12,51,249,87,55,12,403
2674118_Hp9800SeriesDesktopComputers.txt,1046,26,40,379,122,101,36,638
2675465_1979IccTrophy.txt,1726,28,61,571,220,112,59,962
2675516_Paithani.txt,2328,29,80,825,405,140,87,1457
2676910_BulgarianLiterature.txt,756,12,63,287,90,85,17,479
2677435_InvestigationIntoTheBombingOfPanAmFlight103.txt,3975,44,90,1436,602,204,96,2338
2677473_MutyaBuena.txt,647,11,58,266,97,36,16,415
267995_MeyersKonversationslexikon.txt,630,17,37,208,104,57,21,390
2680305_SampleReturnMission.txt,1295,25,51,473,184,118,49,824
268031_Zhuhai.txt,1066,21,50,462,110,109,12,693
268042_AmericanAstronomicalSociety.txt,657,19,34,302,50,68,11,431
268043_TiomanIsland.txt,846,16,52,310,128,70,24,532
2680620_ParameterizedPostnewtonianFormalism.txt,1252,46,27,433,130,135,36,734
268067_HironobuSakaguchi.txt,786,12,65,357,84,35,26,502
268071_BulgarianLev.txt,596,17,35,212,71,32,10,325
2680899_TheNewDinosaursAnAlternativeEvolution.txt,1148,6,191,566,117,115,19,817
2681729_ListOfVideoGamesFeaturingZombies.txt,2047,12,170,785,260,184,55,1284
2684075_HolkerHall.txt,743,9,82,256,97,60,20,433
2684226_Tifamusician.txt,1537,24,64,513,221,104,104,942
2684230_OneFlewOverTheCuckoosNestfilm.txt,1787,31,57,626,280,90,68,1064
2685154_DarkMatterkirby.txt,1224,19,64,396,186,68,54,704
268516_Incoterm.txt,676,6,112,304,84,31,14,433
2686058_ListOfFuturesExchanges.txt,504,39,12,401,10,10,5,426
2686203_Coffeemaker.txt,1144,12,95,390,172,115,31,708
2687902_Phogat.txt,661,11,60,342,76,20,16,454
2689320_MysteryPlayOfElx.txt,1312,29,45,425,142,101,35,703
2689442_UssMcdougaldd358.txt,683,11,62,306,63,27,4,400
2690511_CentrevilleHighSchoolvirginia.txt,1526,39,39,705,168,95,48,1016
2690551_CylinderSeal.txt,883,13,67,423,69,62,19,573
2690828_Glynn.txt,1187,20,59,451,171,65,40,727
2690850_MensStudies.txt,1336,10,133,773,77,64,31,945
2691427_SsSchiller.txt,850,14,60,269,131,45,30,475
269152_Ogopogo.txt,905,20,45,331,137,69,33,570
2691879_LiberalprogressiveCandidates1953ManitobaProvincialElection.txt,2972,124,23,1206,324,252,34,1816
2693655_MorsekelleySetTheory.txt,1561,27,57,535,220,102,78,935
2694890_ModRevival.txt,659,10,65,290,63,59,26,438
26950_RepublicsOfTheSovietUnion.txt,1085,14,77,407,120,81,26,634
26951_Scleroderma.txt,1855,45,41,635,286,225,83,1229
2695247_GregMortenson.txt,662,17,38,329,69,27,9,434
26952_SlaveNarrative.txt,1262,24,52,558,94,76,28,756
26954_StephenKing.txt,5451,91,59,1969,812,358,196,3335
2695571_StGeorgeReefLight.txt,699,10,69,257,93,61,19,430
26955_Spartacus.txt,2074,31,66,839,281,129,64,1313
26956_SilentFilm.txt,2569,35,73,1125,274,163,95,1657
269602_FriedrichAdolfRiedesel.txt,618,12,51,231,79,25,17,352
26961_ShiaIslam.txt,5107,86,59,2063,622,293,162,3140
2696275_LovozeroTundras.txt,343,8,42,141,29,13,6,189
2696278_Ystterskajsa.txt,992,12,82,231,169,80,55,535
2696281_Godaraclan.txt,912,17,53,309,106,43,22,480
2696287_Phwonline.txt,1034,21,49,396,131,88,52,667
26962_SpecialRelativity.txt,6467,184,35,2126,820,626,223,3795
2696335_ArcTrooperA17.txt,636,10,63,206,108,40,30,384
26964_SaintPetersburg.txt,6003,89,67,2380,662,461,165,3668
26968_Saab.txt,630,13,48,248,78,47,17,390
26970_kodaAuto.txt,1961,39,50,673,223,132,70,1098
26973_SanFranciscoBay.txt,1884,26,72,774,208,155,57,1194
26976_SiliconValley.txt,2572,36,71,1146,292,168,79,1685
26985_Salinity.txt,738,13,56,243,104,55,47,449
26988_Cli.txt,734,10,73,296,90,58,39,483
2699552_ShivaLaser.txt,1126,17,66,389,161,82,45,677
26995_Shire.txt,779,19,41,357,90,59,45,551
2699663_MilitaryStructureOfTheFarcep.txt,4713,65,72,1619,583,458,161,2821
26997_Scientist.txt,954,20,47,394,124,92,34,644
27000_Smog.txt,1280,28,45,482,175,111,51,819
27001_Smoke.txt,849,17,49,387,99,88,31,605
27002_SmokingPipetobacco.txt,2536,36,70,774,442,233,153,1602
2700693_TheBigEasyfilm.txt,1096,30,36,478,131,61,38,708
27006_Serendipity.txt,3976,46,86,1468,576,299,126,2469
27008_Ship.txt,2985,26,114,1220,360,274,109,1963
270160_Cobelligerence.txt,806,10,80,288,87,83,33,491
270213_LinkFarm.txt,791,16,49,353,119,55,30,557
2702617_GustaveThuret.txt,611,9,67,190,82,49,17,338
2703306_OmarAmiralay.txt,627,10,62,294,45,44,6,389
2704403_ListOfRadioStationsInSouthCarolinaByFrequency.txt,704,4,176,529,4,7,0,540
2704841_AirPreheater.txt,1448,25,57,516,213,104,46,879
2705000_BrooklynCommunityBoard.txt,1024,19,53,545,54,48,18,665
2705010_StockFund.txt,837,17,49,365,102,60,25,552
2705052_56thPrimetimeEmmyAwards.txt,678,15,45,483,9,9,0,501
270634_Dhammapada.txt,854,11,77,514,61,22,14,611
2706927_SilverDollarCity.txt,1352,20,67,596,167,66,40,869
2706950_EthanEdwards.txt,599,11,54,201,104,36,18,359
2707303_CuttingAgent.txt,896,14,64,256,152,75,59,542
2709073_PeterVanPels.txt,674,9,74,220,102,36,14,372
2709210_GreatSeatheLegendOfZeldaSeries.txt,1279,24,53,408,194,102,61,765
2710162_LeatriceJoy.txt,603,9,67,257,69,52,18,396
2711613_P2ptv.txt,586,12,48,244,86,49,24,403
271261_DavidKelly.txt,3191,46,69,1085,524,162,137,1908
271275_JimBroadbent.txt,639,11,58,294,53,28,9,384
2713114_HeinsLafarge.txt,1038,13,79,445,114,61,28,648
2713407_JeanbaptisteKelly.txt,1909,27,70,616,287,141,108,1152
2713415_EthnicGroupsInThePhilippines.txt,3351,61,54,1101,443,340,144,2028
2713568_LeeHarding.txt,688,12,57,306,80,36,20,442
2714509_DarrylBrohman.txt,935,16,58,337,134,65,36,572
2714990_ApplicationsOfRandomness.txt,1891,42,45,660,280,197,104,1241
2716071_HistoryOfVojvodina.txt,4378,53,82,1862,448,261,89,2660
2717051_ChicagoSky.txt,579,20,28,248,57,42,8,355
271723_OffbyoneError.txt,578,16,36,161,88,46,29,324
2717447_LocalElection.txt,563,9,62,182,68,68,33,351
2717904_BalefirebookSeries.txt,1131,19,59,354,185,67,44,650
2717905_TheBenchwarmers.txt,1370,15,91,632,156,52,32,872
2718987_CertificationOfVotingMachines.txt,715,13,55,335,80,41,12,468
2721160_EnricoCarusoRecordings.txt,3853,88,43,3083,148,97,71,3399
2721573_NorfolkSouthernRailwayformer.txt,1774,19,93,832,165,66,35,1098
2723075_Sancerre.txt,1070,16,66,448,111,64,11,634
2724018_IslamInGreece.txt,664,21,31,242,71,61,22,396
2725864_FrankBiela.txt,667,9,74,259,80,42,17,398
2725956_CaningInSingapore.txt,999,14,71,329,166,84,23,602
2726256_MatthewKing.txt,699,19,36,244,130,29,32,435
2726955_RaymondChing.txt,932,12,77,343,145,56,33,577
2727429_Ieee80211s.txt,604,13,46,264,78,31,11,384
2728186_Kibera.txt,737,13,56,297,103,59,30,489
2728350_WeakFormAndStrongForm.txt,573,9,63,129,98,72,25,324
2728830_ConstableOfTheTower.txt,958,15,63,425,78,36,12,551
2729183_ThomasAndFriendsSeason3.txt,3710,57,65,1458,581,161,157,2357
2730279_ThomasAndFriendsSeason9.txt,3850,59,65,1418,641,163,170,2392
2730291_NeilRJones.txt,1128,12,94,588,89,40,31,748
2731719_DragonPink.txt,1394,17,82,463,219,96,55,833
2732716_CliffMorgan.txt,806,10,80,287,99,62,22,470
2732753_Wtcnca.txt,558,13,42,251,57,24,10,342
2734636_WayneFontes.txt,639,11,58,255,84,32,18,389
2734675_PhiladelphiaMint.txt,950,18,52,322,155,79,27,583
273476_JonnyGreenwood.txt,2079,23,90,883,262,135,73,1353
273478_ChattahoocheeRiver.txt,610,11,55,294,54,34,18,400
273524_LinearParticleAccelerator.txt,1075,13,82,388,164,87,37,676
273529_ParodyMass.txt,605,7,86,226,75,50,20,371
273555_ConsumerElectronicsShow.txt,718,19,37,333,67,38,13,451
273557_JohannesOckeghem.txt,1115,23,48,465,123,83,36,707
2736045_Goumier.txt,1616,29,55,604,202,135,48,989
2736079_200304NbaSeason.txt,656,8,82,395,40,32,9,476
2736489_RichardWilliamTimm.txt,889,34,26,400,85,46,25,556
2738007_ClassicalElementsInPopularCulture.txt,2505,10,250,1085,281,193,71,1630
273854_Telomerase.txt,2292,26,88,865,361,176,86,1488
273860_Colonyalbum.txt,499,14,35,247,47,33,5,332
27390_GeographyOfSpain.txt,2917,51,57,1210,224,264,74,1772
27391_DemographicsOfSpain.txt,962,34,28,366,70,120,20,576
27392_PoliticsOfSpain.txt,3364,63,53,1278,404,267,68,2017
27393_EconomyOfSpain.txt,1015,42,24,404,89,87,28,608
27397_ForeignRelationsOfSpain.txt,1063,18,59,429,115,100,38,682
27401_SpratlyIslands.txt,3652,39,93,1466,447,242,98,2253
2740395_TheBirminghamNews.txt,776,13,59,271,98,65,16,450
2740521_OsuTatakaeOuendan.txt,1445,25,57,569,180,108,46,903
2742275_Wgbn.txt,1109,17,65,469,134,84,26,713
2742363_PoundHug.txt,577,12,48,180,83,54,37,354
2744933_VivHope.txt,783,17,46,253,157,38,34,482
2745590_UqbaIbnNafi.txt,824,10,82,275,123,42,24,464
27455_PoliticsOfSwaziland.txt,1570,22,71,562,216,116,58,952
274562_NineLessonsAndCarols.txt,612,12,51,304,59,26,15,404
274564_LoveHinaPlotSummaries.txt,4627,56,82,1460,737,242,246,2685
27456_EconomyOfSwaziland.txt,868,20,43,355,100,77,30,562
274608_Proana.txt,1066,16,66,381,170,92,40,683
27461_HistoryOfSwitzerland.txt,2340,43,54,845,275,159,68,1347
274621_ListOfIndiarelatedTopics.txt,13210,37,357,7450,30,159,2,7641
2746684_NorwegianOrderOfPrecedence.txt,687,9,76,404,20,27,3,454
2748052_Huike.txt,1355,33,41,522,194,86,33,835
2748064_1966InBaseball.txt,556,17,32,311,28,27,6,372
2748258_1961InBaseball.txt,1114,12,92,564,73,56,6,699
2749117_DanielLevitin.txt,2070,19,108,1117,136,96,21,1370
2749163_NuevaVizcayaNewSpain.txt,1634,8,204,580,215,98,59,952
274942_HistoryOfTheUnitedStatesNavy.txt,3761,82,45,1299,519,270,139,2227
274945_PrinceOfDarkness.txt,709,6,118,545,22,9,8,584
274947_Wxwidgets.txt,786,15,52,378,81,66,15,540
2749598_SpiderwomanjessicaDrew.txt,2686,43,62,920,437,213,96,1666
2750004_ListOfWarioSeriesEnemies.txt,2432,66,36,809,366,154,94,1423
275009_CultureOfTheUnitedKingdom.txt,6548,125,52,2532,792,691,240,4255
275014_Sanchi.txt,872,21,41,317,118,62,18,515
275068_LegioIiAugusta.txt,630,15,42,282,54,24,22,382
2751585_AnselmOfLucca.txt,608,7,86,254,69,29,12,364
2753501_ShutoKousokuTrial.txt,1256,17,73,507,197,62,45,811
2754019_FrontProjectionEffect.txt,734,11,66,260,107,49,41,457
2754386_LangLabor.txt,586,9,65,238,79,34,10,361
275691_BenjaminStoddert.txt,576,10,57,204,72,37,19,332
275704_CertificationMark.txt,949,16,59,420,120,53,31,624
275707_HorseracingInAustralia.txt,1050,35,30,495,130,72,25,722
275724_DigitalRadio.txt,1618,26,62,664,249,158,40,1111
2757266_ListOfLawOrderCriminalIntentEpisodes.txt,976,12,81,320,16,70,4,410
275735_Shackle.txt,814,17,47,277,129,55,32,493
2758790_BradfordInterchangeRailwayStation.txt,908,23,39,403,100,62,32,597
2758794_QihuaPrimarySchool.txt,631,8,78,255,82,46,11,394
2760082_DroylsdenFc.txt,695,17,40,277,74,43,18,412
2763141_OfficialRecordsOfTheAmericanCivilWar.txt,764,13,58,312,81,46,29,468
2763147_AozoraNoNamida.txt,628,14,44,263,66,33,15,377
2763451_Hypostasisreligion.txt,724,6,120,242,103,31,34,410
2766365_LeatherArchivesAndMuseum.txt,732,14,52,329,76,52,12,469
276741_MediumdensityFibreboard.txt,695,22,31,247,136,42,28,453
276748_Zuni.txt,1893,24,78,892,179,114,53,1238
2767502_VictorEMarsden.txt,1817,37,49,726,207,94,52,1079
2767514_StefanoFiore.txt,842,9,93,291,111,53,39,494
2767517_RashaunWoods.txt,577,5,115,228,63,38,12,341
2767911_YodelinSlimClark.txt,732,12,61,303,79,43,12,437
276820_SimonKuznets.txt,1022,16,63,363,113,107,24,607
2768873_RugbyLeagueStateOfOriginResultsAndStatistics.txt,672,27,24,351,59,19,13,442
2768901_IfYouHadMyLove.txt,715,12,59,272,93,44,27,436
2768921_RaceX.txt,1468,25,58,468,231,133,70,902
2768928_200506A1GrandPrixOfNationsGermany.txt,1529,21,72,557,198,125,50,930
2769352_JapanesePainting.txt,645,5,129,205,80,97,22,404
2769735_GetRight.txt,764,17,44,375,81,45,32,533
2769746_RollsroyceSilverGhost.txt,671,11,61,223,89,53,21,386
2769747_GailCarsonLevine.txt,591,11,53,234,76,37,14,361
2770842_Eventphilosophy.txt,877,16,54,258,136,92,40,526
2770849_AutoMechanic.txt,880,15,58,278,129,111,44,562
277182_PhonologicalHistoryOfEnglishLowBackVowels.txt,1233,21,58,428,140,103,49,720
277183_JanuszGajos.txt,589,6,98,348,14,18,7,387
277184_MathematicalNotation.txt,1131,19,59,407,136,121,44,708
277213_CoherentState.txt,1633,43,37,564,206,140,79,989
277274_HenriGiraud.txt,1046,15,69,378,158,58,24,618
2773710_HealthcareInIndia.txt,1365,17,80,462,151,178,30,821
2774105_PersianPopMusic.txt,710,20,35,333,74,63,30,500
2774115_SwordOfXuanYuan.txt,2790,44,63,1012,382,213,104,1711
2776513_GeographyOfSheffield.txt,1781,28,63,656,184,148,72,1060
2776711_UssDeHavendd727.txt,861,17,50,364,99,31,10,504
2777609_HistoryOfCapitalism.txt,1868,30,62,649,219,189,61,1118
2778126_AntoineDeMontchrestien.txt,778,13,59,270,123,63,22,478
277824_Hysteriaalbum.txt,1428,24,59,610,159,92,48,909
277825_Tarantella.txt,941,11,85,342,150,72,46,610
277827_Adrenalize.txt,681,15,45,312,88,36,21,457
277829_SidAbel.txt,400,10,40,186,21,8,1,216
277833_BrazilianWanderingSpider.txt,943,18,52,321,128,78,66,593
277835_PerryComo.txt,2607,34,76,953,332,169,124,1578
2778442_SanjayMalhotra.txt,789,15,52,303,120,56,26,505
277872_Macys.txt,3191,36,88,1375,365,206,98,2044
277876_Stiltoncheese.txt,566,11,51,173,106,51,28,358
277905_LouisianaStateUniversity.txt,1871,35,53,868,205,122,37,1232
2780872_KyleEastwood.txt,920,13,70,379,112,48,24,563
2780877_SasSoccerPark.txt,649,13,49,357,43,28,10,438
2781077_AnthonyWilliamscomics.txt,737,25,29,384,26,28,4,442
2781767_EmpressDouzhang.txt,1302,14,93,478,202,69,70,819
2781791_ProvidenceDaySchool.txt,647,16,40,304,88,34,4,430
2782423_OngSohKhim.txt,579,19,30,264,56,34,7,361
2783221_YekaterinaLobaznyuk.txt,1093,18,60,374,143,68,42,627
2784287_ButtJoint.txt,1656,38,43,535,313,128,75,1051
2784322_EnterTheRatKing.txt,707,13,54,267,103,20,21,411
2784324_GunnarNelson.txt,1153,37,31,468,146,62,39,715
2785742_AlAvison.txt,790,10,79,438,42,28,10,518
2786210_CallCapture.txt,597,10,59,233,79,35,21,368
2787569_IrishFlute.txt,644,12,53,274,76,65,31,446
2788558_Kharkiv.txt,983,25,39,399,116,85,22,622
2788624_IAmWoman.txt,2147,28,76,628,399,147,69,1243
2791590_ChrisRosenberg.txt,2600,22,118,851,463,105,120,1539
2791594_Eurasier.txt,773,23,33,300,103,54,33,490
2792071_NeurofibromatosisTypeIi.txt,2332,28,83,949,260,245,60,1514
2792266_NarenChitty.txt,603,8,75,305,51,16,7,379
2793007_MadhavaOfSangamagrama.txt,1150,35,32,430,130,101,30,691
2794962_GaaAllStarsAwards.txt,757,25,30,387,61,27,11,486
2796342_RenaissanceWeekend.txt,1385,8,173,1026,61,72,16,1175
2797336_WesternCanadaHighSchool.txt,577,10,57,230,67,51,11,359
2797386_JamilAlbanna.txt,1204,30,40,415,227,46,40,728
2797827_ListOfSongsAboutAnimals.txt,1910,5,382,1210,32,35,13,1290
2797830_TheMorningCall.txt,648,13,49,295,70,26,8,399
2798178_ArkIi.txt,635,14,45,273,81,45,17,416
2798907_HossanLeong.txt,656,16,41,300,69,45,19,433
2799314_MissingIdentity.txt,1028,12,85,338,191,38,56,623
280061_Convair990.txt,588,8,73,196,72,42,17,327
2800707_RexConnor.txt,823,14,58,278,118,52,24,472
2800711_SupremeCourtOfArgentina.txt,764,12,63,298,89,58,20,465
2800840_StuartCampbellvideoGameJournalist.txt,1166,17,68,431,136,81,52,700
280101_StanMusial.txt,1422,28,50,512,202,93,56,863
2801547_KawasakiNinja650r.txt,732,19,38,283,88,74,33,478
2801560_OceanAcidification.txt,1030,13,79,457,92,98,29,676
2801854_BallaratGrammarSchool.txt,837,19,44,361,104,65,25,555
2802175_Dieselisation.txt,1016,23,44,418,120,82,33,653
2802549_DreamAct.txt,1487,14,106,408,231,123,88,850
2802601_RobertDenning.txt,862,16,53,330,110,49,28,517
2802637_TipperaryGaa.txt,780,30,26,280,44,33,9,366
2803237_DickRuthven.txt,1214,22,55,429,133,51,30,643
28038_SurvivorsOfTheSeptember112001Attacks.txt,1212,26,46,509,146,49,17,721
2803980_SamuraiShodownRpg.txt,1512,19,79,498,191,137,83,909
2804076_PossessionvideoGame.txt,1963,23,85,679,283,194,103,1259
28045_OrganizersOfTheSeptember112001Attacks.txt,1457,29,50,689,194,53,23,959
28046_ClosingsAndCancellationsFollowingTheSeptember112001Attacks.txt,1999,18,111,805,308,106,72,1291
28047_September112001AttackMemorialsAndServices.txt,2490,51,48,1131,271,137,40,1579
28048_ResponsibilityForTheSeptember112001Attacks.txt,4288,70,61,1738,584,217,109,2648
28049_WorldPoliticalEffectsArisingFromTheSeptember112001Attacks.txt,601,14,42,251,83,33,14,381
2805085_TheSilverLininggame.txt,805,14,57,320,115,46,21,502
2806185_DaiAlmutlaq.txt,917,11,83,332,123,65,26,546
2807993_HarmonRabb.txt,1144,10,114,500,153,47,21,721
28082_September112001AttacksTimelineForOctober.txt,1453,25,58,586,209,95,18,908
2808326_2005BaliBombings.txt,3033,36,84,1132,481,185,80,1878
2808422_GingaLegendWeed.txt,2218,22,100,859,318,106,76,1359
28088_September112001AttackOpportunists.txt,1182,27,43,466,177,59,33,735
2809233_UniversityOfMiamiSchoolOfLaw.txt,657,19,34,313,51,57,10,431
2809400_JannLee.txt,681,10,68,219,104,47,36,406
2809508_HowardSchnellenberger.txt,745,10,74,270,101,32,29,432
2810273_ListOfHighlanderImmortals.txt,1399,16,87,1213,17,9,2,1241
2810598_LaoisGaa.txt,718,50,14,374,42,30,6,452
2810916_DownGaa.txt,697,28,24,309,44,30,10,393
2811318_JeffersonHunt.txt,596,24,24,264,71,32,8,375
2811336_DoctorFischerOfGeneva.txt,1389,24,57,460,225,89,41,815
2811680_CooperationSystemOfTheAmericanAirForces.txt,847,28,30,442,85,37,9,573
2812721_OblatesOfStFrancisDeSales.txt,919,13,70,435,88,44,6,573
2812725_DiabetesMellitusType1.txt,1291,26,49,480,197,99,57,833
2812905_ChoujuuSentaiLiveman.txt,3712,22,168,1621,403,170,103,2297
2814647_CarnivalInColombia.txt,1108,18,61,373,156,72,26,627
2815692_AndrewMichaelRamsay.txt,2104,25,84,848,219,121,37,1225
281692_GuruNanakDev.txt,1712,30,57,644,249,95,51,1039
2817088_GlucoseTransporter.txt,580,15,38,221,76,64,14,375
2817961_BillFristMedicalSchoolExperimentsControversy.txt,586,6,97,195,95,38,18,346
2817967_ResidenzMunich.txt,596,10,59,272,56,43,9,380
2819024_1731EnglishCricketSeason.txt,672,11,61,292,68,43,29,432
2819687_DeliverancemetalBand.txt,618,13,47,314,53,33,14,414
2820059_UrbanFiction.txt,874,17,51,367,99,63,38,567
2820516_MelHague.txt,599,12,49,225,87,40,18,370
2820525_RomaniansOfSerbia.txt,576,16,36,265,51,45,13,374
282226_BaseballCard.txt,3663,57,64,1402,525,262,128,2317
2822315_InThePresenceOfMineEnemies.txt,7594,78,97,2512,1150,610,380,4652
282265_Bayan.txt,700,11,63,321,55,74,16,466
282310_TimelineOfPostalHistory.txt,1948,40,48,834,94,204,7,1139
2823416_RoyKilner.txt,990,11,90,300,122,86,60,568
2823745_1999InAustralia.txt,1089,8,136,489,95,74,20,678
2824817_LondonbrabantIsland.txt,838,14,59,321,102,52,33,508
2824856_FeastOfTrumpetschristianHoliday.txt,3128,40,78,1048,395,175,114,1732
2825940_FranciscoLpezDeGmara.txt,647,6,107,212,89,40,16,357
2826665_LiberationMonument.txt,245,8,30,87,26,18,5,136
2826694_Videoscandals.txt,1682,20,84,604,295,93,55,1047
282713_WrightBrothersFlightsOf1909.txt,667,11,60,216,99,38,26,379
282726_StephenWard.txt,688,10,68,269,97,45,15,426
2827312_ManiacMagee.txt,1124,17,66,415,153,91,31,690
2827371_ImmermanszelepcsnyiTheorem.txt,935,20,46,328,141,55,43,567
2827742_JavaMobileMediaApi.txt,621,21,29,218,109,39,25,391
2828095_FrauSolfTeaParty.txt,1313,18,72,452,185,58,37,732
2828184_JohnHadenBadley.txt,1208,14,86,457,136,83,34,710
2829084_Prabowo.txt,2521,37,68,878,378,181,96,1533
2829113_StreetFightervideoGame.txt,982,25,39,365,113,80,27,585
2829270_CivilCodeOfArgentinatranslation.txt,7473,92,81,4568,589,400,98,5655
2830178_NatalieZahra.txt,599,12,49,236,66,47,25,374
2831019_TheodorWHnsch.txt,721,12,60,261,75,77,15,428
2832100_TribalOfJharkhandIndia.txt,1467,23,63,567,212,131,39,949
2832556_SpidermanLovesMaryJane.txt,2862,33,86,1039,441,202,126,1808
2832591_LucOrient.txt,808,13,62,351,77,74,22,524
2832596_CookForestStatePark.txt,1429,21,68,630,178,109,30,947
2833518_TheAdventuresOfTheGalaxyRangers.txt,1899,32,59,771,251,155,51,1228
2833626_SanthalRebellion.txt,749,7,107,246,99,57,28,430
2834392_Zandar.txt,851,15,56,312,137,54,31,534
2835378_BurlingtonCountyCollege.txt,1326,10,132,686,116,84,15,901
2835486_Akathist.txt,590,9,65,200,84,37,27,348
2835935_GrandMosqueSeizure.txt,1151,17,67,428,164,80,34,706
2837006_WilliamAbercrombie.txt,623,10,62,250,71,31,16,368
283769_ListOfSpeciesInFantasyFiction.txt,2009,30,66,1443,47,116,20,1626
2837816_TheTerrorTimeline.txt,785,14,56,312,102,24,15,453
2837901_SouthWesternHighway.txt,570,19,30,290,37,28,18,373
2837912_KarlAgathon.txt,1212,15,80,452,181,54,34,721
2837913_ConservativeLaestadianism.txt,909,27,33,383,127,52,22,584
283809_AletschGlacier.txt,728,11,66,238,71,65,23,397
283810_MassSpectrometry.txt,5408,90,60,2088,765,506,213,3572
283812_Mathura.txt,700,17,41,319,71,47,21,458
283826_Browniemythology.txt,1143,24,47,388,166,79,43,676
2838734_ImperialJapaneseArmyPoliticsAndBackground.txt,4067,54,75,1422,556,318,140,2436
2839746_LuisMorenoocampo.txt,671,13,51,260,68,46,8,382
2839844_WujalWujal.txt,1030,22,46,387,143,81,32,643
2840836_HigherEducationRoleAnalysis.txt,730,33,22,244,146,40,23,453
2841233_PeterWilliamson.txt,2762,31,89,899,376,189,78,1542
2841261_Viglius.txt,695,9,77,228,94,46,21,389
2842072_TapeDispenser.txt,615,11,55,237,104,53,23,417
2842077_JoetexAsamoahFrimpong.txt,585,12,48,242,56,36,13,347
2842753_CutoffsteamEngine.txt,941,16,58,323,135,58,33,549
2843591_HarlanMills.txt,787,11,71,402,61,37,2,502
2843617_RolladenschneiderLs8.txt,1191,34,35,462,143,121,47,773
2843785_ChadReed.txt,696,10,69,268,91,54,23,436
284398_TheBlueLotus.txt,1113,22,50,398,148,79,31,656
2844212_UssBagleydd386.txt,3273,47,69,1316,373,203,77,1969
2847252_MonasteryOfSoVicenteDeFora.txt,607,9,67,237,68,47,9,361
28478_Skiing.txt,3387,67,50,1401,480,316,153,2350
28481_StatisticalMechanics.txt,2631,97,27,801,350,280,88,1519
28483_Solstice.txt,2464,22,112,833,267,180,110,1390
28484_Sputnik1.txt,1155,21,55,388,172,91,33,684
284855_LeslieSpeaker.txt,1722,22,78,614,234,151,66,1065
28485_SteveJacksonGames.txt,990,11,90,495,103,79,17,694
28487_Suebi.txt,953,20,47,362,98,53,28,541
2849663_RubiconTrail.txt,867,15,57,350,115,49,20,534
2849666_ListOfSantaClaraUniversityPeople.txt,2355,24,98,1682,31,113,10,1836
2849675_JapaneseManagementCulture.txt,1171,14,83,379,160,162,59,760
2849687_ListOfChileanJews.txt,829,5,165,633,17,50,9,709
2851626_EarlStrom.txt,1091,14,77,382,171,37,36,626
2852343_AngeloCataldi.txt,925,14,66,378,121,57,26,582
2853761_InterceptMethod.txt,1140,21,54,409,194,83,33,719
2853880_JohnCMorgan.txt,1373,15,91,491,186,66,34,777
2853892_LaCoscienzaDiZeno.txt,1308,12,109,414,216,72,70,772
28538_SolarWind.txt,2193,42,52,692,278,275,106,1351
28543_Spoonerism.txt,3008,39,77,1193,416,195,105,1909
28544_September9.txt,1967,6,327,1109,66,62,12,1249
28545_Selfreference.txt,804,21,38,320,99,57,31,507
28547_SokalAffair.txt,1457,17,85,582,169,116,41,908
2854850_DoctorWhoTheUltimateAdventure.txt,726,12,60,280,102,33,19,434
285525_FrancisDukeOfTeck.txt,768,19,40,331,76,52,17,476
285532_Moogle.txt,1856,11,168,701,256,154,71,1182
285539_Derringer.txt,675,6,112,206,97,70,44,417
285568_Charmeleon.txt,1028,16,64,390,120,107,43,660
285574_HouseDustMite.txt,734,8,91,265,112,74,36,487
2856326_DaleSteele.txt,580,13,44,261,51,33,10,355
2857073_Twitches.txt,1430,12,119,487,226,58,57,828
2857416_GeorgeHome1stEarlOfDunbar.txt,842,14,60,305,93,30,14,442
2858384_EnvironmentalBenefitsOfVegetarianism.txt,1014,16,63,333,158,105,52,648
2859225_MichaelDransfield.txt,685,11,62,260,85,57,27,429
2859247_LetsGetTogetherNow.txt,297,16,18,106,35,23,23,187
285938_OleWorm.txt,631,11,57,215,81,57,21,374
2859664_CableTvHongKong.txt,1889,31,60,816,221,171,61,1269
286007_UssFranklincv13.txt,1937,27,71,767,251,95,42,1155
286012_PlatonicLove.txt,697,13,53,234,85,60,23,402
2861745_LaborMarketOfJapan.txt,788,13,60,270,121,89,28,508
2861746_JewsOutsideEuropeUnderNaziOccupation.txt,633,8,79,258,88,21,8,375
2861769_GrapheParanomon.txt,591,6,98,160,102,41,36,339
2864388_BobFink.txt,708,17,41,320,62,41,6,429
286578_HeinzSchool.txt,831,27,30,459,59,38,14,570
286581_GermanSpellingReformOf1996.txt,2994,57,52,1013,429,243,119,1804
2866135_LowerSuwanneeNationalWildlifeRefuge.txt,876,15,58,370,123,84,28,605
2866139_ListOfAirportsByIcaoCodeK.txt,9463,56,168,9298,9,9,5,9321
286619_BooksInCanadaFirstNovelAward.txt,1021,35,29,804,27,18,4,853
286620_BrianHuttonBaronHutton.txt,859,15,57,347,118,40,21,526
286636_EastVillageManhattan.txt,678,11,61,300,67,51,13,431
2866484_QueenHippolytacomics.txt,3989,35,113,1415,617,211,135,2378
2866949_PanamintCityCalifornia.txt,690,13,53,275,92,42,21,430
2866965_CharactersOfSmallville.txt,4268,37,115,1506,681,245,154,2586
2868006_SamudraManthan.txt,1148,22,52,400,163,68,33,664
2868802_PianoSonataNo15beethoven.txt,714,11,64,224,88,79,42,433
2869453_Wckg.txt,574,12,47,252,66,18,14,350
2870310_TheFightNetwork.txt,701,22,31,387,54,42,15,498
287091_ClosedTimelikeCurve.txt,685,12,57,208,98,54,42,402
2871386_TimKinsella.txt,1952,28,69,844,236,128,67,1275
2873728_DouglasMarillier.txt,1496,21,71,444,219,75,81,819
2874162_CliffHagan.txt,754,12,62,288,94,45,12,439
2874165_Aximiliesgarrouthisthill.txt,1005,12,83,369,147,61,47,624
2874489_Tsurani.txt,1153,15,76,478,124,61,36,699
2875636_LentBumps.txt,854,23,37,311,112,43,23,489
2875_ArchdukeCharlesDukeOfTeschen.txt,1866,25,74,656,191,138,69,1054
287666_SanPabloCity.txt,876,17,51,472,89,38,18,617
287667_WidowSpider.txt,958,23,41,454,94,68,33,649
287669_SamHughes.txt,731,13,56,248,124,40,27,439
287670_Juon.txt,560,14,40,191,68,62,20,341
2876732_RossAndMacdonald.txt,573,15,38,338,29,17,5,389
287697_GeorgiaPublicBroadcasting.txt,1582,19,83,766,109,156,43,1074
287702_MesaVerdeNationalPark.txt,1943,31,62,729,278,168,56,1231
287722_HomeVideo.txt,692,27,25,349,57,51,21,478
287723_TourismInHawaii.txt,2382,38,62,932,273,193,78,1476
287724_SriLankaMatha.txt,662,10,66,372,55,33,7,467
2877872_Arturia.txt,627,25,25,241,72,51,21,385
2878149_Danionin.txt,2174,58,37,1043,248,114,144,1549
2880425_TheBestMan1999Film.txt,879,21,41,457,92,43,25,617
2880795_ChexMix.txt,1039,35,29,508,112,70,52,742
2880820_ElzaKungaeva.txt,1019,17,59,370,155,54,40,619
288121_SidLuckman.txt,617,7,88,237,72,29,19,357
288141_SuperiorWisconsin.txt,1476,22,67,594,162,102,23,881
2881462_Arachnocampa.txt,926,20,46,344,134,47,28,553
2882512_Bretten.txt,733,14,52,281,95,60,21,457
2883438_Grind2003Film.txt,583,9,64,296,68,20,8,392
2883_ActiveServerPages.txt,574,18,31,242,70,61,20,393
2884434_PedroMir.txt,939,21,44,401,103,38,27,569
2884441_CitizensAgainstGovernmentWaste.txt,1932,45,42,741,286,128,64,1219
2884446_NancyFaust.txt,822,12,68,294,119,57,29,499
2885843_MadameRouge.txt,836,16,52,296,123,51,40,510
2886672_WashingtonMarineGroup.txt,574,6,95,287,54,30,18,389
2887590_ListOfCharactersInGrandTheftAutoLibertyCityStories.txt,5808,144,40,2243,899,295,247,3684
2887715_EdgarGraham.txt,603,13,46,268,60,26,20,374
2889_AmorphousSolid.txt,1108,18,61,363,155,148,51,717
2890_AWizardOfEarthsea.txt,725,12,60,224,105,50,28,407
2891039_ColumbFarrelly.txt,654,6,109,259,75,39,23,396
2891058_FrederikMeijerGardensAndSculpturePark.txt,1106,25,44,515,108,91,23,737
2891074_AdamForepaugh.txt,916,24,38,315,129,70,36,550
2892130_TirumalaTirupati.txt,2179,35,62,920,264,118,73,1375
2892491_VisualLanguage.txt,846,12,70,312,116,61,24,513
2892843_ListOfLosAngelesBikePaths.txt,610,9,67,344,57,25,13,439
2893_AlexLifeson.txt,1348,15,89,563,157,80,31,831
2894247_MeMyKatamari.txt,605,9,67,228,62,51,17,358
2894560_HistoryOfArtificialIntelligence.txt,4263,90,47,1792,501,409,114,2816
2894578_JohnJoubert.txt,1080,15,72,315,228,51,37,631
2897219_SequenceDance.txt,734,17,43,261,115,58,31,465
2897287_IngerChristensen.txt,581,10,58,189,68,47,19,323
2898927_RichardRushdirector.txt,1022,9,113,360,139,85,36,620
2898953_HotCathode.txt,759,13,58,278,126,74,35,513
2898955_PithoragarhDistrict.txt,2241,42,53,1174,227,113,35,1549
289946_ListOfBurialsInTheValleyOfTheKings.txt,1025,62,16,425,137,61,36,659
289952_UsRoute26.txt,866,18,48,355,102,36,22,515
2899715_Siegesallee.txt,944,7,134,312,118,77,41,548
2899775_19251949PacificHurricaneSeasons.txt,700,36,19,269,81,53,13,416
2900546_HughBourne.txt,1583,20,79,555,200,127,55,937
2901216_PehrHenrikLing.txt,701,6,116,218,100,58,21,397
2901985_ShuttleworthCollection.txt,666,11,60,345,39,38,17,439
2903008_CouncilOfScoutAssociationsInBosniaAndHerzegovina.txt,1084,26,41,417,145,43,27,632
2903135_Wbtj.txt,1060,6,176,421,145,85,30,681
2903140_MikePloog.txt,1643,20,82,606,224,101,62,993
290327_GermanAmerican.txt,3092,38,81,1332,325,294,88,2039
290380_Coreldraw.txt,1339,42,31,600,155,106,53,914
290381_YouthForChrist.txt,633,13,48,286,75,53,17,431
290383_KarlLiebknecht.txt,768,12,64,289,96,37,20,442
2904094_ListOfFictionalBeverages.txt,3223,17,189,1963,138,121,53,2275
2904201_DaniellIntegral.txt,1012,29,34,283,116,135,37,571
2904221_SpoofStrategy.txt,1180,20,59,275,206,95,86,662
2905520_PaulVallely.txt,570,12,47,231,72,19,16,338
2905_Artemis.txt,2652,48,55,925,406,130,85,1546
2906024_Amc35.txt,1334,25,53,399,243,88,43,773
2906447_FindAGrave.txt,853,13,65,316,122,69,25,532
2906611_BlueInHeaven.txt,618,9,68,300,52,32,12,396
2906616_FerozKhan.txt,784,12,65,360,60,38,12,470
2906_ArbeitMachtFrei.txt,555,17,32,228,76,37,10,351
2907446_BelarusianAlphabet.txt,635,13,48,196,59,37,20,312
2907454_MonteKiffin.txt,564,6,94,218,66,51,27,362
2908539_AshWednesdayStormOf1962.txt,969,14,69,432,113,67,25,637
2908558_Capacitorcomponent.txt,2245,47,47,831,264,259,97,1451
2909954_AdministrativeReviewBoard.txt,668,13,51,252,93,30,24,399
2909_Albinism.txt,3996,47,85,1505,504,422,192,2623
291033_VirtuesOfUltima.txt,1009,39,25,404,145,35,36,620
291036_AmberRoom.txt,1867,31,60,710,247,120,52,1129
291049_TheTonightShowWithJayLeno.txt,1396,8,174,530,201,82,49,862
2910799_ShaunKing.txt,705,13,54,250,95,52,16,413
2910801_OilReservoir.txt,606,14,43,227,75,40,21,363
2910814_NationalPhysicalLaboratoryIndia.txt,1319,26,50,464,181,95,30,770
2911355_KingHiss.txt,1378,23,59,456,214,111,63,844
2911682_GreggHarris.txt,832,9,92,343,99,60,23,525
2911882_Prosthechea.txt,1201,11,109,606,56,71,11,744
2911_AmrDiab.txt,2007,28,71,838,255,150,48,1291
29123_SemanticWeb.txt,2508,34,73,968,339,184,90,1581
29124_SovietSubmarineK219.txt,610,9,67,232,102,21,22,377
29126_SovietSubmarineK19.txt,1044,17,61,349,184,57,33,623
2912786_PolycratesOfEphesus.txt,778,12,64,236,127,28,25,416
2912790_Nicolae.txt,628,10,62,252,98,27,24,401
29128_SuperBowlI.txt,2525,38,66,1001,349,153,70,1573
29129_SuperBowlIi.txt,2065,30,68,865,234,139,54,1292
29130_SuperBowlIv.txt,2945,38,77,1246,350,190,82,1868
29131_SuperBowlV.txt,3975,49,81,1541,522,267,140,2470
29132_SuperBowlVi.txt,2631,37,71,1024,363,178,91,1656
29133_SuperBowlVii.txt,2312,36,64,905,300,168,74,1447
29134_SuperBowlViii.txt,1812,32,56,747,199,124,58,1128
2913595_EmeryRoth.txt,795,5,159,434,23,22,4,483
29135_SuperBowlIx.txt,2553,42,60,1022,331,156,86,1595
29136_SuperBowlX.txt,3011,43,70,1163,407,167,100,1837
29137_SuperBowlXi.txt,2041,37,55,870,238,125,51,1284
29138_SuperBowlXii.txt,2387,35,68,1003,288,139,83,1513
29139_SuperBowlXiii.txt,3634,46,79,1521,422,228,105,2276
29140_SuperBowlXiv.txt,3115,43,72,1224,378,213,115,1930
29141_SuperBowlXv.txt,2145,30,71,936,244,111,57,1348
29142_SuperBowlXvi.txt,2646,34,77,1068,318,170,72,1628
2914301_ZoidsNewCenturyZero.txt,3134,40,78,1242,409,207,90,1948
2914317_ArrivaScotlandWest.txt,776,15,51,293,100,67,33,493
29145_SuperBowlXix.txt,3421,36,95,1373,388,213,99,2073
291466_Mac68kEmulator.txt,634,7,90,194,110,50,37,391
291469_EnglishShepherd.txt,1036,17,60,341,149,122,59,671
29146_SuperBowlXxi.txt,2618,37,70,1069,303,181,91,1644
2915052_RichardPGabriel.txt,660,13,50,266,80,29,18,393
2915147_PublicTransportInStockholm.txt,1005,31,32,383,132,80,28,623
2915164_SaraDylan.txt,633,14,45,281,86,39,22,428
2915175_Aba.txt,589,7,84,183,103,42,26,354
2915741_RoyBentley.txt,733,8,91,240,91,47,29,407
29161_SaintCyril.txt,1219,18,67,423,179,62,55,719
2916242_SwedishWelfare.txt,1351,17,79,451,188,151,50,840
2916260_9thInfantryRegimentunitedStates.txt,1427,15,95,699,108,63,19,889
2916262_CuricChile.txt,1062,39,27,421,105,91,25,642
29164_ScottishDeerhound.txt,614,10,61,165,104,65,33,367
2916591_TheEnglishConstitution.txt,1076,14,76,308,171,82,47,608
2917144_Balzacband.txt,890,14,63,456,50,41,9,556
29175_SolomonSchechter.txt,675,16,42,276,68,35,14,393
29177_SpaghettiWestern.txt,842,17,49,396,85,56,31,568
29180_SystemShock.txt,2433,34,71,803,381,208,128,1520
2920410_DaNangInternationalAirport.txt,3295,99,33,1565,325,244,59,2193
292066_ZoBall.txt,736,19,38,284,85,49,22,440
292072_Dumnonia.txt,810,15,54,304,108,69,24,505
292094_Anorgasmia.txt,1288,27,47,377,198,162,85,822
2920965_LopezfitzgeraldFamily.txt,1498,19,78,610,233,62,60,965
292101_ChurchOfNigeria.txt,1016,20,50,403,113,66,15,597
292107_Dyspareunia.txt,1768,19,93,592,252,215,74,1133
292108_Heraclea.txt,896,15,59,332,103,52,27,514
292149_MotooriNorinaga.txt,836,13,64,293,108,72,19,492
2922021_CherylChaseactivist.txt,754,19,39,269,115,56,17,457
2922739_KembrewMcleod.txt,795,16,49,315,100,49,22,486
2923028_PooltypeReactor.txt,593,8,74,222,80,49,23,374
2923884_HellTeacherNb.txt,2627,23,114,884,350,200,126,1560
2924683_Wnir.txt,724,17,42,319,82,37,24,462
2924688_AdelphiCharter.txt,904,27,33,441,80,70,12,603
2925273_TheDentist.txt,1349,21,64,555,173,59,45,832
2925310_Hurtsong.txt,1240,17,72,486,160,95,36,777
2927114_Wilhelmstrae.txt,841,13,64,268,89,93,21,471
2928144_Jethrocomedian.txt,682,12,56,268,94,32,18,412
2928317_BienvenidoLumbera.txt,837,13,64,480,49,38,13,580
2928652_SamuelAbaOfHungary.txt,586,8,73,176,102,41,17,336
2929233_GeorgeStallings.txt,583,8,72,208,73,43,21,345
2930061_CarbonMonoxideDetector.txt,693,10,69,257,97,64,30,448
2930574_Musidora.txt,608,10,60,222,74,45,18,359
293159_Mithra.txt,1854,32,57,673,220,138,55,1086
293185_Yogacara.txt,1151,16,71,429,145,86,51,711
293242_PalgravesGoldenTreasury.txt,1694,18,94,1120,21,15,10,1166
2932459_LuisRamirez.txt,794,14,56,262,140,36,31,469
2932694_HetzelUnionBuilding.txt,710,11,64,273,96,45,22,436
2933543_ElectronicFundsTransfer.txt,652,15,43,250,97,45,18,410
2934002_OppositeSextvSeries.txt,815,12,67,280,147,29,26,482
2934905_StanleyZbornak.txt,691,11,62,193,130,41,35,399
2934907_ShootOutTheLights.txt,683,13,52,281,77,36,19,413
2934942_ListOfMoroccans.txt,497,26,19,398,6,21,3,428
2934944_Krisma.txt,767,23,33,380,61,41,11,493
2935920_StandardWrittenEnglish.txt,1434,27,53,444,227,144,72,887
293714_PourLeMrite.txt,2169,17,127,1061,166,165,45,1437
2939148_PartialClass.txt,621,19,32,238,84,67,22,411
2939287_GeneralTheoryOfCollaboration.txt,873,16,54,314,90,99,26,529
2940252_TripoliInternationalAirport.txt,581,13,44,300,64,41,8,413
294270_EarlOfWarwick.txt,658,13,50,323,39,46,18,426
294271_WalloonLanguage.txt,1633,30,54,653,170,169,53,1045
294295_Glyphosate.txt,1373,19,72,485,204,139,56,884
294328_WilliamPatersonUniversity.txt,2245,41,54,966,295,150,73,1484
2944547_RomanCatholicDioceseOfScranton.txt,1824,24,76,762,191,113,44,1110
2944700_CriticalInternationalRelationsTheory.txt,1584,33,48,611,194,158,56,1019
2945072_HumanRightsInJapan.txt,8970,142,63,3263,1336,740,267,5606
2945074_TomGillcomics.txt,585,11,53,288,53,40,9,390
2946054_SandaraPark.txt,1374,28,49,538,179,97,53,867
294736_NicholasBiddlebanker.txt,906,14,64,384,101,39,23,547
294737_DarkFiber.txt,1044,21,49,368,155,99,62,684
294739_VueltaAEspaa.txt,713,13,54,278,84,51,27,440
2947960_JohnMarcellus.txt,753,19,39,379,53,24,6,462
2947990_MazingerZrobot.txt,945,9,105,418,117,70,28,633
294800_FriedEgg.txt,916,25,36,298,140,74,55,567
2949057_Overo.txt,789,16,49,282,116,99,56,553
2949087_Nabha.txt,674,16,42,308,73,30,19,430
2949425_2005MinnesotaVikingsBoatCruiseScandal.txt,1494,29,51,488,275,74,66,903
2949772_RicardoTacuchian.txt,933,16,58,510,25,44,12,591
2950495_PalmBeachCountyParkAirport.txt,868,17,51,328,133,38,13,512
2950511_BossBorot.txt,773,12,64,321,94,48,28,491
2950907_DemathaCatholicHighSchool.txt,1948,27,72,929,151,153,31,1264
2951320_MadNotMadness.txt,1207,32,37,436,185,54,56,731
2952450_Chickenhawkbook.txt,837,30,27,328,111,45,20,504
295384_MaximilianIJosephOfBavaria.txt,1184,28,42,419,129,82,27,657
295385_MesaAirlines.txt,1674,39,42,798,213,38,15,1064
295390_AirMidwest.txt,998,30,33,489,118,33,10,650
295410_ListOfAlbaniarelatedArticles.txt,2631,68,38,2152,33,71,5,2261
2955162_LatinBridgeInSarajevo.txt,688,9,76,163,131,22,34,350
2955558_TheIntimates.txt,604,10,60,214,85,50,20,369
2955693_EasternCanadianWolf.txt,928,10,92,350,144,67,37,598
2955715_Demigodz.txt,1273,16,79,495,170,76,55,796
29564_SuperBowlXxxvi.txt,4178,60,69,1669,532,279,97,2577
29573_SupermarineSpitfire.txt,5393,72,74,2109,683,411,181,3384
2957791_PortlandAndWesternRailroad.txt,1243,21,59,549,140,79,19,787
2958225_Kyliefever.txt,573,14,40,336,45,25,9,415
295855_Catechism.txt,3048,81,37,1052,391,176,113,1732
2960141_MarkaustralianFootball.txt,1140,16,71,341,193,71,50,655
2961112_ListOfCharactersInGabrielKnight3.txt,1431,26,55,502,208,76,44,830
2963556_AfQuarterly.txt,598,5,119,227,75,39,17,358
2963976_LebaneseBroadcastingCorporation.txt,825,19,43,311,117,61,34,523
2964423_TachiharaMichiz.txt,734,8,91,291,88,69,29,477
296454_Acolyte.txt,1248,15,83,442,186,75,44,747
296469_Quarters.txt,2107,40,52,637,355,143,92,1227
296482_MercuryComet.txt,943,25,37,305,127,82,32,546
296534_Arius.txt,3130,31,100,905,544,163,147,1759
296542_Chrysanthemum.txt,983,24,40,358,138,96,44,636
2965504_PrincipalCharming.txt,609,11,55,240,93,31,23,387
2965508_FirerAvrahamElimelechRabbi.txt,476,7,68,175,61,34,9,279
2965820_DinosaurRyuzaki.txt,948,17,55,375,132,52,29,588
2966756_ExperimentalBreederReactorIi.txt,730,9,81,260,91,63,26,440
2968109_GirraweenHighSchool.txt,1001,22,45,439,113,62,26,640
2968584_Doomguy.txt,1903,26,73,626,301,121,93,1141
296919_Xindi.txt,2522,35,72,786,400,213,116,1515
296936_GoldenPheasant.txt,563,13,43,186,70,65,17,338
296937_EvanBayh.txt,2812,71,39,1132,355,207,67,1761
296939_MichaelHuffington.txt,775,17,45,328,66,48,9,451
296941_NortheastBlackoutOf1965.txt,845,23,36,330,128,29,26,513
2969979_ShakespearesLife.txt,1490,27,55,542,219,91,31,883
2970000_AllBecauseOfYou.txt,577,14,41,214,64,50,14,342
2970018_SexualityOfWilliamShakespeare.txt,2255,29,77,743,335,199,86,1363
2970113_LouisalexandreDeLaunayComteDantraigues.txt,1156,14,82,418,155,66,33,672
2970817_LeveeFailuresInGreaterNewOrleans2005.txt,2639,40,65,994,347,171,100,1612
2971948_JeuxDeLaCommunication.txt,624,12,52,277,34,63,11,385
2974488_Anekantavada.txt,581,18,32,213,69,36,33,351
2974492_TheThingvideoGame.txt,2529,18,140,803,410,129,97,1439
297515_GameDevelopersChoiceAwards.txt,587,18,32,312,8,13,4,337
2975203_ScottDyleski.txt,902,17,53,352,146,46,25,569
297576_VanillaCoke.txt,1141,26,43,447,155,66,30,698
297586_FlagOfSerbia.txt,643,18,35,218,92,47,16,373
297610_Enfp.txt,1203,24,50,405,186,95,44,730
297628_DragonBallGt.txt,1675,23,72,762,191,106,74,1133
2976943_AlliedWarCrimesDuringWorldWarIi.txt,1048,18,58,472,123,75,23,693
2977277_SunDevilTelevision.txt,1752,35,50,765,210,120,35,1130
2977287_TheLastLegion.txt,574,15,38,225,58,47,5,335
2979535_BallantineAdultFantasySeries.txt,1347,12,112,711,83,48,13,855
297962_TemucoChile.txt,1191,26,45,435,155,105,48,743
297972_Halfpipe.txt,809,17,47,269,137,81,31,518
298009_CastelSantangelo.txt,788,18,43,298,99,43,31,471
298010_RevolutionaryUnitedFront.txt,938,24,39,333,139,56,35,563
2980274_BillyKersands.txt,1026,15,68,353,142,91,33,619
2980609_ManojKumar.txt,686,10,68,291,88,44,15,438
2982520_ViktorMeyer.txt,804,15,53,322,103,56,32,513
2983053_NeopetsPlots.txt,4969,81,61,1679,847,243,201,2970
2983062_Batihah.txt,852,20,42,297,123,42,25,487
2983072_imran.txt,872,16,54,268,141,36,28,473
2983543_DaisukeNiwa.txt,695,12,57,208,112,44,39,403
2983893_ScoutAssociationOfJapan.txt,1542,31,49,637,179,120,40,976
2984529_SujiKwockKim.txt,540,8,67,348,28,11,3,390
2984983_WillieWilliams.txt,674,11,61,223,120,25,25,393
2985314_TheCollectedShortFictionOfCJCherryh.txt,1646,28,58,791,142,88,30,1051
2985337_FictionalResistanceMovementsAndGroups.txt,1006,29,34,446,121,58,26,651
2985470_CommitteeForAccuracyInMiddleEastReportingInAmerica.txt,1275,16,79,602,134,78,31,845
2986436_STGill.txt,757,11,68,320,88,37,19,464
2986559_QualityOfModels.txt,647,36,17,256,75,61,6,398
298667_StillTheOnepromotionalCampaign.txt,675,20,33,241,73,52,28,394
298672_SimplyRed.txt,1032,16,64,419,102,92,29,642
298677_LeagueOfWales.txt,1184,26,45,536,128,76,29,769
298694_BharatiMukherjee.txt,591,18,32,294,37,27,6,364
298695_IonianRevolt.txt,973,17,57,319,153,44,39,555
298699_BattleOfPrairieGrove.txt,2513,43,58,1401,181,91,37,1710
298712_CerroMaravillaIncident.txt,2444,26,94,911,360,161,71,1503
2988332_KlamathReclamationProject.txt,602,13,46,278,64,35,7,384
2988942_HungarianGrammar.txt,3006,70,42,1042,371,301,128,1842
2989328_ColonelunitedStates.txt,1063,20,53,436,128,70,32,666
299049_Liger.txt,1886,26,72,640,266,179,70,1155
299064_SundayTimesRichList20031500.txt,4257,8,532,2164,59,48,6,2277
2990689_ModelingPerspectives.txt,823,23,35,345,118,59,11,533
299121_MalcolmInTheMiddle.txt,7020,74,94,2454,1058,421,276,4209
299123_BasketballAtThe1936SummerOlympics.txt,551,22,25,302,51,23,5,381
2991770_DieToteStadt.txt,1135,24,47,419,163,64,55,701
2991789_TheStranger1973Film.txt,743,14,53,249,117,39,32,437
299205_JohnAnthonyWalker.txt,915,14,65,370,115,53,38,576
299206_AberystwythTownFc.txt,1302,25,52,498,141,83,40,762
2992685_DarkMousy.txt,1013,18,56,278,180,71,42,571
2992705_RisaHarada.txt,587,9,65,143,83,49,53,328
2994013_AdamXTheXtreme.txt,1407,24,58,448,215,127,58,848
2994014_TheNeverendingStoryIii.txt,1520,22,69,492,230,104,75,901
2994941_Friendfilm.txt,979,14,69,299,149,81,39,568
2995581_TheOfficeukTvSeries.txt,2166,43,50,858,269,178,78,1383
2995948_IcelandPlume.txt,2071,20,103,648,235,221,110,1214
2996055_Antinuclear.txt,1132,19,59,454,131,150,45,780
2997053_ResourceDependenceTheory.txt,600,9,66,255,65,41,8,369
299730_CopaLibertadores.txt,1268,28,45,460,140,96,38,734
2997491_UkRailwaySignalling.txt,2637,47,56,819,447,253,89,1608
2997569_CerebralHemorrhage.txt,1131,19,59,476,116,127,33,752
299761_LaPalma.txt,1424,24,59,577,161,89,26,853
299767_FreeRepublic.txt,1717,40,42,737,199,124,43,1103
299786_ListOfPlacesNamedAfterPeople.txt,3128,80,39,2180,94,94,18,2386
299788_Nianfo.txt,666,15,44,239,87,50,23,399
299809_JohnJacobAstorIv.txt,967,12,80,393,138,50,18,599
2999497_CouncilOfSutri.txt,662,9,73,231,96,35,12,374
3001443_HoweSound.txt,1695,27,62,680,200,153,61,1094
3001446_MandarinOrientalHongKong.txt,579,22,26,270,54,50,11,385
3001720_GeorgeHamiltonpolitician.txt,812,10,81,298,98,61,10,467
300208_Namco.txt,908,13,69,401,126,71,21,619
300210_ArmedIslamicGroup.txt,1637,16,102,590,239,97,48,974
300227_GoldenGateUniversity.txt,1128,35,32,547,95,84,25,751
300233_Moriori.txt,1008,15,67,416,116,63,28,623
3003296_ChristopherXBrodeur.txt,851,10,85,345,105,65,19,534
3004724_CapitulationsOfTheOttomanEmpire.txt,1547,22,70,506,183,108,48,845
3004735_KennesawMountainHighSchool.txt,592,25,23,289,67,35,10,401
3006082_JamesRNewby.txt,665,9,73,301,79,35,9,424
3006095_NationalVaccineInformationCenter.txt,679,19,35,335,73,47,5,460
3006104_SamuelJBattle.txt,1279,22,58,400,223,61,55,739
3006270_RobertHarron.txt,2282,10,228,1156,86,71,30,1343
3007285_NavajoPeople.txt,3752,44,85,1433,520,251,133,2337
300822_BoatPeople.txt,1524,17,89,537,222,120,51,930
300872_ListOfPeopleByNameElli.txt,879,12,73,621,7,57,0,685
3009016_JosMaraQueipoDeLlanoRuizDeSaravia7thCountOfToreno.txt,766,7,109,270,79,51,15,415
3009141_WhenAStrangerCalls2006Film.txt,1165,21,55,419,170,51,42,682
3010452_EmmanuelJal.txt,600,11,54,229,88,36,15,368
3010644_SelbyRailwayStation.txt,549,12,45,210,68,31,14,323
3011360_ListOfCivilParishesInOxfordshire.txt,818,5,163,456,1,8,0,465
3011385_DickLee.txt,1048,22,47,450,105,79,26,660
3012391_BrittaBhler.txt,680,12,56,229,94,46,15,384
301313_JetProgramme.txt,1647,23,71,604,230,138,61,1033
301382_TeenTitanscomics.txt,3498,62,56,1411,459,254,108,2232
301386_DepartmentsOfTheUnitedKingdomGovernment.txt,978,27,36,627,35,30,9,701
301388_JornadaDelMuerto.txt,762,12,63,317,66,58,26,467
3015885_Praxagoras.txt,765,13,58,282,100,51,26,459
3015891_TheDailyPunctilio.txt,1780,52,34,784,244,75,47,1150
3016350_FranciscoPiYMargall.txt,987,13,75,379,106,56,17,558
3016712_TerminalDegree.txt,721,13,55,349,61,69,13,492
3017430_RolandTheHeadlessThompsonGunner.txt,828,12,69,269,108,83,31,491
3018138_ClearRange.txt,637,14,45,261,62,50,19,392
3018347_ThomasMiniStoryLibrary.txt,627,8,78,278,30,22,2,332
301913_BiblicalInerrancy.txt,2345,29,80,907,291,176,60,1434
301934_BattleOfKhalkhinGol.txt,5484,77,71,1985,766,452,143,3346
301945_HolyDayOfObligation.txt,957,24,39,434,82,26,34,576
301951_Veld.txt,647,9,71,222,90,52,34,398
301991_MicrosoftVisualStudio.txt,1787,41,43,791,233,121,57,1202
3020100_M2HalfTrackCar.txt,728,12,60,297,105,42,17,461
30205_TurkishArmedForces.txt,2197,47,46,873,204,170,64,1311
30208_HistoryOfTurkmenistan.txt,3151,47,67,1183,374,229,82,1868
30209_GeographyOfTurkmenistan.txt,1768,33,53,698,183,176,48,1105
30211_PoliticsOfTurkmenistan.txt,1247,28,44,479,181,98,40,798
30212_EconomyOfTurkmenistan.txt,782,20,39,308,85,87,18,498
30217_TurksAndCaicosIslands.txt,2511,49,51,943,282,188,61,1474
3022537_Latifa.txt,1996,45,44,995,207,102,32,1336
30227_Tuvalu.txt,1954,40,48,736,243,153,60,1192
3023613_StrattonBrothersCase.txt,2363,28,84,728,405,104,73,1310
3024444_StokoeNotation.txt,649,13,49,230,93,44,18,385
302468_ActivismIndustry.txt,681,9,75,317,83,63,27,490
30265_TomClancy.txt,2389,56,42,1132,212,120,52,1516
30267_TyburnLondon.txt,816,11,74,271,127,45,28,471
30268_TubeMap.txt,2217,36,61,864,301,180,90,1435
30269_TheHague.txt,2986,71,42,1163,316,274,112,1865
3027091_1999NationalLeagueChampionshipSeries.txt,3136,64,49,1144,413,173,89,1819
30271_TimPowers.txt,849,11,77,406,78,45,23,552
30273_TSEliot.txt,6689,72,92,2663,785,404,191,4043
30274_TommyLee.txt,1438,26,55,614,170,91,38,913
30275_NightOfTheLivingDead.txt,6041,60,100,2290,832,340,183,3645
3027778_LittleShellBandOfChippewaIndians.txt,1021,16,63,393,134,56,34,617
30277_TheThreepennyOpera.txt,1622,26,62,781,158,94,38,1071
3027801_TheSeen.txt,1552,39,39,704,153,67,46,970
30280_TheHoundOfTheBaskervilles.txt,1395,24,58,513,197,83,50,843
30281_TienGow.txt,615,7,87,206,87,40,23,356
30282_TimeSignature.txt,2981,57,52,970,396,267,159,1792
30284_StatisticalHypothesisTesting.txt,965,18,53,300,140,96,45,581
3028862_KongTheAnimatedSeries.txt,1526,22,69,560,189,69,34,852
302993_JohnAubrey.txt,1481,12,123,491,208,97,65,861
303005_HussiteWars.txt,3647,50,72,1198,494,221,158,2071
3030196_NancyHart.txt,738,18,41,264,128,33,21,446
303024_DeathRace.txt,606,17,35,230,92,31,22,375
303031_InformationProcessingLanguage.txt,1188,22,54,479,170,88,30,767
303043_Infomercial.txt,703,15,46,305,77,64,28,474
303045_Joynovel.txt,1611,15,107,503,221,101,87,912
303049_UnitedStatesSixthFleet.txt,1179,20,58,603,118,70,27,818
303050_MichelleHunziker.txt,771,13,59,299,91,77,15,482
303055_PrincessHelenaOfTheUnitedKingdom.txt,775,14,55,387,64,33,10,494
303076_NeonSign.txt,638,17,37,215,110,48,19,392
30310_TextEditor.txt,911,15,60,339,152,85,39,615
3031290_KloogaConcentrationCamp.txt,680,12,56,276,90,41,11,418
30312_TheCommunistManifesto.txt,2116,36,58,743,240,157,76,1216
30317_Trier.txt,4201,62,67,1569,454,316,102,2441
30318_Ton.txt,1500,32,46,549,161,135,67,912
3032107_Supramentalisation.txt,917,16,57,288,99,84,39,510
3032135_LittleBigLeague.txt,899,14,64,392,105,41,38,576
30322_Telecommunication.txt,4679,58,80,1657,651,431,179,2918
30325_TranscendentalNumber.txt,1373,42,32,373,195,179,70,817
30327_TheTerminator.txt,3396,39,87,1135,534,203,155,2027
3033209_DennisCometti.txt,1059,16,66,386,132,65,34,617
3033221_Wcdx.txt,642,6,107,233,86,53,22,394
3033528_PbsKidsSprout.txt,634,13,48,297,70,26,14,407
3034649_ProximityMapping.txt,593,14,42,194,76,39,18,327
3034864_FoundlingHospital.txt,2150,20,107,699,294,156,62,1211
303492_DazDillinger.txt,814,18,45,395,86,49,33,563
303500_CompletingTheSquare.txt,704,63,11,176,100,71,26,373
303563_JohnYoungastronaut.txt,1036,20,51,437,133,44,15,629
3035777_HinterlandsshortStory.txt,737,11,67,205,128,60,33,426
3037195_StorylinesOfNeighbours.txt,5207,47,110,2228,553,187,106,3074
3037555_NickStokes.txt,672,14,48,238,102,33,26,399
3037926_ANightmareOnElmStreet2FreddysRevenge.txt,926,14,66,316,151,36,34,537
3038988_MamakStall.txt,922,17,54,339,140,99,56,634
3039001_AmericanHeritageGirls.txt,658,15,43,280,84,40,12,416
304082_JosephCardinalBernardin.txt,881,12,73,321,106,58,22,507
304085_WilliamKunstler.txt,716,15,47,342,59,41,10,452
3040943_AleksanderEmelianenko.txt,765,10,76,308,83,33,22,446
304097_NewsRelease.txt,976,15,65,385,135,72,49,641
304122_JonnyQuest.txt,2740,38,72,1164,319,198,73,1754
3041255_ForeignPolicyOfJapan.txt,3630,34,106,1258,392,473,122,2245
3041260_NishiwakiJunzaburo.txt,625,13,48,242,84,45,20,391
304131_FanTranslation.txt,1270,22,57,465,191,99,58,813
304141_JewishHistory.txt,4158,55,75,1520,496,288,137,2441
304142_RichardWellesley1stMarquessWellesley.txt,1329,13,102,446,187,64,25,722
3042354_JacksonSoloist.txt,1603,31,51,601,243,118,63,1025
3043343_JoanHinton.txt,1429,26,54,601,161,86,33,881
3044270_Saintjeandemaurienne.txt,1135,19,59,438,116,66,25,645
3045281_ReferencesToCalvinAndHobbes.txt,2643,46,57,1052,347,196,82,1677
304546_PhilipNeri.txt,2234,21,106,665,314,174,88,1241
3045614_SeaContainersLtd.txt,588,18,32,294,64,35,9,402
304645_CanadianUniversitySocietyForIntercollegiateDebate.txt,877,17,51,455,76,59,21,611
3046600_BernardsWatch.txt,741,13,57,232,109,55,40,436
3046631_VPMenon.txt,651,16,40,262,83,29,19,393
3046836_TheCrimeAtBlackDudley.txt,1650,22,75,560,267,98,55,980
3046843_VentilatorassociatedPneumonia.txt,1312,21,62,450,188,153,65,856
3048190_OllieCole.txt,631,14,45,217,98,56,31,402
3049611_Eframe.txt,2132,39,54,724,295,206,121,1346
3049643_ChineseMp4mtvPlayer.txt,1362,23,59,507,203,129,54,893
3049644_YananForum.txt,1008,12,84,367,127,103,38,635
3049649_Icvc.txt,588,10,58,236,80,47,11,374
3051075_EuroukrainianAlphabet.txt,645,23,28,268,74,35,30,407
3051276_Westcot.txt,580,13,44,221,108,27,18,374
305180_CentipedearcadeGame.txt,1443,38,37,566,168,80,43,857
305185_ThirdBaseman.txt,694,10,69,312,75,72,28,487
3051902_DavidKarr.txt,1231,15,82,558,154,61,17,790
3052180_Pallippuram.txt,2641,59,44,1118,306,203,77,1704
305223_QrDecomposition.txt,1301,59,22,421,160,96,51,728
305224_QualityAssurance.txt,819,13,63,340,109,62,23,534
305225_ManganeseivOxide.txt,691,9,76,281,88,84,27,480
305241_Geysir.txt,703,15,46,262,96,41,33,432
305252_MurrayStateUniversity.txt,1906,28,68,896,206,135,33,1270
305295_CharlesCotton.txt,1715,29,59,513,229,106,79,927
3052969_TheEducatedMind.txt,778,16,48,297,89,80,16,482
305296_ColorGrading.txt,1750,30,58,625,249,202,69,1145
305298_SigmaPhiEpsilon.txt,2466,24,102,1274,232,122,45,1673
305300_NationalRevolutionaryArmy.txt,1021,17,60,426,98,82,25,631
3053969_SouthAfricanIrishRegiment.txt,1374,24,57,561,153,58,36,808
3055420_HistoryOfOttomanSerbia.txt,896,11,81,335,109,53,21,518
3055427_NutritionAndPregnancy.txt,1102,22,50,384,167,98,38,687
3056246_MauriceFloquet.txt,659,14,47,234,97,46,26,403
305670_TheDillingerEscapePlan.txt,1918,33,58,711,255,128,67,1161
305673_dithCresson.txt,1105,14,78,436,124,64,30,654
3056879_AdaptiveResonanceTheory.txt,665,18,36,271,90,64,26,451
305695_KissingerAssociates.txt,600,13,46,320,61,33,9,423
3058344_Salofood.txt,586,15,39,184,93,67,29,373
3058347_FolkHero.txt,776,14,55,335,69,74,23,501
3059883_UssRowedd564.txt,883,15,58,386,102,33,7,528
3060576_NanaKitade.txt,1198,33,36,623,70,51,5,749
3060686_ListOfPeopleByNameWilawilk.txt,566,8,70,424,4,23,2,453
3061673_TamarSite.txt,838,20,41,331,103,74,19,527
3061697_UltraMotorsports.txt,906,9,100,346,131,30,20,527
3063173_ListOfXmenLimitedSeries.txt,1284,26,49,641,37,79,11,768
306332_LloydHall.txt,581,10,58,209,89,39,21,358
306355_DianeLane.txt,594,12,49,268,60,18,9,355
306358_PlymouthRoadRunner.txt,1423,20,71,464,186,128,55,833
306361_DorisAngleton.txt,659,21,31,256,106,22,13,397
306378_RobertAngleton.txt,806,17,47,298,141,34,20,493
306380_RiverOaksHoustonTexas.txt,945,31,30,466,87,55,15,623
306381_Nystagmus.txt,1303,24,54,475,180,178,57,890
30648_Timor.txt,663,16,41,255,76,48,19,398
30651_Transposon.txt,1501,26,57,595,200,117,51,963
30652_Trypsin.txt,601,15,40,200,102,53,27,382
30653_Tuberculosis.txt,4644,58,80,1747,612,415,170,2944
30654_Triangle.txt,2342,58,40,701,284,231,64,1280
3065619_Geoponici.txt,612,4,153,226,76,47,14,363
30656_TorinoScale.txt,746,14,53,292,98,53,27,470
3066036_LeonidGaidai.txt,733,10,73,303,64,75,26,468
306723_AdamCopeland.txt,3817,51,74,1621,451,164,104,2340
306726_BitchesBrew.txt,2179,47,46,844,290,203,106,1443
3067461_JohnsonforestTendency.txt,676,9,75,255,85,45,21,406
3067612_November2005InAfrica.txt,929,24,38,443,101,51,9,604
306783_2003LondonBlackout.txt,794,22,36,270,119,52,30,471
3067929_ListOfAsteroids115201115300.txt,1347,1,1347,343,0,2,0,345
3067932_ListOfAsteroids115301115400.txt,1365,1,1365,365,0,1,0,366
3067935_ListOfAsteroids106501106600.txt,1318,1,1318,319,0,0,0,319
3067936_ListOfAsteroids115401115500.txt,1371,1,1371,363,0,8,0,371
3067937_ListOfAsteroids115501115600.txt,1377,1,1377,370,0,6,0,376
3067939_ListOfAsteroids106601106700.txt,1317,1,1317,316,0,0,0,316
3067944_ListOfAsteroids115601115700.txt,1339,1,1339,338,0,0,0,338
3068464_SovietTankmensSong.txt,485,17,28,150,61,31,25,267
3069386_Gasaraki.txt,555,18,30,226,60,32,11,329
3070892_RoadrunnerUnited.txt,911,4,227,766,24,29,2,821
30716_ThomasAquinas.txt,3692,51,72,1309,491,276,125,2201
30719_TidalForce.txt,770,17,45,252,93,67,26,438
3073282_HistoricalShiasunniRelations.txt,3139,61,51,1183,431,241,127,1982
307425_JoeZawinul.txt,639,14,45,276,60,53,22,411
3074305_SimonAnderson.txt,779,17,45,266,97,57,34,454
307437_MoldAlexandraFc.txt,697,11,63,241,95,31,27,394
307442_MaryleboneCricketClub.txt,852,14,60,349,99,55,27,530
307447_BattleOfLanden.txt,1373,22,62,463,180,103,42,788
307465_AndeanCommunityOfNations.txt,1129,21,53,479,122,70,20,691
307467_Realvideo.txt,661,13,50,234,123,56,31,444
307469_ByzantineArchitecture.txt,2163,26,83,779,249,176,71,1275
3075065_Brummbaer.txt,958,23,41,444,88,67,17,616
3075196_UsaPatriotActTitleVi.txt,1159,14,82,455,148,59,35,697
3076012_ToyaKinomoto.txt,1486,25,59,510,223,72,87,892
3076232_Luninets.txt,661,16,41,247,88,48,11,394
3077108_IanTurpie.txt,838,32,26,470,63,38,8,579
3078452_HenryScottHolland.txt,520,10,52,147,90,26,29,292
307868_RichardGrenvilletemple2ndEarlTemple.txt,939,8,117,324,120,63,26,533
307869_Transatlantic.txt,743,16,46,269,81,91,25,466
30786_Tuatara.txt,2271,33,68,740,332,214,85,1371
3079424_JapaneseMilitaryAttachsInForeignService.txt,1018,33,30,738,9,76,9,832
3079428_SriLankaTamilsindianOrigin.txt,2311,39,59,905,321,176,74,1476
3079452_BlasphemousRumoursSomebody.txt,735,12,61,259,91,57,30,437
3080988_RexSmith.txt,694,32,21,339,60,32,6,437
3082012_BaceMotorsports.txt,703,5,140,244,107,45,29,425
3082809_GermanSearchlightsOfWorldWarIi.txt,693,13,53,231,99,43,22,395
3083872_KarenFinley.txt,618,10,61,264,64,33,14,375
3083895_ShaddapYouFace.txt,672,21,32,341,59,48,23,471
308511_NolanChart.txt,1520,17,89,500,177,203,56,936
308519_GalaxyHigh.txt,964,18,53,426,103,53,26,608
308528_LegioXGemina.txt,673,17,39,283,77,32,13,405
308529_LegioXiiiGemina.txt,702,19,36,280,85,33,17,415
308530_MasonBogie.txt,789,16,49,263,115,53,48,479
308532_Lictor.txt,608,13,46,206,100,39,22,367
308535_DukeOfBraganza.txt,1598,19,84,647,163,84,42,936
3085361_GregorianBivolaru.txt,1025,18,56,389,137,78,24,628
3085812_MendipRail.txt,613,11,55,259,79,41,13,392
3087149_SinadQuinn.txt,738,15,49,287,80,69,17,453
3087152_AmericanBarFoundation.txt,1184,84,14,589,120,70,9,788
3087164_Muraqaba.txt,1518,22,69,564,210,94,47,915
3089091_Lotus49.txt,768,13,59,258,111,52,22,443
308961_Milice.txt,954,17,56,329,133,77,43,582
308964_YenHsishan.txt,1353,9,150,464,178,100,55,797
3090192_BeyondAndBack.txt,578,8,72,166,123,48,20,357
3090636_Fiddlercomics.txt,997,15,66,338,161,50,33,582
3091027_AmandaMorgandorsai.txt,1511,19,79,535,176,101,62,874
3091340_DoctorMindbender.txt,764,11,69,288,139,36,31,494
3092323_SkiParty.txt,735,12,61,307,92,59,20,478
3093575_JonRubinstein.txt,1492,38,39,569,228,116,46,959
3093584_EllaInRomeTheBirthdayConcert.txt,584,9,64,274,57,23,16,370
3093921_AllEyezOnMemonicaAlbum.txt,728,11,66,344,71,46,22,483
3094108_HarveyWard.txt,785,13,60,317,103,53,13,486
3094255_Pre1980NorthIndianCycloneSeasons.txt,571,21,27,230,59,45,9,343
3094666_YuriLowenthal.txt,699,17,41,380,63,33,16,492
309638_MalcolmBlight.txt,615,10,61,238,75,34,11,358
309641_ContinentalPhilosophy.txt,855,11,77,316,88,105,41,550
309643_GoldenRetriever.txt,1730,26,66,693,226,140,82,1141
3096492_Chapter27.txt,741,14,52,351,90,31,18,490
3096498_MaraudersharryPotter.txt,763,13,58,280,124,34,32,470
3096500_MillstreamBrewing.txt,943,22,42,473,93,50,17,633
309661_Gauteng.txt,1757,35,50,678,202,118,49,1047
309664_FogOfWar.txt,987,19,51,355,132,99,30,616
309667_LouisMalle.txt,868,12,72,396,84,47,25,552
309668_DowChemicalCompany.txt,2783,55,50,1168,335,198,72,1773
309669_Hephthalite.txt,1172,21,55,401,160,88,51,700
309670_Cuernavaca.txt,698,14,49,286,64,55,19,424
309682_AltamontFreeConcert.txt,1501,28,53,532,244,95,48,919
309689_Hawkweed.txt,657,12,54,397,48,40,6,491
3097460_OrganizationOfJapaneseFortificationsInNewGuineaArea.txt,1946,47,41,1154,129,151,26,1460
3097571_HumanTaxonomy.txt,957,15,63,368,150,101,43,662
3098949_UssHobsondd464.txt,1648,20,82,665,219,83,30,997
310051_Modernisme.txt,1165,14,83,467,124,113,63,767
310053_Uar.txt,1175,14,83,422,151,69,31,673
3100872_ChristianVoiceuk.txt,2477,37,66,900,352,165,68,1485
3101963_LordsOfMagic.txt,1156,21,55,392,159,82,28,661
3102269_ListOfArticlesAboutCcfndpMembers.txt,5225,53,98,2755,399,244,18,3416
3102673_Lumad.txt,787,17,46,300,91,73,16,480
3103404_Herzgruft.txt,1197,62,19,669,29,39,13,750
3103765_Matango.txt,744,14,53,307,95,39,23,464
3104206_Way1979.txt,885,10,88,313,111,74,25,523
3104216_NorthsouthDivideInTheUnitedKingdom.txt,1692,32,52,574,204,156,107,1041
3104368_ArchitecturalGlossary.txt,2591,86,30,915,324,191,81,1511
3105120_HistoryOfTheRussoturkishWars.txt,2762,39,70,964,382,198,70,1614
3106642_RodolfoGonzales.txt,1850,17,108,646,254,145,55,1100
310719_Jellyfishband.txt,861,21,41,435,85,47,32,599
310725_Negaraku.txt,872,19,45,336,122,48,24,530
310731_FreestyleSwimming.txt,707,15,47,284,88,41,35,448
310734_CangjieMethod.txt,2941,30,98,936,438,265,151,1790
310751_Magnesia.txt,530,19,27,209,75,36,8,328
310757_Alpha1antitrypsinDeficiency.txt,774,17,45,297,97,51,35,480
310767_Equalisermathematics.txt,930,20,46,359,117,52,47,575
310780_EurocopterTiger.txt,1042,26,40,410,134,66,24,634
310782_GeneticTesting.txt,2129,27,78,724,308,256,69,1357
3108448_LexMahumetPseudoprophete.txt,778,19,40,304,105,47,24,480
3109579_ColisteEoin.txt,1996,27,73,749,242,206,47,1244
311078_BattleOfMonsGraupius.txt,651,11,59,209,113,40,25,387
311141_ParanClube.txt,944,37,25,432,109,79,15,635
311150_BattleOfWhitneysLane.txt,1261,18,70,468,195,77,39,779
3112091_KingsOfConailleMuirtheimne.txt,581,8,72,288,49,16,15,368
3112830_ForestSchoolwalthamstow.txt,1822,42,43,821,205,121,57,1204
3113796_DickersonVUnitedStates.txt,1065,13,81,326,176,65,47,614
3113916_ChicagoMachine.txt,580,17,34,274,51,19,9,353
3115333_Earth717.txt,1053,16,65,429,133,61,26,649
3115341_SeptimaPoinsetteClark.txt,1020,16,63,417,137,49,17,620
3115383_DarkElfmegaManZero.txt,733,6,122,259,111,35,38,443
3116113_MannySantos.txt,3161,40,79,1041,548,160,145,1894
311819_RarfileFormat.txt,950,8,118,339,134,104,58,635
311821_GothicRevivalArchitecture.txt,3359,41,81,1398,349,291,95,2133
311834_TheCatchbaseball.txt,769,8,96,266,114,51,26,457
311838_PeterChristopherson.txt,745,14,53,421,53,46,16,536
3118393_ButovskayaLightMetroLine.txt,767,11,69,249,113,67,33,462
311846_Eparchy.txt,690,14,49,226,67,66,32,391
311862_SonicTheHedgehogCd.txt,3106,33,94,1094,402,267,122,1885
3118704_LongtermCare.txt,958,25,38,390,100,110,31,631
3119067_BerkeleyDailyPlanet.txt,684,16,42,263,101,47,13,424
311908_MrFreeze.txt,2934,37,79,1038,500,175,118,1831
3119133_HkrInternational.txt,483,5,96,352,11,9,3,375
3119136_BritishArmyOrderOfPrecedence.txt,1272,24,53,591,115,71,32,809
311922_HasimRahman.txt,1551,27,57,601,197,93,63,954
311923_RossKemp.txt,1130,21,53,417,151,62,30,660
311935_TheGoodSonfilm.txt,916,13,70,341,140,46,39,566
3119779_UltimaThuleswedishBand.txt,880,13,67,407,52,64,19,542
3120606_Swervetransformers.txt,803,23,34,270,120,62,35,487
3120639_BlazingSkull.txt,595,13,45,237,79,32,11,359
3120789_InitialDEpisodeGuide.txt,4067,76,53,1429,640,224,146,2439
3121569_Ballyconnell.txt,598,10,59,218,77,37,15,347
312168_JohnStainer.txt,642,13,49,279,68,44,25,416
3121702_JagatSheth.txt,675,7,96,254,78,27,20,379
3121707_UlukhaktokNorthwestTerritories.txt,695,11,63,271,84,60,26,441
312190_9m133Kornet.txt,579,12,48,228,95,44,11,378
3122589_Pronyma.txt,589,7,84,209,90,24,24,347
3122597_Christinebook.txt,1034,13,79,365,142,64,27,598
3123066_Guaicaipuro.txt,664,14,47,246,86,46,18,396
3123504_EvanTanner.txt,3022,57,53,1200,364,162,92,1818
3123505_LRSSetcityrail.txt,1109,16,69,426,217,48,28,719
3124143_WeierstrassPoint.txt,612,24,25,183,76,45,16,320
3124852_ForgottenKingdoms.txt,1866,33,56,647,282,127,58,1114
3124985_ArnoldShortman.txt,1110,10,111,371,162,76,44,653
3124987_GeographyOfScotland.txt,2393,53,45,1037,212,154,64,1467
3124997_ListOfAmphibiansOfIndia.txt,1630,15,108,1009,74,38,6,1127
3125951_SaintPatricksHighSchoolKarachi.txt,609,15,40,308,65,31,19,423
3126857_NaziExploitation.txt,592,9,65,258,70,53,26,407
3127873_CybertrondreamwaveComics.txt,1353,13,104,474,202,73,42,791
3128516_Eupatridae.txt,904,3,301,273,99,75,32,479
312905_LebaneseCivilWar.txt,7411,92,80,2834,938,499,256,4527
312906_HLAHart.txt,937,21,44,396,85,84,19,584
312912_CanadianImperialBankOfCommerce.txt,2684,95,28,1384,194,157,38,1773
3129338_Fiveenneagram.txt,1900,42,45,558,260,198,112,1128
3129434_WacawStachiewicz.txt,925,7,132,311,96,65,18,490
312976_Nwa.txt,2036,35,58,742,261,149,58,1210
312977_MattBiondi.txt,536,10,53,226,52,23,6,307
312984_HenschelHs293.txt,631,26,24,238,97,39,21,395
312989_BettinoCraxi.txt,2488,32,77,847,382,192,109,1530
312990_7WorldTradeCenter.txt,2043,34,60,827,254,155,45,1281
312991_JosefKammhuber.txt,1460,16,91,435,241,98,48,822
312993_400seriesHighwaysontario.txt,4932,73,67,1872,605,296,160,2933
312995_ResetButtonTechnique.txt,2223,24,92,761,337,148,132,1378
313013_KingPhilipsWar.txt,2335,36,64,946,277,152,78,1453
313016_Rheinbote.txt,700,15,46,219,104,66,38,427
313019_Wasserfall.txt,666,12,55,226,91,55,20,392
3131150_JeromeArmstrong.txt,675,15,45,277,78,56,11,422
3131154_JosephDesch.txt,651,11,59,258,76,41,17,392
3131219_ManipalInstituteOfTechnology.txt,2067,55,37,880,254,145,49,1328
3131789_ListOfMusicProdigies.txt,1450,15,96,592,115,99,26,832
3132246_Zipp.txt,627,12,52,247,77,55,22,401
3132707_DeclarationOfTheLillooetTribe.txt,1059,16,66,390,117,68,31,606
3132709_AllhallowsKent.txt,985,19,51,376,125,67,22,590
313283_FukuzawaYukichi.txt,2061,21,98,663,285,188,76,1212
3132877_ClanMunro.txt,4148,64,64,1558,558,170,113,2399
3132886_UniversalRemote.txt,863,13,66,313,136,60,31,540
313345_Savebaseball.txt,995,26,38,343,132,44,39,558
313346_Shutout.txt,1454,29,50,490,205,102,75,872
3133473_lskwitochowice.txt,688,12,57,266,86,53,34,439
3133479_PeetieWheatstraw.txt,854,18,47,307,120,64,30,521
313347_VoluntaryAssociation.txt,745,12,62,247,113,62,29,451
313348_NikolaiBerdyaev.txt,675,14,48,237,84,52,14,387
3133697_AfricanLiterature.txt,829,14,59,408,59,89,20,576
3133720_MonopolyPubCrawl.txt,657,19,34,291,54,39,23,407
3134763_TaxIncidence.txt,1274,20,63,467,165,100,53,785
3134769_LawrenceJegen.txt,987,10,98,446,66,35,7,554
3135539_ThreadingproteinSequence.txt,713,12,59,269,97,67,27,460
31358_TheArtOfComputerProgramming.txt,1218,19,64,454,120,103,32,709
31359_Tapas.txt,1379,21,65,496,185,138,62,881
31360_ToledoSpain.txt,1148,26,44,440,120,90,21,671
3136191_Taricha.txt,609,8,76,209,82,64,34,389
31361_TristanDaCunha.txt,1471,39,37,591,195,92,43,921
31362_ThomasRMarshall.txt,963,13,74,309,158,59,42,568
31364_ThePhysiologus.txt,1232,15,82,510,131,86,33,760
31365_TheNewYorker.txt,3932,42,93,1801,362,263,93,2519
31369_TheLizard.txt,1256,29,43,499,163,68,41,771
31371_SevenSamurai.txt,2189,25,87,735,304,158,83,1280
31388_TreatyOfBrestlitovsk.txt,1200,21,57,474,129,82,33,718
3138997_Slagar.txt,852,10,85,240,148,49,35,472
31390_TerryRiley.txt,1073,17,63,419,129,80,38,666
31392_TasmanianDevil.txt,2317,26,89,708,341,245,94,1388
3139487_ListOfTuftsUniversityPeople.txt,1563,10,156,1055,49,86,14,1204
31394_Tribulation.txt,2836,34,83,889,413,158,103,1563
31395_Tantra.txt,2688,45,59,1124,298,206,76,1704
31398_TwelvestepProgram.txt,2821,40,70,1022,383,201,103,1709
31399_TheWashingtonTimes.txt,1748,30,58,712,230,122,49,1113
31400_Type209Submarine.txt,685,24,28,263,71,52,17,403
314036_Anorthosite.txt,2008,38,52,689,275,258,89,1311
3140556_FloridaStateRoad811.txt,659,12,54,300,58,38,10,406
314055_JuscelinoKubitschekDeOliveira.txt,579,15,38,197,80,38,20,335
3140575_IslamAndSlavery.txt,4820,61,79,1593,703,420,215,2931
3140578_TzviAshkenazi.txt,1972,18,109,638,292,98,78,1106
3140595_GgAllinDiscography.txt,762,10,76,469,20,13,7,509
31405_TheNatureOfGodInWesternTheology.txt,3616,42,86,912,627,304,246,2089
314076_FordWindstar.txt,563,9,62,190,80,45,26,341
31407_Transgender.txt,3285,57,57,1026,500,400,210,2136
314084_DaltonMcguinty.txt,4320,70,61,1679,543,376,98,2696
31408_ThomasJWatson.txt,2118,29,73,761,289,116,92,1258
31409_TheLifeAndTimesOfScroogeMcduck.txt,973,10,97,393,109,58,24,584
314107_OntarioLiberalParty.txt,2775,48,57,1057,333,240,84,1714
31411_ClanMcduck.txt,666,13,51,262,91,62,17,432
3141321_39.txt,771,8,96,251,97,55,38,441
3142340_AVeryBradySequel.txt,592,11,53,259,65,32,13,369
3142341_Burnoutcar.txt,739,13,56,221,126,74,49,470
3142415_Pineboarding.txt,834,15,55,246,135,66,32,479
3142813_FockeWulfSchnellflugzeug.txt,735,15,49,248,88,68,23,427
3143908_MainPremKiDiwaniHoon.txt,618,11,56,243,88,36,26,393
3143930_RickardSandler.txt,707,13,54,272,82,36,6,396
314409_Nexrad.txt,666,10,66,246,86,73,24,429
3144275_NakajimaA6m2n.txt,614,13,47,278,62,41,16,397
3144283_DebakeyHighSchoolForHealthProfessions.txt,621,12,51,258,84,48,20,410
314489_FordGalaxie.txt,1972,30,65,658,274,185,90,1207
314493_MbiusTransformation.txt,3856,157,24,1162,536,408,142,2248
314495_Ristar.txt,2022,36,56,712,298,141,71,1222
3145631_NuclearWeaponYield.txt,1597,15,106,578,182,172,60,992
3145693_ColinMoss.txt,792,20,39,364,79,48,18,509
3145736_HessEducationalOrganization.txt,2181,33,66,751,314,195,83,1343
3145737_TheCalcuttaQuranPetition.txt,1139,25,45,427,150,49,31,657
3145743_ChrisKeller.txt,1114,14,79,389,188,51,54,682
3145747_Lout.txt,501,15,33,190,62,42,33,327
3148190_HumanRightsInTheRepublicOfChina.txt,750,9,83,287,75,81,25,468
3148646_Us4thMarineRegiment.txt,633,11,57,306,60,39,16,421
3149258_PizzaConnectionTrial.txt,722,13,55,253,106,47,15,421
3149282_ListOfUkMinorPartyAndIndependentMpsElected.txt,1301,35,37,509,155,60,28,752
3149285_ChargingOrder.txt,7388,117,63,2483,1134,402,296,4315
3151188_ColoursOfAnimals.txt,5475,20,273,1570,763,639,309,3281
315149_MartinShort.txt,1999,31,64,1052,161,102,39,1354
3151542_1980PacificTyphoonSeason.txt,802,19,42,292,101,87,23,503
3151544_CliveWearing.txt,643,12,53,215,94,42,41,392
315165_TechniquesOfKnowledge.txt,1617,20,80,516,248,96,54,914
315174_UniversityOfMaryWashington.txt,761,18,42,399,54,41,15,509
315193_CommonSenseRevolution.txt,2068,31,66,780,260,155,57,1252
315449_AviationTradersCarvair.txt,723,8,90,279,86,52,20,437
3154503_LawrenceCannon.txt,979,18,54,404,108,74,39,625
3155871_EventManagement.txt,673,19,35,303,79,50,17,449
3156706_SaturdayNightLiveAnimalSketches.txt,2364,59,40,961,311,115,86,1473
3156938_HenriPousseur.txt,1000,10,100,472,57,70,11,610
3157726_MargesSonPoisoning.txt,651,17,38,256,83,26,11,376
3157797_FlyAmericaAct.txt,1654,13,127,638,199,130,46,1013
3158870_1959PacificTyphoonSeason.txt,1473,22,66,520,193,116,39,868
3160607_PayForPerformance.txt,634,7,90,253,90,53,17,413
3160663_FatemehJavadi.txt,598,15,39,243,71,55,11,380
3161236_SnomedCt.txt,819,16,51,341,100,80,21,542
316240_Midian.txt,1670,20,83,602,220,76,44,942
316244_CharliePeacock.txt,625,10,62,309,67,27,9,412
316252_SwedishArmy.txt,663,23,28,373,39,41,5,458
316255_Avengerscomics.txt,3192,55,58,1275,410,200,96,1981
316257_Metrorail.txt,1183,25,47,522,154,72,28,776
3163094_CitizenMedia.txt,857,25,34,367,110,100,19,596
3163655_BattleOfKunyang.txt,681,8,85,250,109,29,21,409
3163658_DryCellband.txt,1001,23,43,459,120,46,29,654
3164049_Laureate.txt,618,4,154,255,84,36,17,392
316607_FiveLawsOfLibraryScience.txt,782,20,39,297,101,56,22,476
3166547_ListOfGradiusTitles.txt,942,41,22,508,60,35,10,613
3167925_SafetyOnTheMassRapidTransit.txt,1702,33,51,709,251,89,44,1093
3168401_MagneticFluxLeakage.txt,2466,20,123,922,358,204,103,1587
3169811_JamesJosephBrown.txt,696,9,77,263,90,36,21,410
3169883_SeafordRugbyFootballClub.txt,1413,32,44,524,201,80,62,867
3170772_WoolwichSteamPacketCompany.txt,1265,15,84,559,83,32,11,685
3171734_GlennPoshard.txt,800,16,50,312,94,64,17,487
3171735_StevenEJones.txt,1766,30,58,731,230,98,40,1099
3171736_GloryHunter.txt,1104,33,33,416,143,103,56,718
3172679_NewmanAndBaddielInPieces.txt,1584,34,46,515,236,112,82,945
317295_ThomasAudley1stBaronAudleyOfWalden.txt,657,9,73,242,88,23,3,356
3173242_SylviaLikens.txt,1364,19,71,469,243,68,33,813
317325_ShenBuhai.txt,616,10,61,247,81,41,14,383
3173272_Pratimoksha.txt,630,13,48,291,69,27,10,397
317328_Dormitory.txt,1430,25,57,529,180,135,78,922
3173354_SouthernPacific4449.txt,1108,13,85,399,155,81,31,666
3173356_KingdomOfParadise.txt,3529,52,67,1369,569,169,102,2209
317335_EarthlyBranches.txt,761,52,14,301,70,84,16,471
317342_MawangduiSilkTexts.txt,910,10,91,259,139,82,43,523
317348_Arborist.txt,922,12,76,338,122,102,28,590
317349_JamesFrazer.txt,716,11,65,286,67,51,24,428
31744_Ungulate.txt,822,15,54,232,138,80,49,499
31750_Ukraine.txt,6208,106,58,2231,730,584,191,3736
3175273_JournalismAndMediaStudiesCenter.txt,578,21,27,197,95,37,28,357
31752_UlyssesSGrant.txt,7888,92,85,3214,978,436,186,4814
31756_UnitedStatesCongress.txt,5347,61,87,1917,699,385,191,3192
3176680_DeliasEucharis.txt,1049,24,43,318,125,107,63,613
317700_WaltDisneysEnchantedTikiRoom.txt,1080,14,77,434,124,82,33,673
3177474_NortheastCatholicHighSchool.txt,1658,37,44,715,180,90,26,1011
3177478_PlymouthcantonMarchingBand.txt,729,27,27,483,19,25,1,528
3177546_JoanCarlyle.txt,660,20,33,325,63,34,11,433
317760_FranciscoCardinalJimnezDeCisneros.txt,1871,19,98,618,269,112,70,1069
3178506_28ActsIn28Minutes.txt,582,9,64,475,12,7,1,495
3178607_HarritonHighSchool.txt,895,16,55,359,115,74,34,582
31808_U.txt,795,10,79,301,94,66,22,483
31809_UserFriendly.txt,2103,41,51,731,313,170,83,1297
31814_UnidentifiedFlyingObject.txt,8960,100,89,3590,1211,818,332,5951
31815_Unixlike.txt,1136,24,47,444,139,109,57,749
31816_Uganda.txt,2315,47,49,901,295,195,58,1449
3181969_FusionBondedEpoxyCoating.txt,1794,30,59,681,282,161,52,1176
3182853_OuterHarborRailwayStationAdelaide.txt,787,16,49,336,85,51,19,491
3182918_InfinitymarvelComics.txt,771,11,70,262,108,45,30,445
3182944_WenvoeTransmittingStation.txt,667,17,39,288,82,32,7,409
3182984_RossParkMall.txt,722,18,40,326,75,52,14,467
318392_HistoryOfGolfInstruction.txt,2039,19,107,744,236,185,77,1242
318411_HawkerSiddeley.txt,816,12,68,374,103,48,17,542
318416_CruelAndUnusualPunishment.txt,609,12,50,206,79,53,18,356
318421_Hegesippuschronicler.txt,790,7,112,270,113,37,24,444
318439_TextMining.txt,764,12,63,370,88,72,28,558
318466_AgentSmith.txt,2759,40,68,873,420,178,116,1587
3184775_CriglernajjarSyndrome.txt,813,16,50,344,86,95,29,554
3186281_ClassReunion1928Novel.txt,605,10,60,189,77,50,24,340
3186291_JaiJagdishHare.txt,225,16,14,84,21,9,6,120
3186372_HumanRobotInteraction.txt,589,16,36,277,66,55,17,415
3186378_UnitedStatesNavyBaseball.txt,606,13,46,271,75,42,12,400
31871_UbiquitousComputing.txt,883,17,51,377,108,72,43,600
318749_HenryBotterell.txt,848,19,44,322,114,35,24,495
318784_Underemployment.txt,1103,14,78,355,183,112,67,717
318813_MandurahWesternAustralia.txt,609,13,46,241,75,38,15,369
3188712_GabrielKolko.txt,794,13,61,382,66,42,5,495
3188724_Dai2Seichouki.txt,463,7,66,264,38,21,5,328
3188727_QuakersInScience.txt,623,9,69,263,74,42,16,395
3189115_TheWeightOfTheWorldbuffyEpisode.txt,750,21,35,255,120,31,31,437
3189116_BmwR90s.txt,1779,26,68,599,248,184,51,1082
3189121_AfterLifebuffyEpisode.txt,1280,26,49,406,234,46,48,734
3189554_BleakHousetvSerial.txt,1089,22,49,399,138,83,33,653
3190640_EmeraldEmpress.txt,605,12,50,204,89,36,20,349
3190716_PhilSmith.txt,630,10,63,273,65,22,9,369
3190731_GarAlperovitz.txt,630,19,33,328,44,56,15,443
3191096_KidsAgainstHunger.txt,913,22,41,356,122,54,25,557
3191479_NeighborhoodPlanning.txt,1362,18,75,400,272,112,42,826
3192053_EnvironmentalCriminology.txt,668,7,95,238,66,79,27,410
3192441_ListOfMinorFoundationUniverseCharacters.txt,607,21,28,264,60,29,12,365
3194053_WilliamIrvinecanadianPolitician.txt,915,13,70,345,111,64,19,539
319505_QuebecSovereigntyMovement.txt,6883,113,60,2441,853,625,235,4154
319525_CameronCrowe.txt,2322,31,74,853,327,150,87,1417
319528_EritreanRailway.txt,1929,45,42,595,296,160,66,1117
319536_7400Series.txt,1359,27,50,526,148,150,42,866
3195441_MarathaLightInfantry.txt,1435,26,55,584,144,94,33,855
3197353_ListOfAntagonistsInXenosaga.txt,4330,55,78,1488,634,271,191,2584
3197812_JohnBoswellMaver.txt,762,35,21,384,62,45,13,504
319834_GeigermarsdenExperiment.txt,1113,16,69,352,155,98,48,653
319835_JimJeffords.txt,1044,15,69,406,133,53,23,615
3198383_TerrorismInTheUnitedStates.txt,4951,18,275,2220,705,172,46,3143
319840_SecretaryToTheTreasury.txt,996,11,90,526,30,17,25,598
3199160_ShenmueOnline.txt,750,16,46,265,113,48,31,457
3199167_IndianizedKingdom.txt,718,7,102,281,79,85,16,461
3199366_MahavirTyagi.txt,1131,19,59,497,143,43,29,712
3199395_AlfaRomeoSpider.txt,1094,16,68,377,150,111,40,678
3200118_StAugustinesHighSchool.txt,810,22,36,397,90,46,7,540
3200764_UssClarenceKBronsondd668.txt,846,17,49,373,89,31,9,502
3200774_Mishpatim.txt,1063,11,96,363,118,38,45,564
3200779_FinneganThePoet.txt,759,15,50,343,78,43,31,495
3200783_Brawntransformers.txt,1296,32,40,485,192,69,42,788
3201591_DeusExInvisibleWarCharacters.txt,2824,47,60,992,411,171,100,1674
3201719_RussianAmericanTelegraph.txt,647,8,80,240,81,55,25,401
3201722_DestinationImagination.txt,1959,35,55,718,263,97,59,1137
3203697_LongevityClaims.txt,1875,24,78,602,309,174,81,1166
3203751_Mnajdra.txt,570,5,114,178,83,58,22,341
3203752_Hsv7.txt,1283,26,49,637,115,38,19,809
3204171_HondaRacingF1.txt,1362,17,80,516,173,96,49,834
3204172_JimOhora.txt,808,14,57,392,79,29,11,511
3204592_TeriBauer.txt,2257,18,125,715,442,78,67,1302
3205222_June212005.txt,691,1,691,318,91,39,16,464
3205543_RocknCoke.txt,648,19,34,405,45,42,9,501
320568_AirtoairMissile.txt,2531,47,53,917,331,271,93,1612
3206085_CraigEllwood.txt,596,7,85,273,62,25,22,382
3206099_BiologicalHalflife.txt,1001,36,27,332,130,88,29,579
3206109_BernardMatthews.txt,632,24,26,244,88,42,10,384
320611_PygmyRightWhale.txt,689,10,68,244,99,54,34,431
320612_NeilTennant.txt,998,17,58,441,119,66,22,648
320622_GenpeiWar.txt,3023,36,83,1132,315,141,84,1672
320634_DisneysAdventuresOfTheGummiBears.txt,3668,41,89,1491,451,214,155,2311
320643_GlasgowQueenStreetRailwayStation.txt,847,20,42,353,107,40,18,518
320655_ListOfBisexualPeople.txt,4468,33,135,2604,241,243,75,3163
3206582_TheSchoolOfAthens.txt,666,15,44,230,85,40,11,366
320685_MarcBlitzstein.txt,698,10,69,304,73,40,15,432
3208443_Wczx.txt,1203,23,52,487,146,61,28,722
3209413_SanJoseMogote.txt,2037,32,63,734,282,179,52,1247
3209515_Khador.txt,1568,21,74,545,235,129,73,982
3209520_OldestDryas.txt,937,28,33,354,132,100,43,629
320979_DavidStarrJordan.txt,793,15,52,412,43,23,13,491
320983_FrancisRussell4thEarlOfBedford.txt,640,8,80,236,76,33,15,360
320985_Hamburglar.txt,730,6,121,256,99,59,22,436
3211425_Godefroy.txt,1017,12,84,341,123,76,13,553
3211437_YaxchilanLintel24.txt,1066,10,106,372,181,59,30,642
3211456_Rathcoolebelfast.txt,1869,19,98,745,229,162,55,1191
3211844_CimbrianWar.txt,1904,18,105,599,268,135,94,1096
3213886_Jpod.txt,1099,10,109,429,154,67,38,688
3215043_HistoryOfParliamentaryLifeInEgypt.txt,962,20,48,328,132,82,17,559
3215433_mileBnard.txt,1077,20,53,402,132,86,29,649
3215588_JeanLaplanche.txt,921,13,70,380,115,60,19,574
3216396_AreaCode386.txt,622,10,62,210,82,52,20,364
3216512_ChadKilger.txt,688,34,20,238,45,22,9,314
3216539_PlantingFieldsArboretumStateHistoricPark.txt,1067,22,48,496,111,62,18,687
3217477_Reharmonization.txt,925,22,42,311,133,67,45,556
3217954_JohnBrignell.txt,2291,39,58,753,306,199,81,1339
3218014_ProbyCautley.txt,679,16,42,208,88,52,25,373
3218324_IllFlyAwaytvSeries.txt,977,14,69,499,83,42,20,644
3218434_Fokofpolisiekar.txt,1015,17,59,425,131,57,44,657
3218783_DrugDevelopment.txt,762,10,76,335,88,57,27,507
3219407_CorrellBuckhalter.txt,1237,26,47,407,165,52,59,683
3219847_Xcorps.txt,969,16,60,330,141,74,37,582
3219942_ChrisWarrenmusician.txt,812,18,45,294,114,49,36,493
322010_QueensUniversityBelfast.txt,1020,20,51,450,104,56,28,638
3220307_JamesGreeneHardy.txt,618,8,77,242,78,43,20,383
3222235_EricNance.txt,704,15,46,245,122,31,20,418
3225161_RenaissanceOfThe12thCentury.txt,1278,25,51,503,119,135,23,780
3226110_LorenzoNeal.txt,637,19,33,285,69,38,12,404
3226703_LauraBeale.txt,1653,15,110,455,325,95,108,983
3226761_TeranceMathis.txt,620,10,62,230,84,32,14,360
3226774_TheGrudge2.txt,3827,52,73,1370,605,177,116,2268
3227521_MunicipalitiesOfRepublikaSrpska.txt,924,21,44,429,123,29,21,602
3227658_Twechar.txt,668,9,74,213,83,65,22,383
3227730_Outlandish.txt,1503,27,55,760,143,113,51,1067
322788_ListOfCollegesAndUniversitiesInFrance.txt,862,9,95,498,25,57,1,581
322789_ListOfUniversitiesInGermany.txt,839,24,34,630,5,40,1,676
3230029_EagleSaltWorksRailroad.txt,687,13,52,283,80,30,11,404
3230499_VenusWars.txt,1229,23,53,487,171,52,33,743
323103_Gyeonggido.txt,619,16,38,244,69,57,19,389
323242_Kogainuyasha.txt,1636,22,74,487,278,99,81,945
3232821_FSCNorthrop.txt,1093,14,78,435,126,58,33,652
3232824_KukiPeople.txt,1571,17,92,643,199,137,54,1033
3233800_RenalTubularAcidosis.txt,820,16,51,315,109,80,42,546
3233879_QuebecMunicipalElections2005ResultsInEstrie.txt,3642,95,38,2120,146,183,1,2450
3234843_AnPostNationalLotteryCompany.txt,2011,37,54,654,273,120,58,1105
3235199_VeralidaineSarrasri.txt,2058,19,108,684,322,110,70,1186
3235792_TheKingsCollegenewYork.txt,829,26,31,367,98,47,14,526
3235812_VladimirColin.txt,789,14,56,403,54,40,11,508
3235823_Gf13017njShiningGundam.txt,982,15,65,386,157,65,26,634
3236165_NikolaiGredeskul.txt,1076,10,107,488,96,50,9,643
3236174_Bugz.txt,615,8,76,213,98,40,15,366
3236292_RobertJovicic.txt,675,8,84,198,135,55,39,427
3236753_26thInfantryRegimentunitedStates.txt,968,11,88,363,98,83,17,561
3237121_DovetailJoint.txt,2309,45,51,871,363,167,68,1469
323903_JoachimRaff.txt,885,11,80,419,72,47,20,558
323912_CulturalEcology.txt,3518,40,87,1170,446,360,116,2092
3239140_EncantadiaPlotSummarypartTwo.txt,4755,43,110,1457,847,198,247,2749
3240521_EddieDyer.txt,865,9,96,342,97,51,13,503
3241565_MilwaukeePublicSchools.txt,752,6,125,605,11,15,2,633
324211_LawrencevilleSchool.txt,2095,36,58,1059,177,139,27,1402
324217_Silla.txt,2373,39,60,864,296,190,91,1441
3242556_RaimondoTommasoDaronco.txt,1116,16,69,455,125,69,29,678
3243075_AlbertoNaranjo.txt,722,9,80,343,69,50,22,484
32442_VladimirNabokov.txt,3387,45,75,1410,329,230,94,2063
32443_Vanuatu.txt,2081,38,54,776,242,207,52,1277
32447_PoliticsOfVanuatu.txt,881,11,80,344,112,75,19,550
32448_EconomyOfVanuatu.txt,665,37,17,273,57,54,15,399
32452_ForeignRelationsOfVanuatu.txt,641,10,64,303,70,40,15,428
32453_HistoryOfVenezuela.txt,1246,26,47,474,143,115,25,757
32454_GeographyOfVenezuela.txt,1588,34,46,630,143,164,52,989
32455_DemographicsOfVenezuela.txt,806,30,26,356,69,80,26,531
32456_PoliticsOfVenezuela.txt,801,15,53,308,72,62,9,451
32457_EconomyOfVenezuela.txt,2043,39,52,752,242,188,59,1241
3245853_VariableStar.txt,1260,17,74,451,184,68,44,747
3246408_SupremeConstitutionalCourtOfEgypt.txt,595,6,99,190,82,38,7,317
3246819_ListOfSicilianAmericans.txt,4518,61,74,1918,519,273,79,2789
3246827_NadjaBenaissa.txt,844,15,56,323,94,60,19,496
3247370_Juce.txt,1836,31,59,749,295,174,47,1265
32476_Vagina.txt,791,23,34,275,92,94,31,492
32479_Vulva.txt,1672,34,49,609,196,160,71,1036
32489_Vorbis.txt,2301,31,74,949,295,232,79,1555
32491_Vesalius.txt,1856,30,61,608,287,134,71,1100
3249258_SchindlerGroup.txt,601,12,50,224,86,45,24,379
32493_VernorVinge.txt,1178,20,58,527,98,67,29,721
3249411_SriLankaLeftistParties.txt,592,6,98,207,75,54,14,350
32494_Vi.txt,1095,21,52,438,141,92,42,713
324956_RiseOfRome.txt,2780,36,77,878,348,292,134,1652
32496_VacuumTube.txt,5480,81,67,1960,846,526,236,3568
32497_VeniceFilmFestival.txt,1721,22,78,1106,22,47,1,1176
32498_Volume.txt,825,23,35,331,87,67,23,508
32499_VectorGraphics.txt,1048,23,45,385,168,108,47,708
325009_ValveAmplifier.txt,4637,75,61,1610,633,516,291,3050
325015_SirJohnSoanesMuseum.txt,987,15,65,326,122,72,30,550
325018_JohnSoane.txt,746,13,57,303,84,47,22,456
3250314_HarryThrk.txt,573,22,26,276,52,23,17,368
325046_CharlesVanDoren.txt,760,9,84,266,107,38,33,444
3250892_SenekaBibile.txt,1165,27,43,461,151,73,23,708
3251189_PseudorandomGeneratorTheorem.txt,1656,59,28,672,213,110,70,1065
3251276_SiegfriedRdel.txt,586,14,41,217,67,31,9,324
3251842_Nadur.txt,829,19,43,309,103,60,24,496
3252218_HistoryOfGalicia.txt,3056,54,56,1074,383,238,80,1775
3253624_SamFisher.txt,3605,47,76,1272,521,277,169,2239
3253650_NighthawksupremePower.txt,1250,19,65,515,173,80,29,797
325425_HuangZhong.txt,1714,28,61,676,245,88,76,1085
325426_JamesParkinson.txt,909,17,53,296,123,77,31,527
3254485_DioceseOfLlandaff.txt,755,10,75,261,98,55,42,456
3254587_SpeidernesFellesorganisasjon.txt,667,22,30,302,87,37,11,437
3255539_Rosettahome.txt,3994,66,60,1496,612,314,174,2596
3257078_RanuccioBianchiBandinelli.txt,697,6,116,374,43,57,14,488
3257958_TheSantaClause3TheEscapeClause.txt,1870,19,98,657,299,84,75,1115
3257964_CivilServiceOfTheRepublicOfIreland.txt,1038,17,61,382,124,69,34,609
3258008_SpeedSkatingAtThe1984WinterOlympics.txt,470,15,31,381,2,11,0,394
3258930_GopalGodse.txt,689,16,43,269,105,13,19,406
3258942_JchiKhasar.txt,589,8,73,234,75,42,19,370
3258954_Alabarch.txt,627,8,78,207,82,24,27,340
3259925_AtauroIsland.txt,686,14,49,260,84,54,29,427
3260356_MossCreek.txt,859,7,122,294,115,80,43,532
3260842_NightProbe.txt,1289,20,64,547,135,80,44,806
326125_LazarOfSerbia.txt,999,14,71,383,115,52,26,576
3261305_VehicularCommunicationSystems.txt,1384,17,81,496,201,123,58,878
3261306_Dollz.txt,2567,33,77,784,442,209,135,1570
3261309_LyttonBandOfPomoIndians.txt,1040,16,65,406,144,53,25,628
3262265_MalaysianLockupDetaineeAbuseScandal.txt,2964,32,92,1086,512,159,106,1863
326456_Chicagoland.txt,1749,48,36,844,135,108,30,1117
3264689_ParametricInsurance.txt,701,12,58,270,104,67,17,458
3264747_NewEnglandCableNews.txt,892,11,81,459,62,49,16,586
326510_MalcolmSargent.txt,2132,32,66,859,238,122,76,1295
326521_Gunsan.txt,621,12,51,261,83,46,30,420
3266626_EhudAdiv.txt,733,14,52,317,71,40,19,447
3267693_ListOfAsteroids11011200.txt,1637,1,1637,615,0,23,0,638
3268027_HomageToQwertYuiopSelectedJournalism19781985.txt,2080,37,56,633,326,180,108,1247
3268201_ArturYusupov.txt,589,13,45,188,84,46,23,341
3268982_Claytontarzan.txt,1063,19,55,351,154,56,39,600
3268989_ArizonaStrip.txt,572,10,57,273,48,42,18,381
3270043_ElectricPower.txt,984,21,46,358,139,115,27,639
3270185_Wboctv.txt,1066,14,76,442,113,62,32,649
3271025_Naggaroth.txt,2125,24,88,737,286,137,54,1214
3271590_AustralianNationalAirways.txt,668,14,47,257,103,39,21,420
327176_ArtoLindsay.txt,925,19,48,403,102,79,27,611
327184_Jeonju.txt,835,17,49,323,99,81,32,535
327187_UssStargazerstarTrek.txt,641,12,53,230,109,27,20,386
327188_RonaldShannonJackson.txt,579,14,41,344,27,26,5,402
3271952_GesherpoliticalParty.txt,1817,28,64,676,229,135,76,1116
327195_TripitakaKoreana.txt,672,11,61,235,97,41,17,390
3271984_Biolinux.txt,772,23,33,291,110,87,34,522
3273440_Sovroms.txt,772,14,55,322,91,41,15,469
3274413_DubaiAmericanAcademy.txt,1271,27,47,533,141,86,37,797
3275358_MarinaAnissina.txt,527,19,27,237,51,22,12,322
3275361_WECule.txt,2008,70,28,916,189,115,32,1252
3275362_PricingStrategies.txt,615,23,26,211,108,56,12,387
327536_BucharestMetro.txt,1997,36,55,709,265,152,72,1198
3275947_JumboTsuruta.txt,850,15,56,382,84,39,19,524
3275954_NazeerAkbarabadi.txt,668,9,74,267,85,58,20,430
327600_EuropeanWindstorm.txt,2390,38,62,861,324,202,77,1464
327602_RobertPalmersinger.txt,1684,25,67,712,192,127,42,1073
3276673_CloudsInMyCoffee.txt,509,5,101,318,24,18,9,369
3277654_PrintCulture.txt,3170,41,77,1053,492,282,140,1967
3280073_GaryClark.txt,895,11,81,358,93,27,15,493
3280082_ListOfDragonlanceLocations.txt,7215,138,52,2559,1054,399,229,4241
3280230_GesangMartohartono.txt,583,10,58,170,77,90,23,360
3280233_NbaSalaryCap.txt,2871,41,70,912,409,215,103,1639
3280302_JuanoHernndez.txt,864,16,54,377,78,37,11,503
3281041_DunningSchool.txt,979,14,69,416,95,80,24,615
3281057_ThermodynamicInstruments.txt,642,12,53,184,117,44,42,387
3282007_AutonomousResearchRobot.txt,751,8,93,297,99,89,24,509
3282108_JamesPercyFitzpatrick.txt,676,19,35,281,80,23,14,398
328228_GeorgiaForce.txt,612,12,51,245,51,31,12,339
328236_OrlandoPredators.txt,1056,12,88,389,89,61,19,558
328238_BillySheehan.txt,1610,34,47,676,195,124,65,1060
328251_TerryBozzio.txt,683,23,29,359,85,33,14,491
328252_PicksTheorem.txt,594,21,28,177,69,51,17,314
328266_DeltaAndTheBannermen.txt,1363,18,75,552,179,75,39,845
328274_Palynology.txt,724,12,60,347,76,68,12,503
3283062_EconomicsOfFascism.txt,4642,51,91,1736,577,460,140,2913
328326_FritsBolkestein.txt,1057,20,52,395,128,78,20,621
328330_JackieDeshannon.txt,1241,15,82,607,113,51,31,802
328339_SapphireSteel.txt,1613,25,64,496,270,121,83,970
3284467_CharlesRiverBridgeVWarrenBridge.txt,2566,23,111,862,421,128,90,1501
3285441_NewWestminsterCity.txt,960,41,23,536,44,173,121,874
32893_Wedding.txt,871,25,34,351,107,101,22,581
32894_Weekend.txt,666,12,55,231,92,57,31,411
32895_Waltz.txt,620,21,29,231,84,55,27,397
3289787_RoyMarlinVoris.txt,2572,31,82,1026,324,141,72,1563
32897_WilliamShakespeare.txt,5237,76,68,1947,707,405,187,3246
32901_WoodyAllen.txt,4260,75,56,1940,474,265,138,2817
3290735_GovernorsOfRomanBritain.txt,994,19,52,462,62,47,21,592
32908_Warsaw.txt,5422,107,50,2215,564,420,170,3369
3292129_EarlStrickland.txt,640,10,64,272,67,32,19,390
3292_Brass.txt,947,13,72,370,144,90,35,639
329322_VictoriavilleQuebec.txt,787,17,46,349,86,64,14,513
329344_GrandePrairieAlberta.txt,3322,59,56,1270,375,305,131,2081
329382_VernonBritishColumbia.txt,949,13,73,453,99,64,23,639
3294057_CalWorthington.txt,1503,20,75,588,195,81,28,892
3294074_RomualdSpasowski.txt,858,24,35,345,116,55,17,533
3294081_BobbyRock.txt,957,15,63,367,111,77,35,590
3294082_TaxLienSale.txt,1345,15,89,449,205,99,62,815
329417_MooseJawSaskatchewan.txt,1497,33,45,746,134,94,29,1003
3296530_ShawnPaulHumphries.txt,790,13,60,274,121,34,17,446
3296648_RotaryClubOfNorthBayOntario.txt,661,8,82,271,97,38,11,417
3296672_JackChurchill.txt,773,16,48,276,118,26,17,437
329735_TimelineOfRomaHistory.txt,625,25,25,227,90,34,25,376
3297624_ChenMing.txt,816,29,28,527,68,20,7,622
3297673_ChurchlandsSeniorHighSchool.txt,730,12,60,317,84,69,19,489
329781_TrapdoorSpider.txt,567,10,56,250,65,38,18,371
3299476_SusanneOsthoff.txt,775,15,51,260,139,31,35,465
3299838_ListOfRooseveltUniversityPeople.txt,775,7,110,615,2,30,1,648
3300892_ValentinSilvestrov.txt,596,11,54,239,52,50,26,367
3300992_CreationOfATintinAlbum.txt,771,14,55,233,118,53,29,433
3301007_Monzuno.txt,646,6,107,253,70,26,14,363
3301021_VidyasagarUniversity.txt,837,15,55,479,81,33,11,604
3302985_HeavyWeathernovel.txt,1168,17,68,453,176,63,38,730
330491_RiemannstieltjesIntegral.txt,669,26,25,221,93,66,37,417
330498_ThePussycatDolls.txt,2005,46,43,918,228,116,50,1312
3305158_KursaalPalace.txt,679,16,42,236,95,61,16,408
3305261_PhantasmIiiLordOfTheDead.txt,3179,36,88,1120,507,93,84,1804
3306199_UssMoberlypf63.txt,638,11,58,261,63,30,15,369
3306201_PrideinTheNameOfLove.txt,843,21,40,326,98,70,25,519
3306222_SunrisePresbyterianChurch.txt,1077,29,37,469,134,54,17,674
3306778_VampireGame.txt,1653,21,78,556,272,93,63,984
3307187_SummitPlaceMall.txt,1140,31,36,442,138,98,34,712
330771_DashboardConfessional.txt,633,10,63,291,69,31,13,404
330773_JStuartBlackton.txt,920,13,70,322,148,56,27,553
330825_SydneyNewman.txt,3085,33,93,1119,384,200,122,1825
330826_Monguor.txt,2244,10,224,1377,121,82,15,1595
330833_Jingpo.txt,1334,21,63,556,157,104,42,859
330836_Salar.txt,568,14,40,256,52,48,15,371
3308575_HighQ.txt,668,5,133,261,81,58,19,419
3308606_OpartsHunter.txt,2399,53,45,896,385,139,75,1495
3308695_HistoryOfTheUniversityOfTexasAtAustin.txt,818,11,74,291,104,41,17,453
3308699_JesseMerz.txt,819,12,68,497,33,22,10,562
330895_AmericanMcgeesAlice.txt,7534,93,81,2426,1103,547,380,4456
330900_mileCohl.txt,4458,38,117,1586,663,331,124,2704
3311117_SenatorYouAreNoJackKennedy.txt,1336,27,49,469,205,78,54,806
3311465_ShuttlepodOne.txt,1290,23,56,438,225,57,35,755
3311472_DanKellybushranger.txt,799,16,49,257,146,40,17,460
3312509_ListOfGayAndBisexualPeopleInModernWrittenFiction.txt,1431,28,51,857,68,82,16,1023
3312919_LoudFastRamonesTheirToughestHits.txt,604,8,75,444,17,13,5,479
3312977_KfcCup.txt,1479,22,67,470,204,98,50,822
3314868_CharityStandish.txt,595,15,39,220,110,23,26,379
331538_AnitaBryant.txt,1544,23,67,602,218,88,49,957
331541_JuanBosch.txt,578,8,72,216,68,45,15,344
331575_ScouterdragonBall.txt,727,5,145,200,116,54,46,416
331582_DavidCoverdale.txt,1382,17,81,653,141,82,39,915
331586_CrocodileDundee.txt,2368,35,67,810,317,126,81,1334
331620_KatieCouric.txt,2033,21,96,843,249,140,60,1292
331621_KarlHeinrichUlrichs.txt,1508,17,88,458,227,126,56,867
3316269_GeorgianaMccrae.txt,1822,27,67,637,258,91,54,1040
3317230_JohnnyAndTheSprites.txt,1083,22,49,417,143,67,42,669
3317318_JoePoolLake.txt,1689,36,46,748,159,146,43,1096
3318391_TirasoulCalibur.txt,1212,21,57,383,200,82,50,715
3318850_AustralianRailwaySignalling.txt,1431,39,36,538,192,159,43,932
331921_CommonName.txt,1106,17,65,340,183,152,49,724
331980_InternationalSocialistGroup.txt,636,15,42,270,70,42,18,400
3319810_AFishfulOfDollars.txt,853,13,65,351,119,55,25,550
3319867_MandybillyAndMandy.txt,914,9,101,322,121,65,52,560
3322619_DesertCrossing.txt,909,21,43,324,152,35,31,542
3322647_PanzerDragoonSaga.txt,3200,47,68,1038,508,267,143,1956
3323587_DavyJonespiratesOfTheCaribbean.txt,1313,20,65,484,185,77,53,799
3324141_CcChapman.txt,575,15,38,244,78,46,13,381
3324540_Shroob.txt,1230,19,64,474,189,64,41,768
3324549_BillNighbert.txt,777,17,45,328,98,37,22,485
3325015_Wralfm.txt,555,16,34,238,55,41,12,346
3325109_NewJerseyRoute92.txt,661,10,66,226,95,30,23,374
3325951_Discodermolide.txt,643,11,58,364,50,38,6,458
3326136_PoudreHighSchool.txt,971,29,33,472,76,52,18,618
3326529_ErieCanalCommission.txt,1824,23,79,698,207,118,55,1078
332669_ListsOfRadioStationsInNorthAmerica.txt,283,14,20,200,16,6,6,228
332676_ListOfRadioStationsInOntario.txt,3600,173,20,2223,19,119,6,2367
332702_UnitedKingdomGeneralElection1945.txt,815,17,47,260,133,73,30,496
332711_ChurchillWhitePaper1922.txt,1138,15,75,371,161,63,42,637
332713_GoTransit.txt,4189,68,61,1876,508,234,113,2731
3327857_NoillyPrat.txt,696,18,38,242,107,58,31,438
3327872_PetteriNummelin.txt,783,10,78,289,62,40,6,397
3327958_PatSinLengCountryPark.txt,726,18,40,350,72,46,29,497
3330312_JackDrake.txt,878,13,67,305,150,47,40,542
333096_SocialHistoryOfThePiano.txt,967,14,69,315,119,95,59,588
3331358_LocalGovernmentAct1888.txt,1311,27,48,496,176,94,28,794
3332330_JamesCobban.txt,567,9,63,202,61,33,16,312
3332678_BrentWilkes.txt,1608,33,48,682,233,66,27,1008
3332796_NonmuslimViewOfAli.txt,581,30,19,206,88,43,21,358
3333284_SteveReichAndMusicians.txt,539,15,35,303,47,31,15,396
3333294_FrancoBonvicini.txt,670,11,60,280,69,55,24,428
3336613_WillTheCircleBeUnbroken.txt,617,7,88,310,46,34,15,405
333720_BlackwallTunnel.txt,917,12,76,343,119,66,45,573
333723_RotherhitheTunnel.txt,877,16,54,293,113,60,39,505
333757_ListOfKPostalCodesOfCanada.txt,474,164,2,375,81,2,2,460
333763_Crieff.txt,721,12,60,267,98,41,24,430
333790_ListOfAlbertaProvincialHighways.txt,661,10,66,311,33,72,7,423
333791_ErnestTubb.txt,938,12,78,343,126,55,34,558
3338631_TheForestRangers.txt,526,11,47,356,32,13,4,405
3340579_NewZealandFireService.txt,1991,43,46,843,237,119,70,1269
334097_AdrianFrutiger.txt,2106,20,105,679,367,159,96,1301
334100_Zaka.txt,757,17,44,317,90,51,19,477
3341483_JanJanssen.txt,563,10,56,218,62,36,15,331
334162_CarlosRobertoReina.txt,997,19,52,334,101,81,24,540
334173_ListOfGardenPlants.txt,3200,59,54,2827,80,153,32,3092
334187_PremierOfBritishColumbia.txt,578,14,41,212,67,46,16,341
3342108_ShuttleMachinery.txt,828,14,59,283,131,63,32,509
3342113_AndrDeChauvigny.txt,844,11,76,318,101,49,20,488
3342135_FamousBlueRaincoat.txt,774,14,55,267,96,49,42,454
3343919_UnionCatholicRegionalHighSchool.txt,567,10,56,327,47,35,4,413
3345456_WilliamPLawrence.txt,662,12,55,317,60,26,6,409
3346382_ListOfScientologyOrganizations.txt,3456,96,36,1898,174,79,47,2198
3347463_Husaberg.txt,547,31,17,211,64,43,21,339
334800_OrlandoPiratesFc.txt,1303,77,16,699,97,62,16,874
3348176_WalterKaiserJr.txt,561,7,80,302,34,27,6,369
334825_AncientArt.txt,2085,39,53,735,294,207,99,1335
334829_WesternArtHistory.txt,1855,41,45,711,226,185,72,1194
334848_PassionFlower.txt,1027,22,46,380,157,82,38,657
3348815_ManilaTimes.txt,805,23,35,288,134,40,28,490
3348837_RoyalFreeAndUniversityCollegeMedicalSchool.txt,548,14,39,275,39,29,11,354
3349806_AbrahamJTwerski.txt,563,7,80,380,23,13,12,428
3350162_MinistryOfPublicSecurityOfPoland.txt,2725,62,43,1383,248,194,45,1870
3350737_MichaelDemiurgos.txt,819,9,91,245,153,54,37,489
335207_SkiBoot.txt,1146,18,63,395,174,122,75,766
3352539_SentryGun.txt,621,15,41,268,73,46,17,404
3352_Blues.txt,6083,87,69,2451,705,668,188,4012
3353219_CatawbaCollege.txt,685,17,40,358,71,31,10,470
3353505_ListOfBachCantatasByLiturgicalFunction.txt,2531,73,34,1615,111,49,21,1796
33536_WilliamRandolphHearst.txt,2609,36,72,1089,313,168,78,1648
33537_Wing.txt,1266,23,55,475,166,119,42,802
33538_Week.txt,2257,29,77,771,266,191,88,1316
33539_WhiteTrash.txt,1388,19,73,628,166,110,53,957
33543_ListOfRecipes.txt,1155,56,20,845,55,65,7,972
3354919_ClanBorthwick.txt,736,26,28,301,99,36,21,457
3354976_Earthtransformers.txt,1126,12,93,383,161,88,38,670
3355124_DeirdreMccloskey.txt,719,14,51,326,49,32,13,420
3356094_VictoryMonumentbangkok.txt,559,8,69,177,72,52,14,315
33563_WordProblemForGroups.txt,2545,78,32,825,363,220,122,1530
3356_BillClinton.txt,6548,100,65,2806,722,417,137,4082
33573_WallaceAndGromit.txt,2467,66,37,967,317,172,71,1527
3357565_Watermen.txt,587,11,53,238,57,37,21,353
33575_WorldTradeCenter.txt,5231,77,67,2102,652,344,108,3206
33580_WilliamSaroyan.txt,2212,37,59,822,282,126,72,1302
33582_WorldFoodProgramme.txt,919,23,39,408,100,62,17,587
33583_WorldHealthOrganization.txt,1844,43,42,775,191,124,63,1153
3358499_JonasHIngram.txt,646,17,38,267,65,29,8,369
335929_PeterIOfBulgaria.txt,1193,16,74,433,160,81,45,719
335932_HistoryOfSculpture.txt,1541,37,41,575,195,136,44,950
335936_BorisIOfBulgaria.txt,979,13,75,375,119,58,21,573
335937_SumidaTokyo.txt,580,11,52,360,45,29,1,435
335944_taGunma.txt,1015,14,72,452,78,75,9,614
3360262_SizeChanging.txt,1075,15,71,317,168,105,66,656
3360481_BlackBritish.txt,2085,28,74,759,296,181,93,1329
3360905_CynthiaGregory.txt,664,10,66,297,81,39,11,428
3361223_HowardsEnd.txt,811,10,81,303,110,60,26,499
3361893_ArthurFrothingham.txt,729,8,91,320,74,31,15,440
3362706_UssWaltonde361.txt,2740,37,74,1208,277,125,54,1664
3362800_WorldsOfWonder.txt,681,14,48,277,92,55,32,456
336297_AbuSimbel.txt,1215,23,52,439,141,90,32,702
336301_JohnJenkinscomposer.txt,760,21,36,294,89,60,12,455
336353_BrianStonehouse.txt,596,11,54,210,83,27,11,331
336357_HugoBleicher.txt,602,8,75,209,86,26,18,339
336367_DeborahSampson.txt,1418,16,88,414,225,70,58,767
3363759_E470.txt,705,8,88,283,66,49,17,415
3365595_JamalNebez.txt,953,6,158,469,58,42,5,574
3365654_MitchellParkHorticulturalConservatory.txt,747,15,49,277,107,61,22,467
3367199_DragonlanceTheNewAdventures.txt,2205,31,71,875,239,132,62,1308
3367269_Backstoptransformers.txt,616,11,56,212,92,32,19,355
3368141_StanfordUniversityArboretum.txt,588,8,73,209,74,44,21,348
3368580_DynamicEnergyBudget.txt,941,12,78,395,107,103,31,636
3368581_JamesWoodforde.txt,925,12,77,303,111,60,38,512
3368967_Rohtak.txt,2514,27,93,1054,255,213,56,1578
3369181_SharpesTriumphnovel.txt,724,9,80,313,98,29,19,459
3369537_FarmallTractor.txt,1040,19,54,381,136,80,26,623
3369555_MercedesSimplex.txt,1010,31,32,366,129,105,44,644
336979_JaguarsInMesoamericanCulture.txt,2580,29,88,878,336,222,98,1534
336986_ChristianDemocraticUnioneastGermany.txt,561,16,35,251,48,37,11,347
336988_PeterGzowski.txt,662,12,55,306,63,30,10,409
3369934_WayneGrubb.txt,594,9,66,179,80,47,18,324
337004_Shellprojectile.txt,3581,47,76,1166,543,383,143,2235
337011_Distributednet.txt,520,15,34,227,66,40,11,344
337012_VisionSerpent.txt,1187,25,47,423,169,77,33,702
337019_RobertToddLincoln.txt,915,17,53,377,102,42,20,541
337026_JayRockefeller.txt,1089,22,49,495,101,55,20,671
337065_ExplodingbridgewireDetonator.txt,758,14,54,255,91,95,38,479
337069_HerneBayKent.txt,1772,32,55,780,214,108,48,1150
337070_CharlesGreeleyAbbot.txt,635,13,48,234,83,44,18,379
337082_BiologicalWeaponsConvention.txt,959,20,47,364,128,74,31,597
337083_ParticleSwarmOptimization.txt,1425,33,43,508,180,144,46,878
337089_YeovilTownFc.txt,1138,34,33,494,106,66,22,688
337090_SocietyForAmericanBaseballResearch.txt,817,15,54,526,49,26,14,615
337101_Marianne.txt,1508,24,62,523,188,149,37,897
3371414_ReformOfTheHouseOfLords.txt,5227,55,95,1661,730,461,173,3025
3371454_GovernmentPerceptionAffectedByMassMedia.txt,611,18,33,222,84,53,41,400
3372377_OpticalFiber.txt,4059,57,71,1437,585,485,146,2653
3372530_PotentialAndNewSlayers.txt,3033,64,47,1034,460,236,108,1838
3373310_TraditionalKnowledge.txt,5677,105,54,2216,641,660,153,3670
337380_WestAustralianFootballLeague.txt,2841,78,36,965,394,215,112,1686
3374000_StockholmCongestionTax.txt,1393,30,46,474,211,90,49,824
337409_MarkusWolf.txt,772,12,64,301,95,36,22,454
337451_AcademicFencing.txt,1416,22,64,441,206,153,57,857
3374721_NederduitsGereformeerdeKerk.txt,1003,21,47,352,134,75,38,599
3374912_LakeWorthLagoon.txt,721,7,103,291,98,34,17,440
3375876_PinOakMiddleSchool.txt,783,28,27,405,105,35,6,551
3376653_NinesWideWorldOfSport.txt,1306,34,38,677,113,77,26,893
3376894_CatalanNegationism.txt,1645,14,117,542,200,167,47,956
3378263_JohnMichaelTalbot.txt,892,10,89,426,65,27,5,523
3378265_ListOfHobbitFamilies.txt,1199,16,74,516,120,52,49,737
3379255_MieczysawSmorawiski.txt,926,8,115,318,100,63,23,504
3381065_WonderBoyInMonsterWorld.txt,1526,36,42,631,202,105,45,983
338135_CasualtyActuarialSociety.txt,780,16,48,309,105,76,19,509
338154_Wound.txt,1477,23,64,444,246,126,56,872
338161_NullCharacter.txt,696,15,46,234,115,58,38,445
338164_BigBlack.txt,1073,29,37,452,139,68,44,703
338169_CardiffUniversity.txt,1472,30,49,664,151,56,22,893
338189_Diaphragmcontraceptive.txt,2387,48,49,763,382,205,111,1461
338190_CockfostersTubeStation.txt,568,19,29,217,73,40,13,343
338195_BengaliScript.txt,1089,22,49,384,142,88,50,664
3382456_SpikeTvVideoGameAwards.txt,827,12,68,424,83,40,25,572
3382612_ListOfSoloPianoPiecesRussian.txt,1777,34,52,890,12,64,4,970
3384551_ListOfNewHampshireHistoricalMarkers125.txt,1340,27,49,560,132,103,27,822
3384636_ListOfNewHampshireHistoricalMarkers151175.txt,2413,27,89,945,290,142,67,1444
3384652_ListOfNewHampshireHistoricalMarkers176200.txt,1284,15,85,504,168,78,30,780
3384994_WarNovel.txt,2055,19,108,1072,122,162,34,1390
3385343_OksanaChusovitina.txt,536,12,44,196,65,44,19,324
338540_EmperorWenOfHan.txt,2727,29,94,1010,370,163,116,1659
3385620_ScienceAndTheBible.txt,2841,32,88,1113,329,255,95,1792
3385969_YahooAnswers.txt,1483,30,49,548,241,95,59,943
3386062_CriticismOfTheBible.txt,1814,23,78,582,236,192,89,1099
3389686_RockinghamPottery.txt,1420,29,48,496,195,150,61,902
3391372_ArgentineNationalGendarmerie.txt,618,32,19,301,60,52,16,429
3392103_ArchivoGeneralDeIndias.txt,728,9,80,292,70,42,7,411
3392310_KelvinGroveStateCollege.txt,796,44,18,337,102,51,16,506
3392353_KulanGath.txt,932,9,103,321,147,71,29,568
339244_LameDuckpolitics.txt,589,8,73,180,93,43,22,338
339245_MeramecRiver.txt,722,11,65,308,77,51,25,461
3393730_Tasmania1900Berlin.txt,776,12,64,293,86,50,20,449
3393762_TempusforgottenRealms.txt,635,12,52,219,91,42,32,384
3394022_JaySigel.txt,570,9,63,270,46,28,10,354
3394023_Stereo.txt,554,10,55,246,52,32,15,345
3395442_Keepers.txt,767,10,76,265,121,51,31,468
3395503_3121album.txt,812,12,67,375,85,59,18,537
339631_RemoteManipulatorSystem.txt,807,14,57,342,100,46,12,500
3396407_RobinsonCo.txt,1238,20,61,490,169,68,36,763
3396604_JoeBrownboxer.txt,1009,13,77,416,120,49,34,619
3396612_ObrerosUnidos.txt,654,9,72,313,61,41,13,428
3398091_FrenchGovernmentMinisters.txt,818,11,74,366,66,48,27,507
33980_WaterfallModel.txt,3066,38,80,1052,477,239,148,1916
3398101_AztecSunStone.txt,777,25,31,288,113,39,19,459
3398395_HansKraus.txt,981,19,51,371,137,68,30,606
33984_Weathermanorganization.txt,4350,91,47,1894,477,255,96,2722
3400401_JeffersonBarracksMilitaryPost.txt,931,23,40,415,115,52,20,602
3400996_LesAventuresDeRabbiJacob.txt,898,15,59,344,119,79,26,568
3402793_UniversitySportingBlue.txt,2160,51,42,859,261,130,61,1311
340289_IrishLanguageInNorthernIreland.txt,922,23,40,363,111,68,23,565
340294_PentagonalNumberTheorem.txt,1135,47,24,370,117,68,37,592
340295_EthylCarbamate.txt,1046,14,74,519,118,51,28,716
340328_Jti.txt,588,17,34,297,63,49,18,427
340372_WilhelmLiebknecht.txt,597,11,54,226,63,31,13,333
340375_RenFavaloro.txt,1348,26,51,531,144,92,20,787
34039_WestPakistan.txt,652,10,65,260,78,58,14,410
34040_WestBengal.txt,4377,58,75,1906,488,362,102,2858
34043_Wormhole.txt,2879,37,77,991,399,250,92,1732
34044_WebBanner.txt,860,19,45,348,111,61,14,534
34046_Wanniyalaaetto.txt,2597,61,42,959,359,206,100,1624
3405756_WansteadFlats.txt,882,8,110,286,122,72,37,517
3405773_RogerSillence.txt,586,9,65,183,63,47,23,316
3405797_Commodore64Peripherals.txt,4792,67,71,1644,670,480,241,3035
3406204_Defendersireland.txt,1312,18,72,435,203,70,48,756
3407587_HighlanderEndgame.txt,1469,28,52,508,239,71,57,875
3407708_JosngelGutirrez.txt,1288,19,67,581,142,51,29,803
3407720_Exotropia.txt,815,15,54,251,149,60,45,505
3408553_lvaresDeAzevedo.txt,1049,16,65,409,104,71,20,604
3410056_ListOfAsteroids9700197100.txt,1329,1,1329,324,0,4,0,328
3412874_ColumbiaUniversityChapterOfSds.txt,5749,16,359,2167,795,478,249,3689
3412896_BiddingFeeScheme.txt,779,21,37,252,105,65,47,469
3413059_FireEmblemPathOfRadiance.txt,4413,29,152,1581,584,293,163,2621
3413472_FrenchRevolutionaryArmy.txt,2768,42,65,1004,371,223,64,1662
341374_Almamun.txt,1256,20,62,393,192,105,33,723
341377_JapaneseGrandPrix.txt,901,11,81,285,146,64,35,530
3413865_ListOfAsteroids9680196900.txt,1336,1,1336,334,0,1,0,335
341418_KoreaUnderJapaneseRule.txt,6346,82,77,2252,848,579,190,3869
3414428_SalvatorFabris.txt,1010,15,67,439,109,77,25,650
3414439_Sune.txt,595,13,45,211,81,38,29,359
3414511_OthernessfPaulWilson.txt,697,10,69,247,98,48,31,424
341466_ArnoldRtel.txt,1132,26,43,385,144,81,29,639
3416349_TantallonCastle.txt,840,14,60,358,106,28,17,509
3417176_GaetanoLococo.txt,808,8,101,284,127,36,28,475
3417410_Yamigo.txt,780,19,41,269,116,55,31,471
3417426_PublicSchoolsAssociation.txt,1169,25,46,532,118,56,7,713
341766_PopGoesTheWeasel.txt,1344,42,32,482,177,75,33,767
3418823_PhiMuDelta.txt,1655,23,71,757,186,102,44,1089
3418824_MadanLalDhingra.txt,887,22,40,313,145,63,26,547
3419182_PajamaSam.txt,665,5,133,273,79,36,18,406
3419636_WilliamRogerbillMoss.txt,1067,46,23,506,134,38,12,690
3419749_MinisterOfWorshipfrance.txt,881,2,440,378,5,31,2,416
3423140_DietmarVonAist.txt,586,11,53,287,52,34,17,390
3423142_RussiaukraineGasDispute.txt,4771,43,110,1692,643,324,156,2815
3424124_TheVisitortvSeries.txt,654,14,46,240,99,30,34,403
342493_RedFlag.txt,1807,37,48,636,268,109,69,1082
342504_FiveSolas.txt,1199,7,171,416,150,69,56,691
342505_TheAngryBeavers.txt,2340,29,80,922,308,130,122,1482
342520_FuelEfficiency.txt,3189,38,83,1199,359,286,99,1943
342555_McmasterUniversity.txt,3545,86,41,1521,372,266,72,2231
3425953_SocialInnovation.txt,1046,20,52,458,87,109,33,687
3426485_Citv.txt,1620,25,64,661,198,79,68,1006
3426531_ListOfNeighbourhoodsInEdmonton.txt,678,19,35,487,30,19,12,548
3427536_ListOfQueensUniversityPeople.txt,1292,15,86,822,20,74,5,921
3428447_LaylaMiller.txt,969,15,64,328,162,67,40,597
342847_TowerSubway.txt,987,17,58,339,123,64,34,560
342912_MeditationsOnFirstPhilosophy.txt,8224,116,70,2029,1361,527,524,4441
342924_BeijingInstituteOfTechnology.txt,835,25,33,367,77,71,5,520
3429344_WakeCountyPublicSchoolSystem.txt,947,37,25,699,55,39,12,805
3429411_RichardWarren.txt,1395,33,42,597,160,67,40,864
3431269_ClaudyBombing.txt,607,12,50,216,92,26,14,348
3432674_Afpl3.txt,851,6,141,376,69,118,10,573
3433597_SouthAfricanCricketTeamInIndiaIn200506.txt,1068,21,50,493,114,42,12,661
3434280_RenaissanceHighSchool.txt,1821,35,52,1005,156,114,28,1303
343552_Phthalates.txt,983,16,61,399,125,97,31,652
343554_JessicaAlba.txt,1381,26,53,499,202,69,43,813
343556_Koei.txt,975,18,54,480,101,41,25,647
343559_EmperorHuanOfHan.txt,2360,26,90,870,355,133,95,1453
343560_JackBlack.txt,1593,28,56,708,178,102,51,1039
343585_OnlineMusicStore.txt,777,10,77,278,116,85,42,521
343588_EmperorLingOfHan.txt,2257,28,80,802,336,156,80,1374
343594_MargaretTrudeau.txt,801,22,36,276,121,58,18,473
3436202_Mitek.txt,888,15,59,359,122,56,26,563
3438543_RonGreschner.txt,404,23,17,137,14,7,2,160
3438588_TheBeatlesLondon.txt,2163,37,58,845,332,93,66,1336
3438593_RightOfRevolution.txt,662,9,73,210,79,61,20,370
343939_EducationInSweden.txt,2663,35,76,968,347,278,116,1709
3439961_MihaiNechita.txt,702,14,50,310,57,50,15,432
344000_FoGuangShan.txt,1926,37,52,1019,196,126,48,1389
344025_Hyperreality.txt,1127,15,75,414,143,76,45,678
3441299_PaulFranze.txt,941,19,49,347,125,59,27,558
3441971_StabilityAndControlOfAnAeroplane.txt,926,13,71,274,124,84,47,529
3442905_PolygraphicSubstitution.txt,569,11,51,144,85,64,42,335
3444912_UnapproachableEast.txt,821,19,43,377,89,35,23,524
344642_CarlAndrewSpaatz.txt,1209,13,93,528,125,56,12,721
344647_RolaidsReliefManOfTheYearAward.txt,657,71,9,386,29,17,6,438
344673_Apocynaceae.txt,721,21,34,340,65,74,18,497
344686_SeeItNow.txt,812,18,45,313,105,57,31,506
344698_PietroDamiani.txt,2010,26,77,680,268,118,70,1136
3447262_SquirrelBoy.txt,2153,31,69,803,346,106,115,1370
3447267_Orbirail.txt,591,13,45,249,68,48,26,391
344761_RainbowBridgeNationalMonument.txt,989,12,82,406,124,62,37,629
3448120_HighendAudioCables.txt,795,15,53,263,109,96,34,502
3449103_SymphonyNo3vaughanWilliams.txt,596,3,198,184,77,51,36,348
3449219_ThePunisherKillsTheMarvelUniverse.txt,1565,26,60,529,257,91,61,938
3449618_HadithOfUmarAndForetelling.txt,689,17,40,240,96,48,24,408
3449626_ListOfFamousAbAnbarsOfQazvin.txt,638,23,27,325,53,31,9,418
345053_Remagen.txt,957,20,47,362,117,64,24,567
3450602_ChicagoBotanicGarden.txt,743,32,23,362,65,65,9,501
345093_PavelNakhimov.txt,615,10,61,253,60,40,14,367
345095_BillWalton.txt,1787,20,89,667,237,107,62,1073
345116_EjectiveConsonant.txt,666,16,41,203,97,98,27,425
345117_SiriusSatelliteRadio.txt,3986,60,66,1687,488,335,100,2610
3452627_Yechi.txt,1303,20,65,432,185,85,47,749
3455051_Phosphonate.txt,917,12,76,351,128,104,37,620
3455776_KaramanliDynasty.txt,688,13,52,294,72,34,22,422
3456027_SpeedymiaDearden.txt,595,10,59,213,91,44,24,372
3456809_ListOfAdministrativeDivisionsOfGermany.txt,1837,2,918,782,19,117,8,926
345757_CracDesChevaliers.txt,854,14,61,284,126,53,17,480
345802_JohnCena.txt,3739,71,52,1559,506,174,106,2345
345825_MackennasGold.txt,592,10,59,216,90,26,19,351
3458347_SarahJayneVercoe.txt,1076,18,59,350,166,65,36,617
3458350_OklahomaStateHighway3.txt,1082,19,56,386,119,45,23,573
345841_ContinuousFunctiontopology.txt,1327,20,66,435,178,142,63,818
345845_XyzAffair.txt,576,10,57,247,66,33,12,358
34612_1948.txt,3638,52,69,2124,162,135,25,2446
34613_1930s.txt,1694,27,62,1039,132,89,17,1277
3461417_VancouverPoliceDepartment.txt,775,22,35,360,93,37,18,508
3461431_HowHermesRequisitionedHisGrooveBack.txt,1020,10,102,377,155,48,43,623
346145_TheEggAndI.txt,627,7,89,236,87,27,7,357
3461478_ShatterDead.txt,639,10,63,194,107,37,35,373
34615_1920s.txt,1468,23,63,818,130,73,24,1045
3461666_ChristianWilhelmAllers.txt,574,11,52,232,77,34,15,358
34616_1912.txt,2714,70,38,1591,99,89,16,1795
34617_1913.txt,2632,64,41,1518,138,81,20,1757
346185_IsoImage.txt,636,7,90,266,77,65,12,420
34618_1901.txt,2235,24,93,1288,108,95,18,1509
34619_1900s.txt,616,9,68,520,14,16,0,550
346200_KurtAngle.txt,2972,40,74,1355,351,106,46,1858
34620_1828.txt,500,14,35,298,17,12,5,332
34621_1910s.txt,986,12,82,600,70,42,18,730
34622_1944.txt,4901,48,102,2824,260,189,38,3311
3462379_SanctuaryangelEpisode.txt,1176,16,73,382,183,43,51,659
3462386_WarZoneangelEpisode.txt,695,15,46,260,108,27,16,411
3462395_BlueCrossAndBlueShieldAssociation.txt,1316,24,54,741,116,63,20,940
34623_1865.txt,1886,30,62,1056,118,78,26,1278
3462401_BlindDateangelEpisode.txt,2050,19,107,658,400,64,66,1188
3462437_JudgmentangelEpisode.txt,1061,21,50,365,161,44,42,612
34624_1945.txt,6066,55,110,3301,395,285,48,4029
34625_14thCentury.txt,589,6,98,273,38,15,7,333
34626_1860s.txt,520,9,57,298,34,18,4,354
34627_1788.txt,874,17,51,470,43,35,6,554
34629_1942.txt,4768,39,122,2699,231,206,41,3177
34631_1946.txt,4494,40,112,2729,166,146,23,3064
3463364_HighSchoolMusical.txt,3862,58,66,1563,476,218,122,2379
34645_11thCentury.txt,830,13,63,347,80,56,11,494
34649_1907.txt,2174,58,37,1257,95,91,12,1455
34650_1906.txt,2322,50,46,1353,87,120,11,1571
34651_1904.txt,2175,55,39,1282,82,94,11,1469
34652_1902.txt,1835,53,34,1112,56,54,18,1240
34653_1900.txt,2991,45,66,1661,164,132,17,1974
34654_1974.txt,4763,57,83,2730,256,186,40,3212
34655_1968.txt,4091,51,80,2380,192,163,29,2764
34656_1929.txt,2622,49,53,1563,97,92,14,1766
3465787_ConnaughtHallLondon.txt,1335,28,47,584,156,118,30,888
34657_1966FifaWorldCupFinal.txt,1066,19,56,384,156,67,36,643
3465848_KrondorsSons.txt,978,18,54,384,124,35,23,566
34658_1995.txt,4950,43,115,2583,368,237,49,3237
34659_1961.txt,4304,41,104,2336,272,205,34,2847
34661_1976.txt,5244,55,95,2980,286,178,56,3500
34662_1959.txt,3214,71,45,1873,143,127,28,2171
34663_1994.txt,5069,45,112,2602,364,236,50,3252
34664_1960.txt,4505,44,102,2517,282,207,42,3048
34665_1919.txt,2599,48,54,1565,139,98,13,1815
34666_1848.txt,1529,16,95,810,118,62,16,1006
34667_1866.txt,1330,10,133,706,70,67,15,858
3466881_Elending.txt,1619,34,47,522,261,141,70,994
34668_1896.txt,1517,42,36,862,66,73,11,1012
34669_1992.txt,4426,39,113,2321,305,201,34,2861
34670_1988.txt,5217,70,74,2913,317,219,36,3485
34671_1972.txt,6494,56,115,3591,406,250,52,4299
34674_1928.txt,2489,42,59,1460,119,95,20,1694
346865_Basil.txt,1641,28,58,550,247,181,77,1055
346905_GianfrancoZola.txt,1344,17,79,501,165,107,26,799
3469131_BabaSehgal.txt,717,9,79,487,48,21,12,568
346939_CarobTree.txt,572,14,40,191,96,56,27,370
346946_PacificSouthwestAirlines.txt,1055,18,58,457,141,56,24,678
346947_TaKungPao.txt,568,12,47,203,62,60,17,342
346949_RockhurstUniversity.txt,1765,44,40,970,130,118,31,1249
3469742_DaysOnTheGreen.txt,1580,84,18,965,82,48,27,1122
3470075_SuburbanHandicap.txt,796,8,99,268,29,23,4,324
3470675_ListOfAsteroids9180191900.txt,1363,1,1363,360,0,2,0,362
3470676_ListOfAsteroids9170191800.txt,1303,1,1303,302,0,0,0,302
3471142_WorldHeroes.txt,706,18,39,291,99,52,22,464
3471144_SomnambulistangelEpisode.txt,845,21,40,282,146,32,28,488
3471146_ParliamentOfGeorgia.txt,1162,36,32,441,144,75,12,672
3471638_FreestyleFriday.txt,1513,59,25,838,63,33,26,960
3472107_HistoryOfFredericton.txt,1159,19,61,422,150,94,32,698
3472122_LeonidGrabovsky.txt,669,14,47,324,36,47,9,416
347235_WesCravensNewNightmare.txt,1069,12,89,384,161,59,39,643
347297_DesignatedHitter.txt,2047,28,73,680,314,148,99,1241
3474509_SscAero.txt,571,19,30,231,65,49,16,361
3474674_SimonJamesmusician.txt,635,9,70,276,73,33,11,393
3475515_DemonDeacon.txt,687,14,49,266,88,65,20,439
3475521_MaltesePeople.txt,791,22,35,287,86,59,21,453
3477425_Rybka.txt,638,19,33,261,58,42,10,371
3478858_ValkyrieProfileLenneth.txt,2252,37,60,944,270,182,85,1481
3479779_PortraitOfAlofDeWignacourtAndHisPagecaravaggio.txt,643,8,80,227,66,44,17,354
3479792_Sennelager.txt,606,14,43,209,69,57,22,357
3479985_ListOfHospitalsInNewYork.txt,1482,7,211,1431,2,8,3,1444
348000_ZinovyRozhestvensky.txt,641,5,128,222,89,53,15,379
348015_ListOfGayLesbianOrBisexualComposers.txt,832,27,30,449,52,50,10,561
3480736_FinalDetroitTigersGameAtTigerStadium.txt,1654,35,47,625,165,73,42,905
3480742_TheMadeiraSchool.txt,1866,48,38,846,218,149,43,1256
3480816_ListOfAsteroids8960189700.txt,1311,1,1311,311,0,0,0,311
3480825_ListOfAsteroids8940189500.txt,1312,1,1312,310,0,0,0,310
3480828_ListOfAsteroids8930189400.txt,1313,1,1313,311,0,0,0,311
3481395_ListOfAsteroids8760187700.txt,1327,1,1327,326,0,0,0,326
3481777_TimelineOfNorthumbriaAndNorthumberland.txt,706,19,37,332,74,34,8,448
3482308_SajjadAli.txt,682,17,40,313,74,55,24,466
3483206_ChrisHarrisspeedwayRider.txt,699,21,33,252,90,57,23,422
3483338_NationalJewishMedicalAndResearchCenter.txt,1473,19,77,577,186,110,43,916
3484133_ThePitDragonTrilogy.txt,699,16,43,229,119,30,38,416
348444_PersecutionOfMuslims.txt,4836,70,69,1814,658,322,132,2926
348454_Cahokia.txt,1185,24,49,440,160,112,27,739
3484744_Indianapolis500Firsts.txt,998,30,33,419,79,95,8,601
3485102_199495InEnglishFootball.txt,2509,83,30,1079,284,138,55,1556
3485711_SpanishRiverCommunityHighSchool.txt,911,25,36,384,101,67,29,581
3487527_Atavus.txt,1735,31,55,471,290,129,81,971
3487576_NickPerumov.txt,721,25,28,290,73,43,7,413
3489060_TheParafaithWar.txt,5105,61,83,1524,752,447,325,3048
349035_Komrno.txt,1779,17,104,615,214,141,50,1020
349036_Bansktiavnica.txt,783,17,46,307,95,68,22,492
349043_Spi.txt,1232,21,58,430,135,103,45,713
349068_MarathaEmpire.txt,2515,30,83,1024,277,177,66,1544
349072_YuShyikun.txt,746,13,57,268,86,42,11,407
349077_Hattrick.txt,4718,43,109,1687,628,389,186,2890
349114_Maus.txt,1582,19,83,613,192,114,62,981
349115_PanzerViiiMaus.txt,1563,24,65,491,240,121,43,895
3492461_HistoryOfTulsaOklahoma.txt,1768,21,84,690,229,122,47,1088
3494308_NalatheLionKing.txt,1547,27,57,536,258,88,69,951
349470_Swingwing.txt,956,13,73,314,146,97,40,597
3494783_TheStudentRoom.txt,1060,21,50,402,135,94,42,673
349496_JohnMillingtonSynge.txt,2135,37,57,787,268,100,57,1212
349498_JamesNayler.txt,831,10,83,279,121,46,34,480
3495248_Tits.txt,1254,19,66,565,109,89,37,800
349531_LouisComteMol.txt,653,10,65,212,68,43,8,331
349532_Wrexham.txt,2868,47,61,1198,340,215,81,1834
349537_TheSeawolf.txt,651,10,65,288,87,35,18,428
3498625_RingRingsong.txt,625,8,78,219,87,41,25,372
3498695_NationalAtomicEnergyCommission.txt,930,23,40,400,99,69,27,595
3499573_JoanWasser.txt,615,16,38,277,56,33,11,377
3499574_StStanislausKostkaChurchsaintLouis.txt,986,11,89,372,121,53,35,581
3499585_DragonBallAlternateTimelines.txt,1788,25,71,661,283,63,74,1081
3499738_GovernorsAndLieutenantgovernorsOfStatesOfIndia.txt,908,30,30,335,93,42,25,495
3500552_OgradyVSparling.txt,747,7,106,232,106,59,32,429
3500559_FieldingLucasJr.txt,583,11,53,241,58,40,12,351
350128_MosheChaimLuzzatto.txt,1035,12,86,321,156,95,38,610
350164_FareySequence.txt,1170,51,22,399,142,68,42,651
350167_ListOfGraphTheoryTopics.txt,552,20,27,458,14,40,6,518
350175_HmvsCerberus.txt,634,10,63,230,89,36,14,369
350204_ListOfCombinatoricsTopics.txt,1222,51,23,953,42,73,10,1078
3502111_AllirelandSeniorFootballChampionship2006.txt,602,20,30,234,81,39,9,363
350220_2003WorldSeries.txt,2032,24,84,777,265,140,45,1227
3502921_Nord100.txt,668,28,23,246,101,48,18,413
3504563_TwelveHolyDays.txt,658,20,32,261,56,43,15,375
3504857_MinorsAndAbortion.txt,1375,18,76,511,182,134,49,876
3505456_ClercClassic.txt,809,20,40,438,64,28,10,540
3505526_GameServer.txt,768,15,51,277,131,56,35,499
350557_JohnWoolman.txt,939,18,52,353,128,47,28,556
350576_ColonialCambodia.txt,3044,28,108,1046,414,298,101,1859
350579_ModernCambodia.txt,907,18,50,361,116,69,21,567
350584_TheVanishing1988Film.txt,615,14,43,240,97,30,23,390
3505857_FallOfNations.txt,602,15,40,210,99,31,25,365
3505858_ElectrogasWelding.txt,602,6,100,209,102,40,16,367
350625_DeutscheFilmaktiengesellschaft.txt,1139,29,39,546,96,75,36,753
35068_1846.txt,881,15,58,479,48,43,9,579
35071_1830.txt,630,17,37,331,26,24,11,392
35072_1803.txt,854,19,44,466,48,33,14,561
35075_1855.txt,737,16,46,408,44,24,8,484
35078_1630.txt,490,10,49,265,34,21,5,325
35080_1601.txt,597,14,42,291,59,26,10,386
3508329_CathedralbasilicaOfStsPeterAndPaul.txt,652,17,38,277,66,54,19,416
3509292_PointHorror.txt,733,16,45,583,19,15,6,623
3509293_ListOfAttractionsAtTheWaltDisneyWorldResort.txt,940,39,24,652,5,45,2,704
3509884_ArthurPenhaligon.txt,1674,19,88,595,270,69,60,994
3510262_SaintQuirinus.txt,624,8,78,233,76,21,15,345
3511184_AucklandCityFc.txt,717,19,37,339,75,33,14,461
3511629_IsraeliMilitaryPolice.txt,3057,59,51,1338,332,257,68,1995
3511662_HurricaneClaudette2003.txt,2044,28,73,755,232,184,75,1246
351214_AgaKhan.txt,857,15,57,398,80,51,16,545
351216_Stripboard.txt,630,7,90,185,110,53,34,382
351219_DonBrash.txt,3762,49,76,1454,484,226,130,2294
351220_Academia.txt,4802,61,78,1600,657,510,189,2956
351226_TheGreatGildersleeve.txt,2440,29,84,967,290,161,104,1522
351227_Transparencyhumanities.txt,619,16,38,236,86,53,21,396
351240_RenaultSamsungMotors.txt,749,10,74,297,107,46,25,475
351258_HardcoreTechno.txt,806,17,47,398,93,63,27,581
351263_IndianSummer.txt,765,18,42,287,92,73,43,495
351264_ScumManifesto.txt,685,19,36,254,92,65,21,432
351269_SacredLanguage.txt,972,9,108,370,110,87,35,602
351274_CoherencephilosophicalGamblingStrategy.txt,748,21,35,199,107,57,29,392
3513608_HingolNationalPark.txt,564,13,43,306,52,40,6,404
3514155_UrKasdim.txt,1127,15,75,503,123,56,31,713
3515038_MagneticLock.txt,1029,28,36,361,121,123,38,643
3515569_Nuzvid.txt,763,21,36,327,101,57,22,507
3515990_SiddharthaShankarRay.txt,591,10,59,219,75,32,24,350
351613_Avebury.txt,1826,38,48,659,247,139,56,1101
3516589_TheGhostsOfInverloch.txt,1683,15,112,659,210,112,39,1020
3516595_HmsCharybdis88.txt,904,19,47,379,123,38,24,564
3516963_SofiaUniversity.txt,778,15,51,321,84,53,6,464
3516971_AbrahamWhistler.txt,1016,6,169,326,184,57,46,613
3517917_LeonardoDeMango.txt,688,10,68,250,71,45,22,388
3518509_Eschenburg.txt,701,20,35,314,56,48,15,433
3518974_ListOfContractLawEnforcementCitiesus.txt,924,34,27,636,31,12,15,694
3519326_AwardsAndDecorationsOfTheStateDefenseForces.txt,1186,106,11,903,68,25,38,1034
3519328_DaniCalifornia.txt,1414,32,44,569,177,92,57,895
3520900_YoungMuslims.txt,624,15,41,303,60,32,8,403
3520958_StumpMerrill.txt,591,12,49,217,63,28,15,323
3522315_ListOfCrossingsOfTheSusquehannaRiver.txt,1007,27,37,563,77,35,21,696
352308_BbcTelevision.txt,1849,41,45,758,215,161,72,1206
352334_WhitebarkPine.txt,926,10,92,400,116,61,52,629
352339_1755LisbonEarthquake.txt,2256,26,86,856,274,175,64,1369
352353_SpiritLevel.txt,862,15,57,317,122,66,36,541
352365_PoisonTheWell.txt,910,13,70,433,96,46,24,599
3523848_Manhuntnet.txt,728,21,34,262,111,57,31,461
3523907_ShlomoMoussaieffrabbi.txt,1030,17,60,373,152,46,31,602
352390_HistoryOfSocialismInGreatBritain.txt,3862,66,58,1450,520,286,105,2361
352392_SwallowsAndAmazonsseries.txt,1670,26,64,614,207,101,54,976
3524655_Scoop2006Film.txt,1621,24,67,608,218,111,76,1013
3524657_DimensionMix.txt,692,34,20,460,41,26,2,529
3524870_MongoosePublishing.txt,581,10,58,294,50,34,20,398
3525665_Lithotroph.txt,864,14,61,325,125,94,36,580
352702_CooleytukeyFftAlgorithm.txt,2622,26,100,988,268,251,114,1621
352756_MalcolmReed.txt,972,13,74,324,168,61,43,596
3527981_TheThinDeadLine.txt,820,15,54,314,111,24,17,466
3527997_Icd10ChapterIvEndocrineNutritionalAndMetabolicDiseases.txt,1793,47,38,991,61,208,27,1287
3528003_RepriseangelEpisode.txt,1084,20,54,378,160,65,28,631
3528031_OverTheRainbowangelEpisode.txt,1088,19,57,336,203,41,46,626
3528089_Icd10ChapterXivDiseasesOfTheGenitourinarySystem.txt,1270,57,22,560,74,190,29,853
3528299_ApocalypseNowish.txt,1439,17,84,423,230,54,66,773
3528964_JinzaburoMazaki.txt,570,7,81,251,56,28,4,339
3529594_KalabaghDam.txt,1844,32,57,651,249,139,88,1127
3529697_StBedesCollegeChristchurch.txt,1273,24,53,580,149,84,18,831
3530599_BaaBaaBlackSheeptvSeries.txt,1318,16,82,504,199,93,38,834
3532369_KnittingMachine.txt,707,8,88,258,121,69,21,469
3533005_BlackOne.txt,1249,16,78,499,170,80,45,794
353424_BaltimorewashingtonMetropolitanArea.txt,866,21,41,587,40,23,14,664
353429_BattleOfCyzicus.txt,786,8,98,271,125,35,22,453
353446_ListOfFeminists.txt,1223,21,58,902,34,59,8,1003
353480_WadysawSikorski.txt,5422,40,135,2076,647,442,128,3293
3534929_DoivjetiStotu.txt,952,12,79,319,131,91,47,588
353496_911Commission.txt,3544,62,57,1422,485,211,110,2228
353507_PapuanLanguages.txt,1714,33,51,698,223,158,79,1158
353509_CharlesPeace.txt,8081,65,124,2411,1357,340,256,4364
3535788_Shtetsu.txt,2715,58,46,873,367,180,137,1557
3535793_OpendocumentAdoption.txt,2393,44,54,932,341,179,80,1532
3535872_MercuryMeteor.txt,752,14,53,295,110,47,20,472
3536917_Ceciliaband.txt,690,9,76,292,77,42,21,432
3537370_1tym.txt,579,18,32,270,37,26,13,346
3537694_LoveHinaTimeline.txt,3986,71,56,1623,565,136,121,2445
3537705_ChangersFoundationParibartakcfp.txt,1494,16,93,572,213,83,45,913
3537713_HenrySavery.txt,748,10,74,229,121,41,36,427
353781_LusFigo.txt,1835,25,73,701,215,103,56,1075
353844_NewZealandHouseOfRepresentatives.txt,1849,35,52,638,266,123,77,1104
353849_HydraulicMining.txt,872,11,79,335,130,69,38,572
3540699_ListOfRegisteredHistoricPlacesInWashington.txt,4303,25,172,4100,4,34,1,4139
3541720_GarbageBowl.txt,926,13,71,347,133,52,26,558
3542052_PenistoneRailCrash.txt,1935,18,107,682,278,122,47,1129
3542068_505thInfantryRegimentunitedStates.txt,1370,25,54,554,162,98,22,836
3542705_HughWHardy.txt,598,11,54,308,58,39,4,409
3543438_BusinessProcessInteroperability.txt,1111,17,65,411,167,101,39,718
3544697_BursfeldeAbbey.txt,671,11,61,234,97,44,13,388
354525_PattiPage.txt,915,13,70,358,106,62,26,552
354528_W07cblp.txt,724,10,72,292,101,65,20,478
354558_SecretaryOfStateForTransport.txt,1120,32,35,468,68,23,14,573
354588_HydrothermalVent.txt,1052,23,45,429,114,117,33,693
3547900_PortOfAntwerp.txt,715,8,89,258,87,61,15,421
3547912_KentNilsson.txt,1033,43,24,322,42,22,9,395
3548783_SouthendManorFc.txt,666,16,41,265,82,40,11,398
3549003_BarkingsideFc.txt,683,12,56,243,96,44,23,406
354962_HoneHeke.txt,597,10,59,212,73,32,21,338
3549720_RobertHTuttle.txt,727,11,66,277,111,33,18,439
3549834_TextileInstituteOfPakistan.txt,2501,141,17,1328,271,177,44,1820
354999_MyHerotvSeries.txt,3434,64,53,1140,550,187,125,2002
355000_JamesBryantConant.txt,558,6,93,235,57,35,15,342
355002_TimArmstrong.txt,986,15,65,487,90,46,20,643
355011_Iconcomputing.txt,705,13,54,300,75,78,20,473
355024_Capitalarchitecture.txt,1607,26,61,549,206,123,73,951
3550797_ArchieKalokerinos.txt,1023,14,73,515,71,45,14,645
3552099_LdvPilot.txt,952,20,47,318,128,70,43,559
3553753_AndreasWisniewski.txt,612,10,61,299,51,19,17,386
3554662_ScottShawartist.txt,590,11,53,283,66,31,23,403
3555621_DallasStoudenmire.txt,2425,29,83,794,438,117,121,1470
355641_SiegesOfNagashima.txt,691,15,46,231,104,46,31,412
355643_Alandalus.txt,4246,55,77,1605,474,295,163,2537
355645_BattleOfNagashino.txt,1291,14,92,434,203,94,39,770
355646_SouthernFlyingSquirrel.txt,1064,12,88,450,127,86,33,696
355648_DistinguishedServiceOrder.txt,636,11,57,255,87,35,24,401
3556548_SalimAhmedSalim.txt,750,15,50,422,34,35,3,494
3556554_BurnabyprovincialElectoralDistrict.txt,1151,84,13,613,27,153,182,975
3556644_DeathStinger.txt,1132,27,41,410,170,87,49,716
355670_NorthernFlyingSquirrel.txt,869,10,86,407,91,74,15,587
355676_JimAnderton.txt,1247,16,77,429,184,85,53,751
3558055_ValueAddedTaxfreeExportsFromTheChannelIslands.txt,786,14,56,274,131,42,28,475
3558918_CollegeOfAeronauticalEngineering.txt,709,13,54,305,85,44,22,456
3559867_Malakand.txt,822,30,27,356,101,54,19,530
3559897_WhitneyRussell.txt,663,19,34,294,104,30,33,461
3559987_PalestineCommunistParty.txt,563,9,62,249,55,26,10,340
356028_FelixFrankfurter.txt,930,17,54,363,108,65,20,556
356050_Lamotrigine.txt,2108,26,81,822,258,242,76,1398
356112_ListOfTelevisionStationsInMinnesota.txt,750,18,41,407,13,44,0,464
356113_FordModelB1932.txt,726,21,34,256,108,61,38,463
3561474_ListOfTheBirdsOfKangarooIslandSouthAustralia.txt,649,136,4,529,10,86,1,626
3561788_ArnoldWilson.txt,751,15,50,282,95,40,23,440
3561827_Attuma.txt,828,13,63,300,130,40,27,497
3562837_RossWinans.txt,687,10,68,251,85,37,21,394
3563258_LifeSciencesResearchOffice.txt,619,6,103,376,18,19,1,414
3564441_Interpal.txt,1096,20,54,405,173,61,31,670
3565856_BillyConnollysWorldTourOfAustralia.txt,1541,14,110,545,192,87,52,876
3566243_AmericanCryonicsSociety.txt,1587,20,79,623,212,127,57,1019
3566585_TheUnknown.txt,664,11,60,212,98,46,36,392
3566611_JulianVereker.txt,649,20,32,231,97,47,19,394
3566820_SchenleyHighSchool.txt,641,16,40,292,69,47,8,416
3566883_ParticlePhysicsAndRepresentationTheory.txt,822,11,74,299,95,62,36,492
356740_CountiesOfEngland.txt,937,27,34,320,124,101,26,571
356741_OpposedPistonEngine.txt,985,17,57,365,121,80,34,600
3567777_JudgepolicyDebate.txt,985,14,70,355,146,74,39,614
3567779_Jevremovac.txt,619,15,41,215,65,58,17,355
356785_InstitutionalRacism.txt,871,16,54,321,98,105,34,558
356788_LitalianaInAlgeri.txt,1137,27,42,499,161,51,28,739
3570152_TropicalStormZeta2005.txt,633,13,48,211,89,59,33,392
3571929_ConowingoDam.txt,1112,15,74,439,141,52,33,665
3572017_AleksanderBrckner.txt,812,8,101,308,69,80,26,483
3572030_Methylcellulose.txt,1037,41,25,339,181,100,46,666
3572031_SeanDAltman.txt,860,11,78,380,102,59,18,559
35738_1779.txt,737,20,36,391,53,34,10,488
3573933_GreatPlagueOfMarseille.txt,581,7,83,204,69,47,16,336
3573954_LauranceRudic.txt,1288,52,24,778,83,58,13,932
3574904_NewHampshireGubernatorialElection2004.txt,620,12,51,236,91,55,13,395
3575334_Vmgr152.txt,1400,27,51,577,157,73,24,831
3576270_SiamParagon.txt,748,22,34,345,83,53,14,495
3577230_AnthologyOfInterestIi.txt,1403,22,63,522,197,76,34,829
357820_TheDivisionBell.txt,1092,24,45,514,127,47,22,710
357821_MultimediaHomePlatform.txt,599,14,42,258,71,62,17,408
357825_JosebaBeloki.txt,543,6,90,204,53,37,14,308
357826_JosephNeedham.txt,665,13,51,284,61,55,14,414
357828_Zolpidem.txt,1375,22,62,481,200,124,57,862
357832_Once.txt,1025,22,46,358,124,103,36,621
357845_GeorgeBSelden.txt,763,10,76,295,108,26,22,451
357847_Shenzhou6.txt,2930,41,71,1110,398,203,65,1776
357868_PanzerGeneral.txt,1035,22,47,446,115,88,19,668
357874_T38Talon.txt,781,16,48,296,107,71,18,492
357881_TestdrivenDevelopment.txt,2336,38,61,745,385,204,126,1460
3578842_DelmarAlabama.txt,1091,25,43,437,151,59,32,679
3579689_NikolausNilles.txt,689,8,86,233,76,52,30,391
3580628_BackOnTheBlock.txt,769,8,96,520,47,24,15,606
3580657_UssZebraakn5.txt,1329,12,110,496,172,71,21,760
3581697_ClintonHighSchoolTennessee.txt,596,31,19,313,66,30,11,420
3582565_LaraCroftTombRaiderLegend.txt,3748,48,78,1386,523,220,145,2274
3582572_HighSpeedPhotography.txt,2122,46,46,789,265,193,77,1324
358293_Hairspraymusical.txt,1084,23,47,693,56,22,14,785
3585737_RaceAndIntelligenceutilityOfResearch.txt,1557,18,86,484,250,167,72,973
3586496_Allur.txt,866,14,61,350,127,50,34,561
3586686_SpinalLock.txt,1034,16,64,388,158,85,40,671
3587056_GreatRailroadStrikeOf1877.txt,2183,44,49,813,300,128,75,1316
3588098_MarianAndHolyTrinityColumns.txt,803,8,100,275,96,67,37,475
358882_PushToTalk.txt,1457,26,56,694,189,111,37,1031
358887_ThomasHoward21stEarlOfArundel.txt,681,17,40,268,75,36,21,400
358904_PostageStampsAndPostalHistoryOfGreatBritain.txt,2007,36,55,707,257,174,66,1204
3589067_HurricaneEdouard1996.txt,1670,20,83,643,195,146,38,1022
3589086_OrdnanceCorps.txt,762,15,50,374,65,42,15,496
358913_BroadcastFlag.txt,1046,17,61,393,148,90,47,678
358922_KitBond.txt,906,18,50,370,118,46,22,556
358923_Delicatessen.txt,968,17,56,377,126,96,46,645
358925_LegazpiCity.txt,1414,33,42,715,124,105,32,976
358933_Optus.txt,1317,27,48,609,148,113,49,919
358961_RuyLpezDeVillalobos.txt,948,14,67,405,101,35,19,560
358964_MargaretCountessOfHainaut.txt,652,9,72,291,69,12,15,387
358970_BeidouNavigationSystem.txt,564,18,31,199,78,48,12,337
358971_BrisbaneAirport.txt,932,26,35,497,83,67,12,659
3589956_UssPineIslandav12.txt,590,13,45,270,60,14,2,346
3589957_UssCurrituckav7.txt,773,16,48,328,90,24,15,457
3590035_NativeWomensAssociationOfCanadaVCanada.txt,1128,10,112,372,187,54,58,671
3590462_LeedsAndBradfordRailway.txt,708,11,64,269,87,33,26,415
3590928_WyndhamBranch.txt,699,10,69,245,100,42,28,415
3591846_SriLankanAyurvedicTradition.txt,1084,29,37,445,134,90,20,689
3591909_AnalFistula.txt,745,12,62,224,129,66,18,437
359312_TransportAndGeneralWorkersUnion.txt,921,19,48,458,79,45,18,600
3593399_Ratbaiting.txt,1618,28,57,528,248,112,62,950
3593447_AlexSanderswiccan.txt,3076,45,68,918,536,198,122,1774
359385_Ttouan.txt,987,14,70,334,122,82,38,576
3594358_EmpireSportsNetwork.txt,917,14,65,394,122,51,27,594
3594806_MacroviperaLebetina.txt,634,18,35,274,80,52,38,444
3594832_ThamiElGlaoui.txt,2730,22,124,890,411,193,94,1588
3596745_TheLivesOfChristopherChant.txt,1137,15,75,347,186,70,49,652
3597689_UsArmyCenterOfMilitaryHistory.txt,2509,25,100,963,265,211,62,1501
3598593_MontanaStateCapitol.txt,800,13,61,299,121,45,12,477
3598595_Fuzorzoids.txt,640,15,42,220,82,53,25,380
3598755_ComarcaLagunera.txt,772,12,64,311,56,71,6,444
3599553_NathanScott.txt,1522,15,101,480,257,55,68,860
359978_Garifuna.txt,640,8,80,243,86,38,19,386
359983_BhaktiYoga.txt,915,19,48,379,104,71,34,588
360011_RegularRepresentation.txt,1057,22,48,358,137,100,33,628
3600135_NichigaiWho.txt,876,42,20,409,104,63,14,590
360015_Phocion.txt,546,7,78,161,78,33,17,289
3600229_Curbroad.txt,745,17,43,207,124,81,48,460
360030_QuestionAnswering.txt,2176,39,55,809,289,209,79,1386
3601867_Widowpc.txt,568,11,51,274,72,35,17,398
3602157_Seismosauruszoids.txt,1442,24,60,506,209,116,58,889
3602493_Nethergate.txt,728,15,48,267,104,45,24,440
3602898_VicePresidentOfTheRepublicOfChina.txt,707,10,70,256,76,43,19,394
3603106_FilmPerforations.txt,731,10,73,240,92,71,31,434
3603114_ErlingWold.txt,901,7,128,375,83,56,12,526
3603563_GeorgetteNeale.txt,665,13,51,308,61,33,17,419
360405_HistoryOfTokyo.txt,1361,10,136,586,175,77,41,879
360426_BattleOfPinkieCleugh.txt,1136,23,49,436,160,70,42,708
3604426_LiCng.txt,3355,33,101,1363,441,164,110,2078
3605505_HydrogenDamage.txt,1124,23,48,473,171,99,18,761
3606456_BDdoonesbury.txt,893,14,63,301,119,80,28,528
3606881_TheStingfuturama.txt,1783,14,127,646,273,82,66,1067
3607262_MolecularBiologyCoreFacilitiesmbcf.txt,586,13,45,279,82,39,14,414
3607273_ListOfTelevisionSeriesRunningMoreThan10Years.txt,777,3,259,394,31,36,14,475
3609822_NavalStrategy.txt,1456,22,66,533,167,99,51,850
3610614_Visitcumbria.txt,1223,8,152,616,91,76,20,803
3610683_FirstBattleOfBeruna.txt,1222,16,76,458,159,60,28,705
3610769_ListOfGovernorsOfDelawarealphabetic.txt,906,73,12,532,11,25,1,569
361093_SandwichTern.txt,643,12,53,279,68,53,30,430
361113_LesLiaisonsDangereuses.txt,1020,16,63,399,151,79,25,654
361120_KotaKinabalu.txt,2698,47,57,1148,320,189,112,1769
361176_BernieSanders.txt,2098,31,67,870,230,140,54,1294
361178_Acadiana.txt,1215,27,45,550,117,89,39,795
361179_LochnerVNewYork.txt,2034,23,88,795,260,135,70,1260
361180_GutzonBorglum.txt,1232,19,64,466,174,98,22,760
361184_HypergeometricSeries.txt,1191,45,26,376,151,160,42,729
361185_Streltsy.txt,701,14,50,240,83,63,22,408
3613161_DavidMontgomery.txt,747,11,67,329,70,40,16,455
3615159_Niphad.txt,794,25,31,429,52,42,24,547
361558_Strangling.txt,971,16,60,349,134,73,46,602
36163_2003.txt,6283,48,130,3381,373,246,56,4056
36164_2006.txt,9243,68,135,4863,537,390,90,5880
3616597_DigitalPhotography.txt,6154,66,93,2137,847,678,290,3952
36165_2007.txt,4135,35,118,1864,375,229,47,2515
3616646_Categoriesgame.txt,789,13,60,340,95,34,26,495
3618925_ListOfAirportsByIcaoCodeZ.txt,1055,17,62,995,12,4,3,1014
3618932_MirceaCrtrescu.txt,592,12,49,354,18,39,2,413
3619889_KamenRiderGarren.txt,983,9,109,533,95,21,17,666
3619993_50thGoldenGlobeAwardsNominees.txt,738,23,32,497,2,10,3,512
362148_Ruthanasia.txt,690,11,62,260,85,50,30,425
362160_Gemini5.txt,1260,27,46,427,182,94,49,752
36218_2010OdysseyTwo.txt,1232,21,58,399,205,61,52,717
362213_28number.txt,823,17,48,296,76,71,22,465
362216_MackReynolds.txt,1138,14,81,604,48,54,10,716
362222_Distributor.txt,728,11,66,262,92,54,32,440
362227_JimBolger.txt,837,12,69,329,103,55,19,506
362233_Magnetocomics.txt,8832,109,81,2951,1351,691,327,5320
362245_MosaicStadiumAtTaylorField.txt,667,11,60,245,92,43,24,404
3622828_ExtremeXm.txt,1794,20,89,726,240,94,76,1136
3624330_MedicalResidentWorkHours.txt,630,11,57,243,84,57,20,404
3625276_SportInThePhilippines.txt,984,24,41,455,124,74,39,692
3625289_BhutanitisLidderdalii.txt,981,13,75,361,99,97,38,595
3625293_IllnessesOfArielSharon.txt,998,14,71,339,172,68,38,617
3625301_GraphiumAntiphates.txt,817,9,90,282,66,115,30,493
3625319_GraphiumAgamemnon.txt,1052,21,50,423,100,105,42,670
362548_FictionSetInAncientRome.txt,869,12,72,563,32,23,3,621
3626050_Zathurafilm.txt,730,13,56,274,98,36,20,428
3626254_ViolinMakingAndMaintenance.txt,1004,18,55,297,177,86,54,614
3626258_ClaudeVivier.txt,690,7,98,295,60,47,14,416
362652_Carjacking.txt,785,16,49,289,120,46,19,474
3627193_AlbertEinsteinsBrain.txt,1075,22,48,403,168,88,40,699
3627676_Nihonga.txt,334,7,47,200,14,5,2,221
3627682_BritishSoapAwards.txt,1262,13,97,992,16,27,2,1037
3628051_ListOfNotableFiguresInCryptozoology.txt,552,3,184,382,28,19,4,433
3630622_JapanPatentOffice.txt,642,14,45,299,84,30,15,428
3632355_HerbCain.txt,626,13,48,309,47,22,9,387
363303_Theatresports.txt,1000,9,111,368,142,45,34,589
363323_Habilitation.txt,1335,19,70,411,185,152,57,805
363326_LeeHsienLoong.txt,2795,55,50,1138,329,197,71,1735
363328_Symi.txt,671,13,51,237,89,58,25,409
363329_MarkWayneClark.txt,563,15,37,250,57,23,8,338
363350_ChenCheng.txt,629,22,28,234,79,48,13,374
363360_LyapunovStability.txt,1212,75,16,362,174,124,66,726
3633831_JosMillnAstray.txt,1303,18,72,449,182,79,39,749
3633935_BlackMoonClan.txt,2571,41,62,908,395,119,92,1514
3634026_ShadowGalactica.txt,1847,39,47,717,281,92,65,1155
3634892_Lucero.txt,1119,23,48,552,89,40,14,695
3634937_TheOtherSidestargateSg1.txt,792,14,56,233,141,66,33,473
3635349_Stedingen.txt,1651,17,97,534,235,107,58,934
3635935_KarnadSadashivRao.txt,946,21,45,321,132,71,32,556
3636315_GibsonThunderbird.txt,659,17,38,308,91,39,21,459
363631_BenEKing.txt,999,8,124,506,57,38,18,619
3636388_TheAToZSymphony.txt,596,13,45,302,42,31,4,379
363675_Mariachi.txt,1614,24,67,609,207,138,59,1013
363697_X400.txt,654,12,54,283,82,47,24,436
3637351_199798SouthernHemisphereTropicalCycloneSeason.txt,1560,32,48,576,215,111,40,942
363754_BootsGroup.txt,1961,39,50,759,269,136,71,1235
363776_MariaBueno.txt,668,22,30,274,83,39,9,405
3640008_6thPennsylvaniaRegiment.txt,1075,21,51,410,121,43,26,600
3640133_IowaStateCyclones.txt,794,79,10,435,16,9,2,462
3640675_EasonSon.txt,1032,21,49,456,125,64,45,690
3640758_BadDriburg.txt,1347,41,32,523,152,99,44,818
3642648_HistoryOfItv.txt,4895,75,65,1796,676,332,178,2982
3642692_SiberianElm.txt,758,14,54,349,80,71,31,531
364369_Lisaastronomy.txt,665,13,51,226,77,67,18,388
364395_FrancisPegahmagabow.txt,738,14,52,264,95,41,24,424
3644382_JohannesPullois.txt,574,11,52,267,59,31,14,371
3644387_CyclicMass.txt,1173,15,78,435,133,126,50,744
364442_ObjectivistPoets.txt,3015,36,83,1142,357,195,105,1799
364446_FeetForwardsMotorcycle.txt,1063,20,53,340,155,100,53,648
3645015_Corficolombiana.txt,563,21,26,229,61,40,5,335
3645985_Chairman.txt,675,16,42,228,89,59,22,398
3646031_JeremaiaWaqanisau.txt,727,17,42,306,72,27,5,410
364723_JosephDaltonHooker.txt,2013,33,61,762,251,83,36,1132
3647387_ClanGraham.txt,2359,47,50,933,298,113,64,1408
3650164_SmileTime.txt,2257,22,102,722,404,93,77,1296
3650167_BasDeGaayFortman.txt,1466,22,66,598,129,86,24,837
3650231_Knwatv.txt,603,13,46,273,50,41,17,381
3650281_Porsche907.txt,1111,17,65,351,159,96,37,643
3651702_AJSeymour.txt,814,19,42,344,82,47,10,483
3652754_BrianShima.txt,657,12,54,390,21,21,5,437
3653714_Seersem.txt,760,20,38,309,128,61,23,521
3654610_SamuraiSpy.txt,1014,13,78,401,154,30,31,616
3654679_MattTalbot.txt,1114,14,79,392,156,68,32,648
365485_TechnicalWriter.txt,856,16,53,311,106,134,41,592
365493_ShineOnYouCrazyDiamond.txt,2852,38,75,1170,308,164,77,1719
365497_NonenglishbasedProgrammingLanguages.txt,560,6,93,281,57,67,14,419
365510_ListOfBiochemistryTopics.txt,3588,31,115,1811,58,348,12,2229
365511_LinkRot.txt,828,25,33,299,128,87,34,548
365537_TheMarvelousLandOfOz.txt,1565,18,86,555,228,73,46,902
3656139_ListOfNewspapersInScotland.txt,1271,46,27,750,78,76,26,930
3656540_MelodiGrandPrix2006.txt,640,16,40,270,68,67,10,415
3657084_PanditaRamabai.txt,971,18,53,324,135,69,37,565
3657113_SirJohnRetcliffe.txt,709,12,59,352,55,38,12,457
3659440_ColonialHistoryOfNewJersey.txt,1320,23,57,532,178,82,33,825
3659453_OverallEquipmentEffectiveness.txt,845,29,29,309,145,62,33,549
365948_MarxistPhilosophy.txt,4692,39,120,1615,508,409,194,2726
3659821_RostomOfKartli.txt,572,9,63,205,76,33,13,327
3659883_BinarySynchronousCommunications.txt,1000,19,52,410,155,76,23,664
3661366_BuildingHarlequinsMoon.txt,996,12,83,332,153,69,25,579
3661405_CanadasGrandRailwayHotels.txt,718,13,55,286,87,46,22,441
3661458_ArchCreek.txt,934,13,71,388,112,72,12,584
3662314_PrincipleOfMinimumEnergy.txt,1592,47,33,444,226,176,42,888
3662342_JonBannenberg.txt,573,10,57,202,73,66,28,369
3663219_HudsonCanyon.txt,742,8,92,314,74,50,13,451
3663223_ListOfRegisteredHistoricPlacesInNorfolkCountyMassachusetts.txt,3565,4,891,2184,321,14,0,2519
3663849_DitmarAwardResults.txt,7744,285,27,6378,99,177,10,6664
3664860_ChicagoCard.txt,637,8,79,253,93,44,13,403
3665145_RuleOfThreewriting.txt,860,11,78,290,125,54,26,495
366555_Biomolecule.txt,961,25,38,357,161,89,38,645
3665751_KanwalNewSouthWales.txt,668,14,47,313,47,45,15,420
366598_SuperMarioAllstars.txt,1734,18,96,678,229,92,66,1065
3666176_No23r.txt,638,7,91,255,82,35,17,389
3666573_RiverBladnoch.txt,1995,20,99,669,279,121,46,1115
3666797_EuropeanUnionrussiaCommonSpaces.txt,1002,26,38,388,88,86,16,578
3667133_ChuckLeonard.txt,638,29,22,320,73,24,16,433
3667535_CharlesTEppsJr.txt,661,13,50,299,67,31,7,404
3668102_MightyTerror.txt,693,23,30,271,81,26,26,404
3668503_AnthonyEllmakerRoberts.txt,2078,23,90,813,257,102,41,1213
3668560_Barreiras.txt,1480,26,56,535,192,119,35,881
3669163_TaoKan.txt,837,7,119,278,127,51,40,496
3670042_PatriotGamesfamilyGuy.txt,775,8,96,315,113,32,30,490
3670134_Choirokoitia.txt,583,15,38,194,91,37,21,343
3670136_AnsoniaClockCompany.txt,689,12,57,262,90,35,23,410
367037_BillMckibben.txt,1713,24,71,586,200,120,67,973
367049_PianoConcertoNo3rachmaninoff.txt,751,28,26,272,89,77,22,460
367052_BruderhofCommunities.txt,2062,32,64,752,280,143,53,1228
3671048_Tubthumping.txt,694,11,63,255,93,42,15,405
3672474_UssCharlesFHughesdd428.txt,769,13,59,316,87,42,15,460
3672530_OsrovhenzinhasidicDynasty.txt,668,11,60,372,54,20,8,454
3672549_DrBeattieMartinTrophy.txt,584,6,97,369,13,15,2,399
3672868_ListOfDisneyLiveactionFilms.txt,947,24,39,539,15,9,5,568
3672935_BuildingBiology.txt,618,15,41,241,90,52,17,400
3673487_SuJun.txt,774,8,96,251,129,51,37,468
3674450_WildernessTherapy.txt,746,10,74,297,104,64,31,496
3675324_LeastsquaresEstimationOfLinearRegressionCoefficients.txt,681,24,28,194,95,47,24,360
3675442_SidneyCotton.txt,687,9,76,249,87,62,22,420
3675865_ListOfLibertyShipsByHullNumber1051.txt,1481,1,1481,523,87,23,1,634
3675893_DurandkernerMethod.txt,1231,60,20,466,152,75,46,739
3676340_ListOfLibertyShipsByHullNumber1951.txt,4013,1,4013,1477,239,45,0,1761
367644_OrderOfPrecedenceInNorthernIreland.txt,4659,3,1553,2833,17,260,12,3122
3676825_ListOfLibertyShipsByHullNumber2701.txt,3946,1,3946,1421,225,77,1,1724
3677779_OklahomaStateHighway51.txt,724,12,60,244,82,50,16,392
3677836_WeekdayCartoon.txt,1831,26,70,824,204,106,62,1196
3678823_DillwynParrish.txt,782,8,97,308,87,32,25,452
36790_Artery.txt,855,27,31,328,115,70,25,538
36791_ToddRundgren.txt,2827,47,60,1155,311,242,77,1785
36795_MedievalWarmPeriod.txt,805,20,40,336,78,67,41,522
36796_Paclitaxel.txt,1191,18,66,520,141,74,35,770
36797_OccamsRazor.txt,6806,97,70,2262,969,663,346,4240
3680225_LeonardOprea.txt,765,14,54,386,49,47,9,491
368071_TheWildWildWest.txt,1993,25,79,780,259,119,55,1213
3681182_MonboddoHouse.txt,722,12,60,301,80,57,19,457
368130_DorothyLoudon.txt,688,14,49,256,80,41,12,389
36816_ThreeStooges.txt,7753,61,127,3193,928,456,265,4842
36826_DekkersAlgorithm.txt,605,11,55,182,97,60,26,365
36827_MutualExclusion.txt,569,13,43,223,83,66,14,386
36835_AugerElectronSpectroscopy.txt,675,16,42,259,103,35,18,415
36842_Gossypium.txt,647,11,58,297,94,57,10,458
3684583_Consulrepresentative.txt,2047,24,85,674,218,242,96,1230
3685554_LonMinkus.txt,5596,58,96,2128,628,396,199,3351
3686479_Cdub.txt,1900,16,118,632,276,158,65,1131
368733_NoorJehan.txt,9289,35,265,3221,1422,535,368,5546
368736_HivAndAidsMisconceptions.txt,6365,111,57,2744,720,574,201,4239
3687452_Ambitus.txt,1973,16,123,643,335,87,71,1136
3688407_Venomcrack.txt,900,10,90,282,187,55,40,564
3689370_CommanderMineSquadronSeven.txt,1698,29,58,853,185,76,14,1128
3689739_ListOfRegisteredHistoricPlacesInHartfordCountyConnecticut.txt,5005,6,834,3159,427,23,3,3612
3689913_TurboC.txt,671,12,55,278,87,53,18,436
3689938_ListOfRegisteredHistoricPlacesInMiddlesexCountyConnecticut.txt,1396,3,465,910,110,8,0,1028
369223_MurphyJFosterJr.txt,1298,30,43,567,158,95,30,850
369232_LeafcutterAnt.txt,545,13,41,192,69,56,22,339
3695195_RogerAndHolly.txt,1629,11,148,581,326,44,91,1042
3695204_AdvancedGunSystem.txt,971,15,64,345,132,83,47,607
369826_NepaleseCivilWar.txt,3672,23,159,1488,523,230,76,2317
369836_Holsteincattle.txt,1007,20,50,387,128,79,36,630
369857_Acanthamoeba.txt,617,14,44,258,79,44,14,395
3698598_ChhatarSingh.txt,702,8,87,293,90,27,14,424
369910_EroticArt.txt,902,17,53,300,124,96,40,560
370268_DeepBrainStimulation.txt,1711,29,59,595,270,143,67,1075
370273_MacHall.txt,1939,23,84,617,269,171,111,1168
3702884_SouthPacificGames.txt,648,15,43,310,65,53,20,448
370315_Ghazni.txt,678,26,26,291,80,29,16,416
3703749_MarineOtter.txt,644,19,33,238,95,46,33,412
3703755_Doctorwildstorm.txt,1110,16,69,363,174,82,32,651
3705381_TehranStockExchange.txt,761,11,69,321,86,54,14,475
3708918_WittenhamClumps.txt,697,12,58,288,88,48,25,449
3708968_ValeDoAmanhecer.txt,564,10,56,207,65,49,14,335
3709875_MexicanAcademyOfSciences.txt,2542,82,31,1025,301,192,42,1560
3709882_WangDao.txt,1233,11,112,473,187,65,41,766
3710888_HurricaneDolly1996.txt,909,21,43,351,120,53,32,556
3712821_Currie.txt,764,14,54,315,89,40,16,460
3712826_InternationalFreedomFoundation.txt,1037,15,69,425,138,61,24,648
3713853_MegaManZx.txt,2678,35,76,1036,349,227,88,1700
371398_NauruanLanguage.txt,1194,27,44,489,146,79,52,766
371408_SangoLanguage.txt,875,10,87,331,110,79,45,565
371468_Semiring.txt,836,17,49,252,108,85,38,483
371486_PesticidePoisoning.txt,1179,25,47,408,171,115,41,735
3716791_PatLawlor.txt,2322,21,110,807,316,227,112,1462
3717604_CogsLadder.txt,601,10,60,203,99,39,32,373
371803_MusicOfAlbania.txt,2140,44,48,816,248,267,61,1392
371823_NeilGoldschmidt.txt,819,16,51,295,99,49,23,466
371831_Stanhopea.txt,784,14,56,469,59,37,14,579
371838_EnhancedVersatileDisc.txt,598,11,54,236,96,34,23,389
3721068_BrightonBears.txt,4265,39,109,1529,549,258,129,2465
3721916_TheSalvationArmyUsaWesternTerritory.txt,687,13,52,388,46,24,14,472
3722858_ListOfCubanComicCreators.txt,953,3,317,729,59,33,53,874
3723512_TheNovaTrilogy.txt,823,16,51,256,133,54,42,485
37242_BookerTWashington.txt,3986,58,68,1432,516,326,131,2405
3724336_AnnuityeuropeanFinancialArrangements.txt,7167,64,111,2225,1046,496,281,4048
37250_ScoobyGang.txt,699,11,63,338,58,15,14,425
372516_DoushantuoFormation.txt,713,12,59,245,89,85,30,449
37252_JohnKnox.txt,3720,61,60,1159,530,235,137,2061
3725355_GeorgeTrenholm.txt,1485,26,57,560,250,73,58,941
372582_EalingBroadwayStation.txt,780,18,43,316,92,49,13,470
3726833_ListOfBangladeshrelatedTopics.txt,2932,129,22,2041,8,31,1,2081
3727251_ListOfBangaloreBirds.txt,2111,39,54,1602,180,180,38,2000
3727714_GoodApolloImBurningStarIvVolumeOneFromFearThroughTheEyesOfMadnessgraphicNovel.txt,1343,9,149,519,188,53,25,785
3728254_DiablocomputerGame.txt,7536,91,82,2548,1120,613,349,4630
3728693_KidAzteca.txt,1030,19,54,398,119,64,25,606
3728813_DancingWithTheStarsaustralianTvSeries.txt,1335,64,20,772,109,39,22,942
3728879_JohannesPfefferkorn.txt,774,14,55,306,99,39,10,454
372893_MusicOfLatvia.txt,595,10,59,245,70,52,34,401
372894_MusicOfLithuania.txt,913,22,41,402,108,86,28,624
372898_AdrianoCelentano.txt,568,8,71,279,41,34,12,366
372899_UnitedFoodAndCommercialWorkers.txt,1544,28,55,603,205,102,38,948
372916_DanSavage.txt,1684,26,64,619,213,123,62,1017
372917_Mechwarrior.txt,930,32,29,468,89,47,18,622
372941_Tharkadbattletech.txt,989,13,76,373,107,85,27,592
372962_SocietalAttitudesTowardsHomosexuality.txt,5509,85,64,1948,782,569,232,3531
3729715_GeneStanlee.txt,665,13,51,233,100,34,19,386
372972_SodomyLawsInTheUnitedStates.txt,897,8,112,373,115,49,32,569
37304_MartinHeidegger.txt,7545,101,74,2839,968,539,257,4603
3730671_TheBaskervilles.txt,1570,11,142,582,207,117,79,985
37307_PoliticalPrisoner.txt,1516,12,126,673,180,92,40,985
3732063_TamOShanterburnsPoem.txt,1756,44,39,569,253,125,82,1029
3733161_LubbockLakeLandmark.txt,1243,29,42,471,167,112,43,793
3734067_EmploymentScams.txt,1305,16,81,399,220,102,59,780
3735022_OregonRoute99w.txt,1165,19,61,488,107,62,37,694
3735591_TheDivineCanary.txt,572,9,63,218,61,46,20,345
3735977_KioaVWest.txt,695,13,53,233,115,42,18,408
3736553_PaperMoneyOfTheZimbabweanDollar.txt,1455,39,37,522,195,81,40,838
373672_Bohemianism.txt,1369,21,65,618,128,139,37,922
3739281_HarryTMoore.txt,1210,23,52,486,166,65,29,746
3739305_5rhythms.txt,965,16,60,418,133,48,14,613
3739366_MontageSequence.txt,694,7,99,266,93,56,25,440
3740327_MorphogenicNetworkinspirationForMorphogenicNetwork.txt,675,10,67,221,90,73,32,416
374045_NarutoGeography.txt,3547,73,48,1126,578,211,150,2065
374052_LouisalexandreTaschereau.txt,810,18,45,349,82,44,13,488
374054_BlackRhinoceros.txt,1965,28,70,628,304,178,116,1226
374097_LincolnsSecondInauguralAddress.txt,1183,11,107,299,189,76,60,624
3741853_TheYearsOfLyndonJohnson.txt,947,24,39,376,114,64,35,589
3744122_HistoryOfPrague.txt,1769,22,80,653,217,138,41,1049
3744123_TonPentreFc.txt,678,16,42,274,88,33,17,412
3744292_MaryPoppinsmusical.txt,913,20,45,527,65,38,13,643
374684_ListOfMountainPasses.txt,1032,32,32,815,13,21,4,853
374688_DimeunitedStatesCoin.txt,3307,46,71,1174,485,183,106,1948
374699_HalfDollarunitedStatesCoin.txt,679,14,48,246,87,40,24,397
3747048_BackTalk.txt,879,14,62,247,184,42,49,522
3747610_CathedralHighSchoolstCloudMinnesota.txt,884,18,49,401,92,66,26,585
3749493_Gli2.txt,675,9,75,269,97,66,26,458
3749591_DanceOfKiribati.txt,589,10,58,202,90,35,34,361
375133_ListOfHistoricHousesInMassachusetts.txt,1450,14,103,955,39,57,9,1060
375137_RashadKhalifa.txt,1043,28,37,408,132,66,25,631
375163_LunaLovegood.txt,1492,21,71,472,242,93,72,879
375183_EnemyAtTheGates.txt,2782,27,103,992,401,187,101,1681
375187_MedalOfHonour.txt,2637,9,293,1725,4,511,0,2240
3752907_KazimierzMoczarski.txt,1006,19,52,377,112,59,25,573
3755350_VenusAndAdonisopera.txt,622,10,62,253,75,32,22,382
3755700_ListOfEnvironmentTopicsc.txt,8699,70,124,5356,647,659,63,6725
3757170_DeadSet.txt,558,16,34,317,45,15,13,390
3758185_ZacaraDaTeramo.txt,935,15,62,301,119,82,48,550
3758216_Whtg.txt,1135,129,8,607,84,47,29,767
3758727_NancyVandal.txt,738,10,73,392,63,33,19,507
3760644_JuanManuelLebrn.txt,681,15,45,309,75,44,16,444
3760664_JohnWhytemelvilleskeffington13thViscountMassereene.txt,814,18,45,348,67,38,16,469
3761497_Hmh464.txt,1031,20,51,479,99,43,6,627
3762055_BillyWhitlock.txt,716,17,42,311,84,42,20,457
376223_MelTorm.txt,1781,30,59,744,176,131,47,1098
376228_TheMatrixseries.txt,1097,18,60,517,105,51,26,699
3767372_DavidMccormack.txt,879,8,109,385,106,45,36,572
3767871_SamuelMarinusZwemer.txt,879,7,125,456,35,26,9,526
376877_EminPashaReliefExpedition.txt,2728,37,73,958,395,152,98,1603
376890_QuebecNationalism.txt,1372,26,52,523,129,149,41,842
376892_IsabellaStewartGardnerMuseum.txt,724,10,72,257,100,62,23,442
3770157_Ichimaru.txt,708,17,41,267,91,44,16,418
3771132_OnAnIsland.txt,924,12,77,519,65,35,15,634
3771139_BelgianChamberOfPeoplesRepresentatives.txt,712,19,37,449,27,53,5,534
3772801_KellyTayloreastenders.txt,1438,13,110,392,291,73,87,843
377293_Wisp.txt,554,11,50,219,71,50,24,364
377295_Americorps.txt,616,18,34,302,61,57,6,426
377314_BeavertonSchoolDistrict.txt,1303,58,22,815,44,31,11,901
377332_WilliamManchester.txt,632,12,52,257,58,34,12,361
3773548_ArtaxiadDynasty.txt,750,11,68,298,80,30,19,427
3773610_12012band.txt,1048,15,69,504,60,52,17,633
3774730_BostonParkLeague.txt,1283,110,11,687,71,63,21,842
3775478_DalitVoice.txt,645,15,43,236,89,54,26,405
3775479_MerryHillNorthCarolina.txt,741,13,57,309,102,33,23,467
3775929_Duvdevan.txt,2272,24,94,827,298,214,106,1445
3776143_StringTheorynovels.txt,1231,36,34,376,221,77,62,736
378050_SaatchiGallery.txt,2277,44,51,1047,273,118,58,1496
378109_Coimbra.txt,3346,52,64,1483,290,295,63,2131
378111_HowardUniversity.txt,1144,28,40,579,102,69,14,764
378112_Dnyaneshwar.txt,751,20,37,347,85,44,20,496
3781433_PoliticsOfSvalbard.txt,1127,24,46,506,128,70,28,732
3782394_CardiffRugby.txt,783,23,34,342,107,36,20,505
3783862_RussellMillsartist.txt,1087,21,51,497,111,77,37,722
3783867_ProfaneExistenceDiscography.txt,615,3,205,325,5,12,1,343
378410_SecondaryEducationInJapan.txt,2366,35,67,747,308,328,131,1514
378420_Metalhead.txt,3640,38,95,1188,492,382,260,2322
378422_DirkPitt.txt,1584,22,72,648,195,108,57,1008
378430_UnemploymentBenefit.txt,3080,49,62,1071,481,229,115,1896
3784621_JohnBrereton.txt,824,10,82,304,115,42,21,482
3786808_AirforceDeltaStorm.txt,541,17,31,215,57,46,13,331
37870_PopeLeoX.txt,4269,40,106,1546,528,254,106,2434
37876_NationalOceanicAndAtmosphericAdministration.txt,1977,39,50,1015,191,130,25,1361
37878_MentalRetardation.txt,2518,30,83,788,365,330,133,1616
37879_Brainwashing.txt,6224,82,75,2425,785,477,200,3887
3788210_EnshinKarate.txt,1475,22,67,576,200,122,48,946
37882_Crocodile.txt,2718,49,55,999,395,216,117,1727
37885_Falstaffopera.txt,898,12,74,360,125,38,26,549
37888_Aida.txt,1476,29,50,624,187,69,31,911
37891_MickyDolenz.txt,848,16,53,330,114,47,17,508
3789992_CornerstoneChristianAcademyillinois.txt,573,17,33,283,59,38,10,390
37903_IlTrovatore.txt,1024,23,44,415,156,29,22,622
379051_EquivalenceOfCategories.txt,1602,24,66,589,169,138,68,964
37913_EscapeVelocity.txt,1717,54,31,578,203,134,68,983
379140_ListOfCollegesAndUniversitiesInSouthKorea.txt,2861,32,89,2144,14,8,9,2175
37914_Carmen.txt,3485,51,68,1256,528,257,128,2169
37915_DieMeistersingerVonNrnberg.txt,3422,50,68,1211,492,199,122,2024
37916_TheMagicFlute.txt,2512,48,52,972,340,122,70,1504
37924_TheBarberOfSeville.txt,1272,19,66,553,166,60,31,810
37929_LaBohme.txt,1478,22,67,584,201,79,48,912
3793357_FdrationDuScoutismeLibanais.txt,569,14,40,244,73,28,10,355
37933_MaisonIkkoku.txt,5995,51,117,2629,707,288,223,3847
37934_GaetanoDonizetti.txt,2643,20,132,1352,142,146,39,1679
3793507_DorothySebastian.txt,590,18,32,277,69,26,10,382
3794489_Philautus.txt,683,4,170,426,46,23,3,498
379470_YouthCriminalJusticeAct.txt,1010,23,43,332,167,73,41,613
379489_DuchyOfNormandy.txt,725,19,38,273,83,44,14,414
379496_GaryLStewart.txt,596,10,59,230,77,21,18,346
379497_ColumbineHighSchool.txt,853,15,56,344,116,50,22,532
379517_ListOfGuestStarsOnFriends.txt,2069,6,344,1018,159,70,32,1279
379518_PanoramicPhotography.txt,2130,24,88,715,267,232,115,1329
379523_WallOfSound.txt,765,16,47,275,104,57,33,469
37966_Himalayas.txt,2830,46,61,1147,297,206,67,1717
37973_JohnMaynardKeynes.txt,2799,30,93,1135,333,199,90,1757
37977_Millet.txt,711,23,30,340,82,48,24,494
37978_Totnes.txt,878,18,48,321,132,54,28,535
37979_Mayflower.txt,1395,31,45,523,182,83,47,835
37981_LaLiga.txt,2084,30,69,806,216,127,53,1202
37983_Typex.txt,1103,23,47,421,148,67,22,658
3798715_ViceCooler.txt,1039,29,35,591,68,38,18,715
37988_UnitedStatesNationalGuard.txt,2467,42,58,1031,268,120,45,1464
37993_ToiletPaper.txt,2790,35,79,952,444,244,126,1766
37994_Barley.txt,1372,30,45,475,231,118,67,891
380286_Wit.txt,600,16,37,220,77,49,30,376
3803971_RoadDiet.txt,651,11,59,253,99,44,18,414
380554_WilliamTryon.txt,724,11,65,291,97,27,14,429
380569_JohnFKennedyCenterForThePerformingArts.txt,1412,23,61,627,160,93,26,906
380579_Belobog.txt,1101,8,137,349,138,136,56,679
380583_Dazbog.txt,1503,15,100,559,204,124,66,953
380590_Jarilo.txt,1447,19,76,529,180,108,57,874
380676_ProfessorHubertFarnsworth.txt,2706,17,159,852,429,200,143,1624
380677_OnehourThanksgivingDinner.txt,722,10,72,233,117,63,43,456
3807981_KunstsammlungNordrheinwestfalen.txt,609,11,55,271,57,25,13,366
3809717_JessieWhiteMario.txt,1248,21,59,478,176,76,34,764
3809742_TheChinaStudy.txt,1226,21,58,431,139,159,49,778
3809966_Silenceband.txt,948,15,63,422,101,67,17,607
3811638_Sabbac.txt,748,12,62,314,87,45,13,459
381305_LondonWall.txt,663,8,82,219,87,52,23,381
381310_Gorn.txt,736,11,66,297,88,43,24,452
3813216_LuckyGlauber.txt,585,7,83,231,71,33,31,366
381374_TempleOfMithrasLondon.txt,716,11,65,291,79,59,16,445
3814223_ListOfConstituenciesInTheParliamentOfScotlandAtTheTimeOfTheUnion.txt,612,13,47,231,54,29,15,329
3815248_JesseStone.txt,655,13,50,248,79,56,20,403
381644_ConstitutionOfAfghanistan.txt,1129,24,47,420,161,79,33,693
381658_FkPartizan.txt,1698,32,53,703,144,106,43,996
3816617_MianTufailMohammad.txt,799,15,53,308,90,59,28,485
381661_Owicim.txt,763,15,50,337,84,55,20,496
3816992_Dholavira.txt,948,13,72,345,134,68,40,587
3817053_ErsaHautecorse.txt,707,12,58,271,59,46,8,384
381707_MetropolitanBoroughOfBattersea.txt,759,16,47,297,73,30,8,408
381709_MetropolitanBoroughOfHackney.txt,603,13,46,237,64,27,8,336
381717_MetropolitanBoroughOfStokeNewington.txt,726,17,42,281,77,35,14,407
381732_LarryCraig.txt,931,27,34,363,126,43,14,546
3818583_Hmh361.txt,843,16,52,370,89,41,21,521
3819030_24season3.txt,951,14,67,388,118,51,27,584
3819424_801band.txt,1052,25,42,525,90,69,38,722
3819605_SplShaPoLang.txt,1515,26,58,592,207,91,52,942
3820004_Barrettjackson.txt,909,19,47,385,97,72,19,573
3820361_MegatonMan.txt,1699,42,40,699,239,126,60,1124
382420_SouthEasternTrains.txt,1079,22,49,495,130,60,11,696
382421_SopwithAviationCompany.txt,985,11,89,351,108,109,33,601
3824727_TheBluffers.txt,874,19,46,268,129,66,43,506
3825197_PlanetEarthsong.txt,651,22,29,262,81,62,21,426
3826140_Rice.txt,825,17,48,425,95,50,16,586
3826330_WilliamRobbinswesternSettler.txt,2006,12,167,636,341,98,65,1140
3827091_Radiancesoftware.txt,1306,41,31,450,213,122,30,815
3827117_TitoMukhopadhyay.txt,849,16,53,289,139,66,40,534
3827279_SoftwarePipelining.txt,1978,20,98,697,265,91,80,1133
382797_JohnHawkins.txt,989,22,44,351,147,54,31,583
382800_FriedrichGustavJakobHenle.txt,619,9,68,248,55,52,19,374
382801_Glucose6phosphateDehydrogenaseDeficiency.txt,1016,22,46,404,146,115,35,700
3828057_SurenpahlavClan.txt,3301,42,78,1184,413,227,98,1922
3828058_TheRoadGoesEverOnsong.txt,1088,26,41,312,173,70,48,603
382809_Dynebolic.txt,622,14,44,252,94,73,28,447
382824_TheFreewheelinBobDylan.txt,5043,59,85,1851,714,335,240,3140
3828295_ListOfShadowrunBooks.txt,1072,17,63,629,37,16,5,687
3829543_DerSchuhDesManitu.txt,2101,26,80,754,325,128,75,1282
3831511_CzechAirForce.txt,556,33,16,278,51,60,8,397
38323_Cigar.txt,4370,71,61,1579,639,338,221,2777
38326_UnitedNationsInterimAdministrationMissionInKosovo.txt,759,18,42,302,106,57,31,496
38327_Cigarette.txt,3337,50,66,1273,497,226,117,2113
38330_PovertyInTheUnitedStates.txt,3014,43,70,1066,358,315,93,1832
3833992_Milva.txt,1372,17,80,689,77,90,26,882
3834000_Actigraph.txt,612,6,102,240,66,49,19,374
38341_Harlequin.txt,1050,15,70,382,143,75,54,654
383448_MusicOfItaly.txt,8967,114,78,3236,1005,1221,380,5842
383452_CaliforniaStateUniversitySanMarcos.txt,914,20,45,423,92,58,23,596
3834589_DetroitCompuwareAmbassadors.txt,930,25,37,427,105,40,14,586
3835399_ListOfRomantics.txt,1005,26,38,817,22,60,7,906
3835549_GenghisKhanAndTheMakingOfTheModernWorld.txt,576,7,82,204,78,57,20,359
3836974_IndraSen.txt,860,11,78,379,63,30,14,486
3837317_NewDemocraticPartyCandidates2006CanadianFederalElection.txt,3757,98,38,1605,418,228,65,2316
3837949_JanWernerDanielsen.txt,574,13,44,188,72,49,20,329
383864_JoePiscopo.txt,716,11,65,347,84,47,16,494
38387_LuciaDiLammermoor.txt,1492,36,41,633,190,83,40,946
383893_CyanWorlds.txt,568,8,71,252,76,34,17,379
383899_SethMacfarlane.txt,1510,22,68,631,181,81,48,941
38390_Dementia.txt,961,19,50,355,115,107,33,610
383916_FederationOfBosniaAndHerzegovina.txt,1119,32,34,475,127,52,30,684
383925_HamiltonFish.txt,1204,22,54,518,119,52,16,705
38393_Rubber.txt,1746,35,49,641,277,149,67,1134
3839852_ListOfAfghanAirForceAircraft.txt,635,12,52,174,80,25,9,288
3842100_SexyCommandoGaidenSugoiyoMasarusan.txt,1679,24,69,570,259,121,80,1030
3842315_CalifornianHinduTextbookControversy.txt,3280,38,86,1659,352,122,55,2188
3843259_UnidentifiedSubmergedObject.txt,835,10,83,275,151,63,34,523
3843277_CossacksEuropeanWars.txt,1616,18,89,531,238,138,83,990
3843299_CountJanDogaossowski.txt,831,23,36,370,85,45,16,516
3844273_ListOfGuardiansOfTimeTrilogyPowers.txt,719,20,35,258,117,40,33,448
3844669_TheRickyGervaisShow.txt,3601,54,66,1209,548,235,146,2138
3845218_BrachypodiumDistachyon.txt,804,5,160,448,53,63,6,570
384531_UssLyndeMccormickddg8.txt,731,17,43,328,82,29,6,445
3846593_TripleJHottest1002005.txt,1124,14,80,556,38,26,13,633
3848602_JessicaFolcker.txt,693,15,46,298,73,49,18,438
3849456_AuriesvilleNewYork.txt,748,6,124,276,102,44,26,448
384956_ListOfFilmTopics.txt,3303,52,63,1900,83,207,11,2201
384959_Sa1apollo.txt,617,14,44,191,96,48,27,362
384984_PreemptiveWar.txt,832,14,59,287,113,71,26,497
384990_SexLiesAndVideotape.txt,741,15,49,296,111,40,22,469
3849994_ComputationalElectromagnetics.txt,1885,48,39,871,206,192,58,1327
385000_TexasRangerDivision.txt,7172,67,107,2754,955,442,214,4365
3850067_Stealthwebcomic.txt,640,23,27,245,88,57,26,416
3850791_LagayliaFrazier.txt,742,7,106,263,103,46,17,429
3851034_BlackRockRanger.txt,645,7,92,271,75,44,27,417
3851773_ProductInformationManagement.txt,1110,23,48,483,138,109,34,764
3853358_KyawZaw.txt,2306,17,135,926,281,120,66,1393
3853380_StemCellTreatments.txt,2561,36,71,991,391,228,87,1697
3855286_JohnDickinsonHighSchool.txt,659,11,59,370,53,38,15,476
3855316_2006TableMountainFire.txt,598,10,59,215,81,42,19,357
385621_PlasmaDiagnostics.txt,766,27,28,263,105,65,16,449
385688_NationalAnthemOfPeru.txt,781,10,78,256,102,59,19,436
385706_TheLionKing1.txt,1877,19,98,704,265,101,63,1133
3858681_ListOfDogDiseases.txt,8839,21,420,3306,1386,987,324,6003
3858760_FuJin.txt,4203,40,105,1662,581,237,156,2636
3859698_HistoryOfLibetarianism.txt,896,7,128,299,122,102,28,551
3859706_ChrisThomasrecordProducer.txt,1823,31,58,588,296,73,88,1045
3859725_VictorClemente.txt,633,8,79,206,114,33,32,385
3860685_ClimaxBluesBand.txt,596,7,85,286,46,24,11,367
3860686_CherokeeDance.txt,1708,21,81,702,193,162,56,1113
386074_SenOcasey.txt,950,23,41,339,115,75,29,558
386082_Tropius.txt,768,15,51,297,92,88,21,498
386085_JohnLewisPartnership.txt,2427,53,45,1024,283,121,75,1503
386090_Waitrose.txt,2649,37,71,1013,347,221,116,1697
386093_GeorgeJesseljurist.txt,1300,14,92,371,156,82,50,659
386095_Necron.txt,2771,31,89,829,437,246,175,1687
386097_Type42Destroyer.txt,946,16,59,354,131,57,36,578
386128_ListOfScientificMethodTopics.txt,717,43,16,363,59,71,11,504
3861641_TellMeSomething.txt,655,6,109,198,105,57,19,379
3861649_Splitoctonion.txt,637,18,35,227,71,56,14,368
3861652_NewYorkStateRoute33.txt,1126,24,46,383,113,102,61,659
3862103_Winbond.txt,608,14,43,363,31,43,6,443
3864015_JetsetaGage.txt,755,22,34,312,102,54,21,489
3864046_ThrissurDistrict.txt,1849,37,49,774,201,134,39,1148
3866415_PortWarwick.txt,637,9,70,252,81,56,9,398
386723_PiotrkwTrybunalski.txt,1356,23,58,505,133,138,23,799
3867420_TodSloanjockey.txt,1098,13,84,396,160,57,31,644
386763_ThomasErskine1stBaronErskine.txt,1262,10,126,377,177,82,37,673
3868249_IcelandicLiterature.txt,973,19,51,379,96,118,34,627
3869208_LetItBefilm.txt,891,20,44,385,105,56,25,571
3871136_SharpesCompanynovel.txt,1174,16,73,402,208,55,51,716
387165_PoppaeaSabina.txt,921,13,70,339,122,67,23,551
387175_LandsatProgram.txt,942,12,78,339,145,62,20,566
387185_EnglishlanguageEditionsOfTheHobbit.txt,2423,12,201,1092,239,198,69,1598
387188_ColoradoTickFever.txt,985,20,49,339,160,73,50,622
3872660_LeonardoIsCaughtInTheGripOfAnOutbreakOfRandalsImaginationAndPatrickSwayzeEitherDoesOrDoesntWorkInTheNewPetStore.txt,719,8,89,292,112,23,27,454
3873491_TariffInAmericanHistory.txt,3064,23,133,1135,387,290,96,1908
3874138_WaterParkmalcolmInTheMiddleEpisode.txt,1621,15,108,513,271,103,80,967
3875140_Banditcomics.txt,749,11,68,273,106,50,34,463
3875481_KnightsRevolt.txt,1146,15,76,362,177,77,54,670
3875870_CyrusLeroyBaldridge.txt,1851,21,88,773,198,97,46,1114
3875938_NoarHill.txt,906,22,41,384,138,81,27,630
3876090_ListOfSigmaNuChapters.txt,30,1,30,10,5,2,0,17
387800_BostonStrangler.txt,1451,16,90,519,213,87,54,873
3878513_LincolnsEarlyLifeAndCareer.txt,1802,19,94,665,245,110,65,1085
3879307_MaximakingOfFighters.txt,599,11,54,213,93,45,19,370
3880293_TheDogsOfWards9.txt,858,17,50,345,112,41,30,528
3882852_BernardLevy.txt,631,9,70,207,94,40,27,368
3883819_Hmm265.txt,1042,19,54,453,113,50,17,633
3884614_Conjoint.txt,648,14,46,209,88,67,24,388
3884780_ClanSinclair.txt,2470,63,39,1061,304,103,52,1520
3885512_WthkformerNewJerseyRadioStation.txt,748,9,83,319,85,25,22,451
3885787_Soulhead.txt,583,6,97,265,63,30,13,371
3886219_IndigoAirlines.txt,1265,14,90,592,150,130,39,911
3888145_ReykjavkAirport.txt,574,11,52,188,64,58,19,329
3888981_MasakazuKawabe.txt,641,7,91,288,44,24,9,365
3890949_LegalInstitutionsOfScotlandInTheHighMiddleAges.txt,941,11,85,396,103,92,45,636
3892299_AJPero.txt,928,11,84,364,120,51,28,563
3892499_Wkkf.txt,649,12,54,283,66,40,15,404
3892525_TheGoldenBird.txt,677,16,42,245,86,24,18,373
389373_OleBull.txt,589,14,42,201,80,35,20,336
3893884_Asyut.txt,561,16,35,258,51,37,8,354
3893898_DelhiCollegeOfEngineering.txt,1189,30,39,514,135,71,19,739
389401_ScientificManagement.txt,1680,32,52,591,249,122,67,1029
389415_MarioDagata.txt,785,11,71,256,115,38,16,425
389426_ChalfontStPeter.txt,1138,16,71,482,126,54,37,699
3894843_ForeignExchangeManagementAct.txt,1986,34,58,717,248,148,32,1145
38957_Snowboarding.txt,2962,28,105,1071,468,211,120,1870
38965_CaryGrant.txt,2632,40,65,1118,296,142,71,1627
38966_Aqueduct.txt,1534,27,56,648,163,136,46,993
3896702_ListOfPipelineAccidents.txt,145,4,36,50,25,7,1,83
38972_Chinatown.txt,7584,138,54,3095,857,871,309,5132
38975_SkateboardingTrick.txt,1068,16,66,318,182,76,57,633
3898267_TollcrossEdinburgh.txt,604,12,50,254,65,51,15,385
3899255_KillianDocumentsAuthenticityIssues.txt,4292,56,76,1551,626,321,175,2673
3900171_sterreichischePostsparkasse.txt,1047,18,58,377,112,109,21,619
390047_HenryMorrisonFlagler.txt,1462,25,58,649,187,56,37,929
3900625_JacquesLeFatalisteEtSonMatre.txt,579,9,64,205,70,52,33,360
390073_ListOfPanamanians.txt,1469,13,113,1025,44,78,8,1155
3901153_YouCallThisMusicVolume2.txt,542,44,12,250,42,26,17,335
390123_TasmanBridge.txt,772,12,64,305,91,49,26,471
3902009_RobertRCoats.txt,663,6,110,261,59,46,9,375
39021_Daytona500.txt,3376,45,75,1162,476,241,98,1977
3902571_EconomicHistoryOfNicaragua.txt,2343,31,75,801,318,234,76,1429
3902573_JohnGFoster.txt,668,10,66,270,86,26,17,399
39026_Netiquette.txt,1840,24,76,530,346,165,95,1136
39027_MikeTyson.txt,4715,69,68,1707,718,246,149,2820
39029_Bamboo.txt,2439,42,58,800,404,234,128,1566
39031_RJMitchell.txt,689,11,62,243,98,41,24,406
39032_RollsroyceMerlin.txt,2302,27,85,806,314,173,92,1385
390436_TheHauntedMansionfilm.txt,2405,17,141,919,318,89,80,1406
39043_AfricanClawedFrog.txt,701,10,70,238,109,71,22,440
3904509_JhunHoon.txt,623,7,89,208,95,33,29,365
390476_Chem.txt,756,14,54,260,97,59,25,441
390498_CapeMaylewesFerry.txt,1371,29,47,523,168,108,34,833
39049_RobertSMulliken.txt,1195,24,49,442,142,80,41,705
390520_IranAirFlight655.txt,3678,42,87,1363,520,238,114,2235
39052_ProvincetownMassachusetts.txt,1435,36,39,592,165,104,38,899
39066_ListOfReligions.txt,2421,73,33,1784,90,134,38,2046
39068_DigitalElectronics.txt,4037,75,53,1377,600,479,180,2636
3906954_RamnathGoenka.txt,1136,17,66,466,178,50,33,727
39070_MaximilianIHolyRomanEmperor.txt,1501,21,71,588,168,74,34,864
39071_SamuelDeChamplain.txt,2342,29,80,802,334,101,68,1305
3907316_LacticAcidBacteria.txt,669,8,83,248,96,84,29,457
39075_SpiroAgnew.txt,2289,23,99,920,305,132,61,1418
39076_BattleOfMohcs.txt,1301,20,65,437,187,95,49,768
3907769_TheMysteriousGeographicExplorationsOfJasperMorello.txt,1403,17,82,663,159,68,31,921
3907770_Bestival.txt,852,11,77,432,88,45,21,586
3908340_MusicOfVenice.txt,722,13,55,265,87,65,22,439
3908724_TpcAtSawgrass.txt,781,12,65,337,86,55,31,509
3909688_BeosApi.txt,732,9,81,300,115,54,26,495
3909858_NewYorkStateRoute52.txt,1801,30,60,632,195,114,95,1036
391149_MadSeason.txt,1028,27,38,453,120,49,42,664
391156_BerlinStateOpera.txt,703,17,41,320,83,44,21,468
3912266_DucatiPaso.txt,596,12,49,204,82,61,14,361
3913229_IanAtkins.txt,668,11,60,229,84,41,15,369
391525_JeanlouisGasse.txt,1353,17,79,507,182,104,42,835
391531_TheCrabWithTheGoldenClaws.txt,703,13,54,261,90,47,11,409
391568_MethylTertbutylEther.txt,1850,27,68,699,273,155,79,1206
391578_DeuceMcallister.txt,783,6,130,292,92,48,9,441
391611_MormonismAndAuthority.txt,1589,16,99,533,217,134,66,950
3916477_DutchNationalityLaw.txt,2701,70,38,808,345,264,76,1493
3916598_DemocraticResponseTo2006StateOfTheUnionAddress.txt,1041,18,57,403,129,76,25,633
3917438_SwedishNationalityLaw.txt,954,32,29,321,151,94,32,598
3918023_ListOfImprovGames.txt,3917,12,326,1274,549,239,160,2222
3919342_ListOfActsOfParliamentOfTheUnitedKingdomParliament19201939.txt,10663,108,98,7090,33,93,4,7220
3919955_F1PowerboatRacing.txt,971,19,51,350,134,84,39,607
3921925_BigBoneKentucky.txt,774,16,48,297,104,53,35,489
3921930_Kkbqfm.txt,908,11,82,417,87,54,28,586
3922361_Eppingen.txt,678,14,48,271,68,53,12,404
392245_HavelockEllis.txt,1081,16,67,402,115,64,29,610
392250_LaiseniaQarase.txt,4367,62,70,1453,694,276,131,2554
392252_TynwaldDay.txt,2295,26,88,911,261,108,73,1353
392309_FounderEffect.txt,763,12,63,274,92,82,38,486
3923747_LocalConsistency.txt,5140,91,56,1434,817,526,193,2970
3924342_ArthurPardee.txt,704,8,88,267,73,43,20,403
3924354_AscentMedia.txt,1559,34,45,876,158,144,11,1189
3924366_TheHiramKey.txt,1104,26,42,382,156,78,45,661
392620_Heinkel.txt,861,13,66,413,77,66,23,579
3926261_BangkokUniversity.txt,494,19,26,217,51,37,11,316
3926274_WonderGirlcassieSandsmark.txt,1691,26,65,597,271,79,66,1013
392689_NewQueerCinema.txt,984,17,57,536,66,61,25,688
392690_ConsoleGame.txt,1591,20,79,553,263,105,87,1008
392691_HomelandSecurityAdvisorySystem.txt,1158,23,50,472,154,86,38,750
3928658_LouderNow.txt,1008,27,37,445,119,55,20,639
3929605_Boroughitis.txt,660,11,60,227,91,50,18,386
3930462_Mexicogame.txt,1898,17,111,452,288,171,106,1017
393289_BbcThree.txt,1454,26,55,550,213,102,49,914
3932903_Amona.txt,775,7,110,275,123,37,22,457
393290_BlackBoy.txt,1149,10,114,317,199,92,63,671
393356_HsbcHongKongHeadquartersBuilding.txt,1460,31,47,557,196,109,39,901
393359_BethNumber.txt,610,33,18,198,74,45,23,340
3933994_ListOf2005HotWheels.txt,1501,7,214,914,3,24,0,941
3935369_Strovolos.txt,678,16,42,301,81,47,11,440
3935392_Pararaton.txt,718,11,65,280,81,47,26,434
3937335_WilliamJohnMacleay.txt,669,6,111,200,103,28,19,350
393756_StJohnstoneFc.txt,1350,50,27,625,127,85,29,866
3938188_ColorGuardflagSpinning.txt,1433,23,62,529,194,141,55,919
3938277_PlayersWhoHaveConvertedFromOneFootballCodeToAnother.txt,1349,29,46,572,171,148,42,933
3938813_HikaruNishida.txt,596,11,54,269,30,17,5,321
3940762_MayiTheaterCompany.txt,613,12,51,313,64,47,8,432
39418_MooresLaw.txt,2946,39,75,1053,399,247,145,1844
3942507_PyotrSchmidt.txt,820,10,82,341,101,35,11,488
39425_PrimoLevi.txt,2241,28,80,802,302,170,65,1339
39428_RecordingIndustryAssociationOfAmerica.txt,3667,51,71,1400,541,243,92,2276
3943138_WingCommanderEndRun.txt,3285,24,136,1215,463,203,118,1999
3944073_MvAlsalamBoccaccio98.txt,1329,28,47,471,223,71,38,803
3945056_JackCommon.txt,623,6,103,211,73,43,28,355
3945065_ListOfStatutoryInstrumentsOfTheUnitedKingdom1987.txt,15506,49,316,11086,9,98,1,11194
3945928_JeanLouis.txt,324,4,81,178,9,5,2,194
3947476_Oxygennovel.txt,3259,48,67,1093,485,235,182,1995
3947513_RousettusAegyptiacus.txt,579,16,36,185,71,60,38,354
3947842_NikaAward.txt,673,8,84,347,86,22,10,465
3947887_DiomedesDaz.txt,1133,20,56,387,214,55,42,698
39478_HistoryOfLiechtenstein.txt,902,12,75,307,110,64,20,501
394792_JackieBrownfilm.txt,1070,20,53,463,133,65,37,698
394795_MollyElliotSeawell.txt,1007,20,50,387,109,69,39,604
394823_CarlWeathers.txt,579,10,57,237,54,33,17,341
394825_HailToTheRedskins.txt,778,16,48,292,106,51,35,484
394832_PlateNumberCoil.txt,626,6,104,217,84,47,26,374
394844_Pasha.txt,738,16,46,358,55,58,27,498
3948476_WestSideMarket.txt,862,9,95,319,108,64,29,520
394868_info.txt,676,9,75,195,114,71,22,402
3949323_JackWeiss.txt,612,10,61,247,85,39,13,384
3949418_PantechniconVan.txt,610,7,87,178,107,43,30,358
3950415_AcademyOfLight.txt,1169,17,68,444,180,81,26,731
3950433_DarkFall.txt,1057,28,37,353,144,75,36,608
3950865_NewOrleansNeighborhoods.txt,570,22,25,324,49,36,20,429
3951818_AnneMackenzie.txt,998,26,38,395,124,56,33,608
3953733_ColonialViper.txt,940,21,44,355,122,75,28,580
39541_1378.txt,491,3,163,265,37,23,8,333
395530_BattleOfPortArthur.txt,1888,28,67,657,275,121,60,1113
3956034_Atlantropa.txt,862,10,86,356,88,87,22,553
3957825_ThePumpkinificationOfClaudius.txt,596,12,49,224,65,36,15,340
3957_Baroque.txt,3745,53,70,1356,476,347,142,2321
3958361_LngElPasoSonatrach.txt,809,19,42,321,135,36,20,512
395883_Bananaman.txt,1232,19,64,538,145,89,57,829
395888_BrettonWoodsSystem.txt,9692,134,72,3355,1341,851,299,5846
395918_RoyalGeographicalSociety.txt,1070,22,48,485,116,57,13,671
3959260_Versican.txt,864,13,66,361,96,101,18,576
3959_BooleanAlgebra.txt,2538,61,41,978,243,186,84,1491
3960231_MichaelJMalikSr.txt,760,10,76,354,91,49,12,506
3960247_ThePlotOfTheFumaClan.txt,690,16,43,331,78,33,19,461
3962175_SilvaNight.txt,1090,19,57,380,157,78,43,658
3963_BeachcomberpenName.txt,748,21,35,296,108,43,27,474
3965_BillJoy.txt,880,13,67,364,107,54,24,549
396615_JohnRobertSchrieffer.txt,661,8,82,265,75,29,9,378
396691_ChemicalMortarBattalion.txt,1229,25,49,436,171,109,31,747
396693_ArdbraccanHouse.txt,667,8,83,255,77,56,22,410
3966984_RiverEngineering.txt,3339,25,133,982,394,332,146,1854
3967009_WaterPoloAtThe1988SummerOlympics.txt,821,31,26,596,23,16,4,639
3967948_Tedsuikoden.txt,580,7,82,226,79,19,18,342
3967_Bandwidth.txt,1250,25,50,456,149,96,41,742
3968527_ExtendedBootRecord.txt,667,16,41,211,59,63,9,342
3968906_BbcGeneralForcesProgramme.txt,696,17,40,300,87,41,16,444
3968928_DavidMillerpoliticalTheorist.txt,954,14,68,300,133,87,36,556
3968967_WaylandHighSchool.txt,856,25,34,359,112,56,25,552
3968_Bodhisattva.txt,1502,23,65,569,215,104,53,941
3969484_RichardGordonpolitician.txt,968,10,96,397,108,67,15,587
396968_MotionCapture.txt,2913,48,60,1032,402,343,90,1867
396982_CarlFHHenry.txt,828,36,23,402,74,45,16,537
396990_ListOfPhysicsTopicsAe.txt,1370,16,85,878,8,36,1,923
3969_BuckinghamPalace.txt,6044,79,76,2298,814,426,174,3712
397001_PeterWiggin.txt,1832,14,130,622,274,105,62,1063
397025_AceOfBase.txt,2394,53,45,1005,263,132,58,1458
3970326_Atheris.txt,817,25,32,320,123,69,41,553
3970340_AhmedYacoubi.txt,604,9,67,247,76,27,13,363
3970341_WowAndFlutterMeasurement.txt,1353,14,96,405,218,122,72,817
397056_TimelineOfQuebecHistory1982ToPresent.txt,1262,9,140,512,98,95,26,731
397064_Poeticsaristotle.txt,547,17,32,224,69,40,18,351
397066_SlaveryInCanada.txt,621,15,41,227,82,54,21,384
3970_BritishAirways.txt,5923,89,66,2302,768,406,155,3631
3971283_RobertGammage.txt,589,8,73,250,40,26,5,321
3971356_Florencio.txt,583,17,34,221,70,37,29,357
3971481_TheWorldOfNarue.txt,750,29,25,299,97,51,26,473
3973_Bicycle.txt,4277,71,60,1633,568,400,153,2754
3974732_QubecSolidaire.txt,852,22,38,330,103,74,28,535
3974835_NewZealandWine.txt,2609,44,59,1075,314,216,133,1738
3974_Biopolymer.txt,961,20,48,316,152,92,41,601
3975678_QuincyWilson.txt,707,8,88,251,102,40,14,407
3975_UnitedKingdomGeneralElection2001.txt,624,14,44,236,70,50,25,381
3976231_CenturyHighSchooloregon.txt,1230,27,45,545,161,62,18,786
3976_BiblicalCanon.txt,6958,80,86,2492,896,405,278,4071
397713_Darts.txt,2932,41,71,1115,352,243,113,1823
397715_MissPortersSchool.txt,663,12,55,383,38,29,11,461
397721_TheFamousFivecanada.txt,691,14,49,257,82,50,25,414
397790_McguffeyReaders.txt,1587,17,93,561,222,137,45,965
3978616_ZwizekModzieyPolskiej.txt,605,7,86,224,73,74,23,394
3978_BookOfMormon.txt,7549,84,89,2757,946,442,223,4368
3979_Baptist.txt,7224,97,74,2743,839,597,286,4465
3980144_OnimushaDawnOfDreams.txt,2008,21,95,701,297,139,79,1216
3980554_ListOfMinorCharactersInSavedByTheBell.txt,4215,129,32,1467,688,221,191,2567
3980621_TigresDelLicey.txt,751,12,62,447,67,36,13,563
3980956_StevenClemons.txt,810,10,81,393,83,50,12,538
3980978_TransmisionesYMecanicos.txt,765,8,95,300,113,41,21,475
3980986_Program437.txt,727,9,80,289,89,65,21,464
398138_ListOfComputeranimatedFilms.txt,1419,39,36,855,77,57,20,1009
398146_LebanonCedar.txt,794,11,72,314,79,66,24,483
3981505_ListOfPrideEvents.txt,892,4,223,228,5,5,2,240
398165_SebastianShawactor.txt,521,7,74,238,34,11,6,289
398166_SebastianShawcomics.txt,2077,21,98,781,302,116,97,1296
3981_Blackjack.txt,3515,55,63,1124,531,285,144,2084
3983382_ListOfContaminatedCellLines.txt,971,24,40,471,115,52,29,667
3983430_DraftEisenhower.txt,1600,21,76,531,243,98,62,934
3983441_BektashismAndFolkReligion.txt,775,7,110,212,130,67,40,449
3983495_KlaipdaRevolt.txt,1980,35,56,696,288,137,37,1158
3984342_FayettevillemanliusHighSchool.txt,2469,42,58,1089,241,186,50,1566
3984401_AxiomOfArchimedes.txt,628,28,22,219,66,55,26,366
3984_BernieFederko.txt,647,12,53,290,60,30,10,390
3985_BuffaloNewYork.txt,7070,113,62,3056,738,542,206,4542
3986891_SelwynSchool.txt,829,22,37,313,98,62,23,496
3986_BenjaminFranklin.txt,8636,98,88,3290,1055,557,245,5147
3988656_CzechRepublicAtThe2006WinterOlympics.txt,950,63,15,516,49,66,3,634
398878_Rincewind.txt,1554,22,70,458,236,112,92,898
3989289_Rebeccamusical.txt,1239,17,72,744,72,49,18,883
3989668_JamesWattCollege.txt,644,16,40,253,88,46,17,404
3989_BanachSpace.txt,1447,31,46,526,192,123,54,895
3991109_GmAPlatformrwd.txt,645,8,80,227,82,64,23,396
399187_HansMajestetKongensGarde.txt,735,9,81,302,80,47,11,440
3992119_BangaloreMetropolitanEnvironment.txt,823,21,39,339,87,70,12,508
3992125_PaceTwinPvr.txt,1903,35,54,749,272,116,79,1216
3992146_ZoneValve.txt,629,20,31,229,97,54,24,404
3992194_Warhammer40000WeaponsEquipmentAndVehicles.txt,1571,39,40,599,190,133,67,989
399231_Concussion.txt,1066,20,53,380,153,95,48,676
399233_BourneEndBuckinghamshire.txt,1363,30,45,558,174,72,45,849
399238_WinterbourneGloucestershire.txt,839,17,49,330,89,62,33,514
3992_BramStoker.txt,906,21,43,401,87,52,19,559
3993106_LoveGetsMeEveryTime.txt,612,10,61,274,62,45,22,403
3994017_WaqoGutu.txt,599,12,49,217,89,43,13,362
3994466_RoyMustang.txt,2098,27,77,709,358,91,80,1238
3994486_MikePhipps.txt,767,13,59,283,87,36,16,422
3994649_SosrihannaSong.txt,897,15,59,334,112,85,27,558
3995423_TheLakeHousefilm.txt,1846,29,63,720,247,66,63,1096
3995_ContractBridge.txt,7837,119,65,2550,1200,612,305,4667
3996407_TheDefense.txt,768,13,59,243,125,47,19,434
3996_Boat.txt,772,15,51,270,121,72,37,500
3997371_DenhamHarman.txt,706,15,47,264,98,40,11,413
3997997_TransitWindsor.txt,744,39,19,294,81,33,22,430
3997_Blood.txt,3119,55,56,1118,507,264,120,2009
3998379_JainsOfMaharashtra.txt,722,24,30,311,90,50,14,465
399908_WhiteFlight.txt,3668,43,85,1347,458,394,185,2384
3999856_RoyalDanishAirForce.txt,621,18,34,291,76,37,5,409
39_Albedo.txt,2221,38,58,743,274,251,98,1366
4000368_YouMayNowKissTheuhguyWhoReceives.txt,1539,8,192,594,236,66,42,938
4000799_HistoryOfTransylvania.txt,7640,90,84,2826,968,490,234,4518
4000800_Hamlet1964Film.txt,665,15,44,304,61,48,27,440
4000811_BrianCadd.txt,3104,50,62,1455,289,209,74,2027
4001390_TurtlesAndTortoisesInPopularCulture.txt,1470,13,113,605,173,98,33,909
4001_BenedictOfNursia.txt,3164,57,55,1279,357,193,93,1922
400270_Tsesarevich.txt,608,10,60,209,77,39,28,353
400285_ChristianityInIran.txt,1292,26,49,485,136,151,48,820
400330_StClementDanes.txt,737,18,40,292,98,27,21,438
4004116_SydKing.txt,876,19,46,319,119,39,22,499
4004722_2002UsOpenMensSingles.txt,404,8,50,252,5,7,1,265
4006643_Techniciannewspaper.txt,1058,13,81,559,73,40,9,681
400951_UssPhiladelphiac4.txt,715,11,65,317,83,23,7,430
400993_Mastitis.txt,830,24,34,320,129,73,43,565
401000_Sialkot.txt,3129,56,55,1293,369,191,60,1913
401003_TimelineOfNewYorkCityCrimesAndDisasters.txt,4844,8,605,1860,588,282,95,2825
40112_SalvadorDal.txt,4806,55,87,1861,573,315,151,2900
40113_IdesOfMarch.txt,2062,24,85,616,384,87,89,1176
4011424_AhmedAkkari.txt,587,12,48,200,94,43,13,350
40114_EscherichiaColi.txt,2328,37,62,888,322,232,88,1530
40121_VanityFair.txt,2570,34,75,873,385,181,112,1551
40135_LumenGentium.txt,1285,18,71,416,149,67,45,677
401373_BattleOfOriskany.txt,1468,30,48,626,171,70,29,896
4013776_Jagernaut.txt,668,15,44,281,79,63,26,449
40137_DeiVerbum.txt,1868,21,88,706,223,80,47,1056
401419_Moorgate.txt,1653,28,59,683,183,88,37,991
40142_Botulism.txt,2181,25,87,783,336,184,92,1395
401443_Stelleroidea.txt,691,13,53,227,97,86,43,453
401447_OutbackSteakhouse.txt,701,21,33,335,92,38,23,488
4014772_CompetencehumanResources.txt,792,12,66,237,134,74,43,488
40147_Divorce.txt,3777,63,59,1261,547,295,128,2231
40148_HaroldGodwinson.txt,2180,26,83,777,319,113,59,1268
40151_AlappuzhaDistrict.txt,825,21,39,325,102,69,24,520
40157_RussianOrthodoxChurch.txt,4141,57,72,1418,520,413,137,2488
40158_Berchtesgaden.txt,999,15,66,396,126,80,33,635
40166_BrocasArea.txt,782,15,52,283,117,74,32,506
4017191_CompaqPresarioM2000NotebookPcSeries.txt,1514,2,757,1508,1,1,0,1510
4017211_BillNelsen.txt,824,12,68,295,97,34,23,449
4017218_Shaykhism.txt,1409,21,67,469,191,114,41,815
4017773_RobinHood2006TvSeries.txt,1568,29,54,607,212,91,31,941
402084_EdmundCardinalSzoka.txt,637,10,63,277,56,28,10,371
402085_BelcourtCastle.txt,1510,23,65,586,180,117,27,910
402087_CenepaWar.txt,5332,50,106,1912,648,390,135,3085
402097_MarlonJackson.txt,823,12,68,296,109,57,30,492
4021144_Xethanol.txt,802,8,100,280,123,55,26,484
4021481_Arawa.txt,1267,13,97,482,180,52,49,763
4023910_CorruptionInKenya.txt,1486,21,70,600,220,76,36,932
4023927_MichaeljHorn.txt,811,17,47,247,143,56,45,491
4024871_TheMagicWorldOfThe12Family.txt,120,1,120,45,21,7,10,83
4024882_PaulRPillar.txt,1179,21,56,545,120,71,33,769
4025831_AllSaintsChurchEarlsBarton.txt,741,10,74,259,115,53,24,451
4029808_StefanoDimera.txt,1208,26,46,441,187,79,51,758
4031647_Kten.txt,817,14,58,392,80,60,22,554
4031650_NeithNevelson.txt,1969,29,67,649,282,173,100,1204
4031800_BillBuckleyradioPresenter.txt,1146,21,54,424,153,82,39,698
403250_NorthernPrayingMantismartialArt.txt,2169,32,67,1096,224,140,50,1510
4032612_UniversityOfTheWest.txt,861,31,27,418,77,51,18,564
4033580_TheMarchingMorons.txt,1116,28,39,389,162,71,37,659
4033599_HavocRecords.txt,683,8,85,404,34,7,6,451
403553_FatButtAndPancakeHead.txt,1302,19,68,492,208,66,46,812
403561_MgmGrandLasVegasHotelFire.txt,857,11,77,330,132,46,26,534
403585_CaptainMarveldcComics.txt,7278,87,83,3190,846,454,220,4710
4035946_ListOfCommandersOfGuantanamoBayNavalBase.txt,756,6,126,341,10,24,5,380
403630_ParableOfTheProdigalSon.txt,1209,20,60,398,167,75,48,688
403631_LisaGerrard.txt,1050,20,52,507,80,60,17,664
4036882_AliJavadi.txt,850,24,35,321,105,51,20,497
4037146_1999InNascarBuschSeries.txt,3188,166,19,2137,165,29,4,2335
4037545_Nerusstargate.txt,590,15,39,171,110,43,29,353
4039342_AeschinesSocraticus.txt,1400,18,77,474,188,90,68,820
4039448_UniversityOfPotsdam.txt,594,16,37,287,46,29,3,365
4039472_SoulFoodtvSeries.txt,816,14,58,348,100,57,29,534
4039530_JoyDenalane.txt,637,10,63,249,76,47,23,395
4039531_198788InEnglishFootball.txt,1482,34,43,624,177,108,35,944
4040297_MaryAinsworth.txt,1081,26,41,397,150,75,46,668
4040326_FuyumiOno.txt,531,7,75,260,27,7,6,300
4042252_Lomaland.txt,1318,22,59,574,157,73,27,831
4043646_20Yo.txt,2985,54,55,1227,363,172,72,1834
4043668_ListOfSubjectsInGraysAnatomyXTheOrgansOfTheSensesAndTheCommonIntegument.txt,2117,104,20,1368,127,252,3,1750
4043694_ListOfSubjectsInGraysAnatomyXiiSurfaceAnatomyAndSurfaceMarkings.txt,1136,109,10,700,54,220,3,977
4043701_ListOfSubjectsInGraysAnatomyXiSplanchnology.txt,4525,339,13,2694,194,684,28,3600
4044608_PhillipJackson.txt,838,9,93,338,99,41,15,493
4044631_SusannaLuchenko.txt,588,10,58,196,107,31,17,351
4046272_WarrenCentralHighSchoolkentucky.txt,693,10,69,337,64,55,9,465
404647_FideszHungarianCivicUnion.txt,736,22,33,280,75,67,19,441
404649_IntercruralSex.txt,664,11,60,237,101,71,17,426
404651_SelfdefenseOfTheRepublicOfPoland.txt,918,21,43,380,91,85,14,570
404665_AustinHealey.txt,1003,21,47,339,148,53,34,574
4047065_ChewValley.txt,3419,48,71,1421,397,267,107,2192
4048025_ToyotaAurion.txt,2159,37,58,981,253,163,39,1436
4048071_PierrealexandreMonsigny.txt,880,13,67,360,70,80,20,530
4049036_Espiye.txt,1411,18,78,574,174,80,44,872
4049968_JeulmunPotteryPeriod.txt,1085,12,90,489,99,90,24,702
4050570_ListOfNewspapersInRomania.txt,658,14,47,457,4,72,3,536
4050632_ListOfNewspapersInSpain.txt,686,5,137,255,4,81,2,342
40507_UnitedStatesPresidentialElection1816.txt,719,24,29,262,109,38,28,437
40508_UnitedStatesPresidentialElection1820.txt,914,30,30,321,136,63,34,554
4050950_JohnTCorley.txt,684,16,42,295,72,29,23,419
40509_UnitedStatesPresidentialElection1824.txt,932,23,40,375,102,78,28,583
40510_UnitedStatesPresidentialElection1828.txt,563,23,24,198,84,33,22,337
40511_UnitedStatesPresidentialElection1832.txt,1459,28,52,540,197,112,29,878
4052963_BridgesInKiev.txt,2563,69,37,957,351,183,68,1559
4053365_198586InEnglishFootball.txt,2057,43,47,831,230,158,62,1281
405370_RepublicPictures.txt,1561,20,78,760,154,88,40,1042
405374_Ali.txt,4195,69,60,1526,610,237,133,2506
405424_Caesartitle.txt,1359,19,71,535,142,137,47,861
405428_TheMagazineOfFantasyScienceFiction.txt,1776,26,68,875,163,106,42,1186
405429_MurrayCod.txt,4607,57,80,1827,524,520,188,3059
405430_Gynoid.txt,1456,20,72,585,193,103,58,939
405433_LozaPuertoRico.txt,1198,26,46,538,123,67,13,741
40556_UnitedStatesPresidentialElection1932.txt,693,18,38,299,75,43,16,433
40557_CampaignFinanceReform.txt,3346,48,69,1257,430,316,106,2109
40563_UnitedStatesPresidentialElection1952.txt,955,22,43,388,116,62,32,598
40568_UnitedStatesPresidentialElection1972.txt,1598,41,38,688,168,122,37,1015
40569_UnitedStatesPresidentialElection1976.txt,1473,37,39,639,155,98,43,935
40570_UnitedStatesPresidentialElection1980.txt,3322,71,46,1203,469,224,132,2028
405729_RobertStanfield.txt,1173,18,65,446,151,68,44,709
405742_WebFeatureService.txt,777,23,33,333,112,56,24,525
405744_ChrisWare.txt,1594,16,99,606,206,132,65,1009
405765_SiderealAstrology.txt,936,23,40,338,93,74,29,534
405770_EavanBoland.txt,593,15,39,335,37,19,7,398
4057744_StJohnsburyAcademy.txt,1721,29,59,833,203,109,38,1183
405803_ComplementaryColor.txt,571,12,47,154,83,92,24,353
405807_TheFallOfNight.txt,876,18,48,313,140,51,26,530
405813_GreyCollegeDurham.txt,1000,15,66,416,123,57,31,627
405816_ListOfSpiritualityrelatedTopics.txt,622,31,20,538,4,18,1,561
405820_RobertWyatt.txt,1239,23,53,571,122,64,27,784
405827_HerneTheHunter.txt,1076,14,76,432,140,62,37,671
4058308_TOMorrow.txt,1287,17,75,396,236,79,45,756
405839_Apocatastasis.txt,2936,32,91,964,396,171,98,1629
405841_Hula.txt,1520,37,41,582,225,131,50,988
405847_AksPrimalityTest.txt,924,19,48,286,121,103,37,547
4059286_ListOfEnergyBlades.txt,5462,13,420,2223,620,395,165,3403
4060073_ListOfAsteroids8270182800.txt,1309,1,1309,305,0,0,0,305
4060080_ListOfAsteroids8250182600.txt,1326,1,1326,325,0,0,0,325
4060082_ListOfAsteroids8240182500.txt,1345,1,1345,340,0,1,0,341
4060084_ListOfAsteroids8230182400.txt,1324,1,1324,324,0,0,0,324
40630_Beach.txt,1610,31,51,583,233,148,58,1022
40634_ConvexHull.txt,1544,40,38,580,180,123,61,944
4064546_ActonboxboroughRegionalHighSchool.txt,831,20,41,333,103,54,31,521
406514_Gameline.txt,731,10,73,346,99,40,22,507
4065456_BaltimoreLutheranSchool.txt,674,16,42,362,70,39,8,479
4066012_MusicInDenver.txt,1515,17,89,671,152,142,56,1021
4067801_Russiancomics.txt,949,10,94,280,159,76,32,547
4068747_GrassrootsAlliance.txt,753,13,57,308,102,33,18,461
406877_HenryWinkler.txt,1384,22,62,533,185,67,43,828
4068806_HelmutSchelp.txt,942,7,134,287,145,89,42,563
406885_FermiProblem.txt,703,16,43,230,101,55,26,412
406892_ParramattaRiver.txt,1678,30,55,734,220,119,65,1138
406902_GeometrizedUnitSystem.txt,715,15,47,253,87,86,28,454
406905_EvolutionTo3g.txt,1430,26,55,529,236,91,60,916
4072175_FuChong.txt,571,6,95,252,69,23,11,355
4073155_GoldenAgeOfTheCinemaOfMexico.txt,1204,20,60,519,144,62,21,746
407550_MichaelHarrington.txt,593,11,53,266,57,41,17,381
407623_MarkBelanger.txt,658,9,73,222,69,41,17,349
4076497_Inflight.txt,1210,19,63,610,96,65,16,787
407936_InternationalizedDomainName.txt,2736,40,68,1112,356,172,85,1725
407940_PoliticalMachine.txt,1332,14,95,668,118,80,34,900
407971_BoshinWar.txt,3931,48,81,1392,510,364,106,2372
407980_Aizu.txt,964,27,35,428,89,75,17,609
407994_LibertyMeadows.txt,711,15,47,324,73,53,14,464
408006_LossLeader.txt,1096,15,73,363,171,98,72,704
408026_RelativisticDopplerEffect.txt,571,35,16,187,76,44,15,322
4081389_LutherBible.txt,783,11,71,320,83,49,14,466
4081538_MightyMikeMcgee.txt,691,15,46,310,68,43,17,438
4082507_ProofThatBooleanSatisfiabilityProblemIsNpcomplete.txt,747,17,43,221,101,68,29,419
4083324_TheCompleteEllaFitzgeraldLouisArmstrongOnVerve.txt,527,6,87,330,20,1,10,361
4085872_Waaytv.txt,814,21,38,361,83,44,24,512
408640_GeorgeMillerpolitician.txt,686,9,76,302,89,32,8,431
408660_TomLantos.txt,1198,23,52,515,133,94,32,774
408724_VirginMegastore.txt,3108,45,69,1485,329,184,90,2088
408725_CroatianPeoplesPartyLiberalDemocrats.txt,563,18,31,235,53,28,14,330
4090082_EverquestDeities.txt,3595,58,61,1255,514,202,144,2115
409026_ErastFandorin.txt,3151,56,56,1120,462,220,98,1900
409027_Pongal.txt,601,15,40,235,90,36,14,375
409037_GraceNapolitano.txt,1138,16,71,436,149,93,23,701
409057_taples.txt,1477,33,44,530,160,74,30,794
409105_VeganOrganicGardening.txt,957,16,59,393,125,96,27,641
409106_TalbotHobbs.txt,963,10,96,308,127,72,21,528
4091676_FijianPresidentialElection2006.txt,1566,25,62,550,259,77,51,937
4092672_JohannAndreasEisenmenger.txt,850,10,85,327,117,56,21,521
4092674_PopColaPanthers.txt,555,12,46,264,60,25,5,354
4093049_SergeyMartinson.txt,476,10,47,144,40,21,2,207
4093637_SonetosDeLaMuerte.txt,608,24,25,345,58,29,8,440
4094579_TheLastTemptationOfChristy.txt,689,10,68,262,96,40,29,427
4095008_AWitchsTailpart2.txt,587,10,58,265,75,29,11,380
4095357_NanjingUniversityOfTechnology.txt,845,7,120,359,76,82,16,533
4095580_Auroraship.txt,710,13,54,264,107,29,12,412
4095979_AyumuKasuga.txt,747,9,83,235,108,64,46,453
4095980_KevinCovais.txt,928,25,37,400,119,41,21,581
4096004_SriLankaTamilsnative.txt,5753,131,43,2011,730,464,242,3447
4096014_LisaTuckersinger.txt,938,16,58,342,129,62,28,561
4096828_ThePeopleThatTimeForgotnovel.txt,797,11,72,299,105,55,24,483
4096972_MorrisEight.txt,587,13,45,236,86,35,16,373
4096976_NostradamusInPopularCulture.txt,2924,63,46,1124,404,173,105,1806
4097001_TheSolitaireMystery.txt,1472,27,54,456,218,101,70,845
409729_DuncanHunter.txt,1947,34,57,734,280,116,66,1196
409739_Taxiband.txt,653,19,34,312,72,46,17,447
4097859_CapitolTheatreportHope.txt,669,10,66,237,94,53,23,407
4097959_PrivilegecanonLaw.txt,933,7,133,321,114,67,50,552
409801_ListOfFilmsNumbers.txt,1271,21,60,503,3,32,1,539
4098911_Sonderaktion1005.txt,657,10,65,245,108,31,23,407
4098932_OvieMughelli.txt,635,12,52,274,59,45,3,381
4101154_RuthFisher.txt,587,8,73,192,106,25,16,339
410119_DianaDegette.txt,569,11,51,221,75,41,12,349
410123_PederSeverinKryer.txt,791,22,35,293,106,51,26,476
4101330_EmailSurveillance.txt,625,8,78,233,99,24,26,382
410156_IanMccartney.txt,567,10,56,229,62,27,12,330
410169_RobSimmons.txt,793,13,61,334,89,57,17,497
410203_AmyBeach.txt,844,17,49,393,80,61,12,546
4103247_ListOfShipsOfRussiaByProjectNumber.txt,1454,3,484,1048,60,103,1,1212
4103719_2006SouthernLeyteMudslide.txt,1456,29,50,595,203,93,34,925
4103750_RegHickey.txt,673,11,61,230,73,49,23,375
4104668_MaghainAbothSynagogue.txt,1177,31,37,414,191,55,40,700
4105688_Menemen.txt,1149,24,47,410,132,96,29,667
410828_MarianoGuadalupeVallejo.txt,1791,20,89,662,270,98,35,1065
410892_JimMcgreevey.txt,1849,24,77,731,232,93,61,1117
4109042_CellSignaling.txt,1359,19,71,538,205,81,38,862
4109048_ListOfTelevisionDuopoliesInTheUnitedStates.txt,1251,63,19,782,5,27,5,819
4109439_YouDontLoveMeAnymore.txt,574,11,52,191,74,35,29,329
410977_BattleOfNaupactus429Bc.txt,1164,12,97,361,205,55,32,653
4110975_MuhammadAbuTir.txt,1146,12,95,424,174,68,44,710
4111991_DongHaichuan.txt,1177,14,84,411,166,84,61,722
411205_IcelandicName.txt,941,17,55,282,135,121,58,596
411219_MalaysianChineseAssociation.txt,900,16,56,401,71,76,24,572
411238_IleanaRoslehtinen.txt,648,10,64,261,104,42,14,421
411292_TiaCarrere.txt,862,19,45,370,83,37,27,517
411295_Nahal.txt,1356,14,96,469,165,149,65,848
411296_Ofcom.txt,1113,21,53,403,181,66,46,696
4116180_OregonMission.txt,1449,16,90,616,183,82,35,916
4116818_ZedekiahBenAbrahamAnaw.txt,581,7,83,226,66,40,21,353
411936_Thirtyonegame.txt,1217,14,86,340,168,59,40,607
4119530_ListOfStarWarsSeparatistCharacters.txt,3290,67,49,1293,501,162,111,2067
4119667_DaveMeros.txt,805,16,50,336,90,52,28,506
4119715_GlossaryOfEducationrelatedTermsdf.txt,2100,43,48,767,281,192,82,1322
411990_AbelianAndTauberianTheorems.txt,611,14,43,205,73,48,31,357
412053_SteveCram.txt,640,9,71,216,71,33,22,342
412054_SebastianCoe.txt,1653,28,59,605,207,86,46,944
412064_Magatama.txt,1072,12,89,383,158,74,34,649
412065_SteveOvett.txt,576,15,38,168,75,39,15,297
4121145_GlossaryOfEducationrelatedTermstz.txt,1464,37,39,573,211,115,55,954
41226_HammingCode.txt,2166,48,45,690,345,151,92,1278
41227_HammingDistance.txt,505,15,33,199,53,37,14,303
4123053_MyDocuments.txt,725,13,55,270,107,48,21,446
412326_DemocraticPeaceTheory.txt,9536,132,72,3010,1328,1076,490,5904
412344_GrammyAwardForBestInstrumentalSoloistsPerformancewithOrchestra.txt,1319,11,119,794,37,21,1,853
412345_GrammyAwardForBestInstrumentalSoloistPerformancewithoutOrchestra.txt,845,11,76,444,29,19,1,493
412349_DoctorFate.txt,4473,80,55,1601,654,262,137,2654
412386_GrammyAwardForBestClassicalAlbum.txt,1307,8,163,853,17,18,0,888
41244_Hybrid.txt,2197,33,66,790,288,248,87,1413
4124519_August192005.txt,588,1,588,258,76,31,7,372
4125505_OwnerOfALonelyHeart.txt,704,11,64,267,79,75,32,453
4126436_SasanianFamilyTree.txt,94,2,47,32,2,0,0,34
4127420_BritishAcademyTelevisionAwards2000.txt,809,3,269,592,7,14,0,613
4130747_11thSignalBrigade.txt,575,14,41,281,53,49,5,388
413087_Meggan.txt,1088,15,72,324,184,88,49,645
413088_Iver.txt,763,17,44,290,107,39,24,460
413090_EdAmes.txt,859,12,71,318,112,52,33,515
413091_ListOfNationalParksOfThePeoplesRepublicOfChina.txt,1023,11,93,921,9,8,3,941
413094_MilesFranklin.txt,646,10,64,259,65,37,19,380
4131726_CharlesPeterMccolough.txt,990,14,70,433,100,69,24,626
4133205_PhilFarrand.txt,1052,9,116,407,148,60,22,637
4133551_RobertWHeagney.txt,659,12,54,274,81,36,13,404
413390_AssignmentEarth.txt,1411,26,54,489,198,71,62,820
4134000_OuranHighSchoolHostClub.txt,3524,44,80,1254,531,232,116,2133
413401_PatrickMillersoldier.txt,790,17,46,303,124,36,14,477
413402_GranTurismoseries.txt,3118,58,53,1203,401,216,117,1937
413433_Mooncake.txt,1907,28,68,635,306,224,85,1250
413435_Narragansetttribe.txt,1216,18,67,490,167,63,40,760
413445_UgandaBefore1900.txt,2752,23,119,948,397,247,86,1678
413447_RussianMafia.txt,2269,31,73,910,276,225,65,1476
413472_Idli.txt,810,13,62,316,122,73,35,546
413490_DaltonCamp.txt,753,12,62,278,96,54,26,454
4136530_TwitchOfTheDeathNerve.txt,2198,26,84,789,336,155,100,1380
4136570_SidneyLowe.txt,550,6,91,232,49,24,7,312
4138470_M8ags.txt,929,14,66,365,129,61,32,587
4139347_PGWodehouseMinorCharacters.txt,5552,139,39,1992,666,418,209,3285
4139470_RichardGreenWaterhouse.txt,560,13,43,213,81,23,19,336
4140245_Operationmathematics.txt,579,15,38,208,84,51,18,361
414126_Blah.txt,681,15,45,196,125,57,36,414
414178_RenalCellCarcinoma.txt,1628,32,50,548,230,214,70,1062
414180_SomethingsGottaGivefilm.txt,1026,13,78,362,151,62,51,626
414182_AmateurRadioEmergencyService.txt,715,19,37,350,73,49,18,490
4141835_ListOfStatutoryInstrumentsOfTheUnitedKingdom2005.txt,2176,46,47,1481,14,33,0,1528
4141838_VectorMap.txt,974,23,42,467,124,64,19,674
4141839_GiuseppeSerembe.txt,742,6,123,266,82,62,22,432
4141840_NewYorks19thCongressionalDistrict.txt,524,12,43,228,49,31,12,320
4141841_ListOfStatutoryInstrumentsOfTheUnitedKingdom2006.txt,20863,75,278,14602,67,195,0,14864
414192_OvarianCancer.txt,2660,36,73,1093,310,330,76,1809
4143245_ListenLearnReadOn.txt,706,8,88,450,17,35,9,511
4144211_Hermannbsegymnasium.txt,578,17,34,192,75,42,21,330
4144616_MontenegrinIndependenceReferendum2006.txt,2265,41,55,815,304,151,57,1327
4144674_AurasHouse.txt,1174,18,65,486,166,61,31,744
414493_RichardBakerpolitician.txt,842,9,93,332,112,46,30,520
414503_ChrisJohn.txt,609,15,40,250,84,36,7,377
414513_OlivierPanis.txt,682,14,48,197,95,55,23,370
4145198_CampusSuperstar.txt,552,15,36,281,46,25,4,356
414538_AlbertWynn.txt,877,17,51,376,70,62,15,523
414541_MaximBehar.txt,588,14,42,238,56,42,17,353
414545_DaveDudley.txt,725,12,60,225,98,53,46,422
4145574_PlotSummaryOfEurekaSevenanime.txt,10495,86,122,3361,1754,512,494,6121
4145642_GloryOfHeracles.txt,613,11,55,226,68,51,21,366
414564_RoscoeBartlett.txt,1004,19,52,413,87,59,25,584
414565_NickAdams.txt,3559,30,118,1465,468,161,102,2196
414579_ChrisVanHollen.txt,1469,30,48,580,136,105,39,860
414585_ErichVonDemBach.txt,1560,29,53,601,177,96,54,928
414590_YahooWidgetEngine.txt,2147,29,74,828,313,116,72,1329
4146143_MichaelSGardiner.txt,595,11,54,214,82,39,27,362
4147049_OrlandoWard.txt,580,9,64,234,69,38,16,357
4147129_AssociatedMennoniteBiblicalSeminary.txt,872,21,41,365,112,66,13,556
4148015_JeffMonson.txt,848,11,77,362,38,29,7,436
4148025_RadarAbsorbentMaterial.txt,827,20,41,311,121,63,19,514
4148982_ErastGarin.txt,330,11,30,118,30,12,5,165
4149041_RadioRepeater.txt,2422,48,50,874,342,221,57,1494
4150521_StricklandVSony.txt,1380,20,69,483,232,48,48,811
4150557_VictimsFamily.txt,595,8,74,254,72,34,15,375
415217_InstituteOfEconomicAffairs.txt,1356,30,45,761,133,66,24,984
415225_InstituteForFiscalStudies.txt,971,64,15,428,130,57,19,634
415276_ListOfDiscoArtists.txt,11295,28,403,7044,230,142,168,7584
4153354_Sodastream.txt,789,19,41,284,116,63,21,484
4153870_ScryHard.txt,622,11,56,274,83,32,16,405
4153913_ListOfUsafStrategicWingsAssignedToTheStrategicAirCommand.txt,2990,118,25,1462,133,238,34,1867
415601_DivineProvidence.txt,2313,33,70,863,274,163,93,1393
415632_MartinMcguinness.txt,1037,16,64,425,139,40,14,618
415675_PeterRobinsonpolitician.txt,668,12,55,230,69,52,28,379
415677_HeinkelHe176.txt,562,15,37,233,75,41,21,370
415679_MartinSmyth.txt,574,9,63,227,73,24,15,339
415685_MarkOaten.txt,1071,20,53,383,158,49,31,621
4157295_ArtRupe.txt,580,7,82,228,75,33,20,356
4158231_BishopCottonSchool.txt,2706,278,9,1833,118,47,12,2010
4159146_Threatfilm.txt,1109,14,79,565,105,59,23,752
4160051_TamilChronometry.txt,804,24,33,330,21,43,4,398
4162589_ListOfStatutoryInstrumentsOfTheUnitedKingdom1983.txt,726,40,18,473,3,17,0,493
416307_Muskmelon.txt,631,22,28,293,81,54,28,456
416314_IyasuVOfEthiopia.txt,1712,14,122,605,258,96,75,1034
4163542_BiancaJackson.txt,988,15,65,393,149,51,53,646
416378_HarrietLane.txt,571,10,57,213,71,45,16,345
4164034_FrankChanfrau.txt,1519,20,75,591,192,70,49,902
4166009_JamesWSymington.txt,580,20,29,266,57,21,10,354
416768_BentleyArnage.txt,1141,25,45,408,161,92,26,687
416770_NigelDodds.txt,737,15,49,299,95,43,24,461
4169336_CourtHousesOfWinstonCountyAl.txt,708,6,118,259,99,38,11,407
4170319_OswaldSkippings.txt,1833,24,76,563,271,117,68,1019
4170327_SwallowsAndAmazons.txt,694,11,63,319,76,24,18,437
41721_SlaveClock.txt,946,20,47,329,127,76,32,564
417453_ChicagoSchoolsociology.txt,2727,16,170,1162,257,213,53,1685
4174658_Halmir.txt,278,7,39,95,41,8,8,152
417788_Cogship.txt,818,14,58,279,115,76,43,513
4178003_AnnadelStatePark.txt,1033,16,64,423,132,81,30,666
4178009_Zooomr.txt,661,21,31,285,85,48,18,436
4178047_AustraliaNationalBasketballTeam.txt,1476,47,31,875,91,59,25,1050
417815_RelativisticRocket.txt,1307,36,36,452,183,101,46,782
417819_Cimbalom.txt,705,18,39,280,84,77,26,467
417829_ListOfAllwomenBands.txt,2909,27,107,2690,24,33,8,2755
417835_ElishaGray.txt,1655,34,48,695,230,82,23,1030
417858_BenedictArnold.txt,3879,61,63,1403,558,209,110,2280
417860_LittleGirlLost.txt,816,18,45,227,136,43,41,447
4178886_Technet.txt,1811,31,58,589,311,124,59,1083
4179006_NuneatonRfc.txt,614,7,87,333,52,31,20,436
4179018_Reborn.txt,1749,11,159,643,248,117,68,1076
4179020_RobbinsdaleCooperHighSchool.txt,904,10,90,438,95,49,18,600
4181407_MaidenheadCitadelBand.txt,539,16,33,294,29,19,7,349
4181780_DownbelowStation.txt,1513,28,54,611,215,91,56,973
4182810_Lunac.txt,3792,34,111,1298,584,284,144,2310
4184301_TheFamilyOfHumfreyOfXanth.txt,2606,32,81,1051,335,117,71,1574
418482_TwentiethAnniversaryMacintosh.txt,589,12,49,194,88,44,23,349
418488_HoustonNutt.txt,2096,34,61,843,265,109,57,1274
418558_BlackNmenreans.txt,1424,33,43,430,163,116,63,772
418621_PopularDemocraticPartyOfPuertoRico.txt,1354,23,58,545,152,95,48,840
4186688_AlphaRhoLambda.txt,1388,19,73,561,169,99,28,857
4187678_CarolynStewartolsen.txt,631,10,63,261,65,51,17,394
4187687_HierarchyOfCalormen.txt,539,3,179,175,84,47,26,332
418889_ListOfPeopleFromNewJersey.txt,1854,8,231,1380,103,37,10,1530
418902_BattleOfSvolder.txt,4141,60,69,1604,547,254,110,2515
4189147_PresbyterianLadiesCollegeMelbourne.txt,1238,28,44,558,153,76,17,804
418918_RubenStuddard.txt,1137,17,66,432,130,70,32,664
418923_Gnutella2.txt,1153,25,46,422,184,69,63,738
418925_RodBlagojevich.txt,2920,51,57,1181,404,168,63,1816
418930_CurrencyBoard.txt,756,12,63,285,87,63,33,468
418947_GavinNewsom.txt,1208,18,67,526,139,71,20,756
4189498_StephensonScholarshipHall.txt,837,13,64,379,83,53,17,532
418950_AdamPetty.txt,591,9,65,238,64,32,17,351
4192852_October62003.txt,648,2,324,262,94,40,13,409
4192853_GreenWithEvil.txt,1894,21,90,715,268,89,78,1150
4194835_QuisCustodietIpsosCustodes.txt,978,13,75,359,138,49,23,569
419575_CingulateCortex.txt,632,10,63,208,91,53,26,378
4196263_CeliaDropkin.txt,938,12,78,343,109,90,31,573
419644_AlternativeEducation.txt,1774,39,45,707,196,228,73,1204
419720_ContinentalNavy.txt,1854,35,52,669,275,110,69,1123
4197840_OconorDon.txt,778,12,64,368,36,30,6,440
4198802_BlockSettlement.txt,539,13,41,292,55,48,13,408
419962_Nue.txt,595,6,99,228,71,30,19,348
4199662_TheLifeAndCrimesOfAliceCooper.txt,835,5,167,391,9,14,8,422
4199757_KensingtonVipers.txt,638,16,39,291,59,28,14,392
419980_Nesm.txt,1291,31,41,450,171,106,45,772
420010_Chaotix.txt,3515,57,61,1217,526,197,154,2094
4200732_LiaisonstngEpisode.txt,702,11,63,218,136,30,37,421
4201192_Wnfm.txt,909,18,50,393,114,66,10,583
4202182_FossilRidgeHighSchool.txt,1095,36,30,578,88,67,27,760
4204871_BohumilMller.txt,1163,9,129,408,177,77,34,696
4205955_Shocknovel.txt,664,13,51,246,97,36,23,402
4205968_SouthernLebanon.txt,475,9,52,326,19,16,4,365
420806_ErnieFletcher.txt,3002,39,76,1176,436,156,84,1852
420811_JimmieDavis.txt,1877,36,52,737,221,153,48,1159
4209781_MultilevelGovernance.txt,775,9,86,260,79,120,20,479
4209796_ShadowDancer.txt,619,11,56,230,86,33,26,375
421049_SpiritRover.txt,3105,51,60,1174,445,181,111,1911
421051_OpportunityRover.txt,2773,58,47,1043,409,186,81,1719
421053_TheKumarsAtNo42.txt,583,12,48,220,86,35,18,359
421082_ArchibaldSinclair1stViscountThurso.txt,851,9,94,341,94,41,28,504
421085_ParaconsistentLogic.txt,1900,47,40,635,275,201,109,1220
4210890_MorganReport.txt,2646,46,57,962,330,153,73,1518
421100_NewZealandDemocraticParty.txt,803,15,53,295,110,69,32,506
421106_TheHorseAndHisBoy.txt,787,14,56,277,115,53,23,468
421108_ShoulderlaunchedMissileWeapon.txt,712,16,44,240,102,87,35,464
421109_EvelynKeyes.txt,603,8,75,317,33,16,8,374
421110_InternationalMarxistTendency.txt,594,9,66,355,42,24,12,433
421135_GiambattistaDellaPorta.txt,925,20,46,383,119,66,22,590
4211954_ListOfNightclubs.txt,3922,54,72,2379,214,297,79,2969
4211963_VaughanMunicipalElection2006.txt,803,19,42,380,77,51,13,521
4212519_ItalianConfederationOfWorkersTradeUnions.txt,646,11,58,225,77,65,11,378
4214705_ValeriKamensky.txt,302,5,60,168,7,5,1,181
4214712_SphingidaeSpeciesList.txt,1142,20,57,1019,87,12,1,1119
4214728_JamesRRussell.txt,1292,15,86,716,57,59,10,842
4215812_ApostolicVicariateOfBruneiDarussalam.txt,665,19,35,260,79,55,25,419
4215833_CheesecheesyMusic.txt,657,16,41,226,86,83,31,426
4216375_OakGroveLutheranSchool.txt,672,22,30,325,89,52,12,478
4217293_BloodbathAtTheHouseOfDeath.txt,628,20,31,223,98,37,17,375
4217297_ElectricalSensitivity.txt,2035,21,96,847,221,220,67,1355
4217935_NautilusInc.txt,664,15,44,270,87,47,15,419
421825_VisaWaiverProgram.txt,1385,30,46,529,188,95,48,860
421829_EducationInCzechoslovakia.txt,1268,16,79,435,151,118,39,743
4218550_JohnWymer.txt,589,11,53,213,62,39,13,327
4218567_WildChicago.txt,619,5,123,273,67,49,12,401
4218571_OhlStandings.txt,5159,55,93,1649,50,8,2,1709
4218573_DillonHalluniversityOfNotreDame.txt,957,18,53,400,123,65,27,615
4218578_OhaStandings.txt,4086,68,60,1561,33,5,4,1603
4218959_SacramentalUnion.txt,656,7,93,244,67,40,25,376
421911_IndustryOfCommunistCzechoslovakia.txt,722,10,72,251,93,87,21,452
4220231_EvolutionaryMusicology.txt,1090,15,72,368,137,148,35,688
4220236_BorisStenin.txt,782,11,71,298,96,60,22,476
4220721_ListOfEspnPersonalities.txt,1744,7,249,1378,14,8,3,1403
4221193_LinderSterling.txt,1711,17,100,665,195,131,43,1034
4221322_Iraklis.txt,2038,28,72,650,291,148,94,1183
422137_JoeMantegna.txt,595,12,49,293,49,27,16,385
422144_CeterisParibus.txt,2073,23,90,585,331,160,123,1199
422154_RedOchre.txt,754,12,62,280,138,58,26,502
422186_StrengthLevelcomics.txt,790,14,56,235,121,93,55,504
422194_HoiPolloi.txt,2514,49,51,808,405,162,104,1479
422199_GuaSha.txt,1193,28,42,432,162,113,74,781
422211_TugMcgraw.txt,717,13,55,237,92,53,14,396
422214_CommunistPartyOfCzechoslovakia.txt,3988,37,107,1423,460,333,134,2350
422230_BattleOfSariBair.txt,2123,29,73,732,310,157,61,1260
422247_Selfawareness.txt,2514,26,96,730,337,272,124,1463
422258_EmperorAiOfJin.txt,699,9,77,274,92,30,24,420
4222792_TheMiamiValleySchool.txt,987,15,65,431,101,90,28,650
4222797_BobRebadow.txt,750,10,75,281,122,40,23,466
4222856_1944InBaseball.txt,492,14,35,296,16,22,3,337
4224065_BennieSmith.txt,702,16,43,365,52,25,11,453
4226195_OperationMeteor.txt,752,7,107,280,105,44,18,447
4226207_FredZollner.txt,690,11,62,270,94,23,23,410
4226234_RuthlessRecordslosAngeles.txt,702,25,28,436,50,39,10,535
42279_BassDrum.txt,3320,37,89,1031,446,361,207,2045
42280_CrashCymbal.txt,717,7,102,220,108,78,42,448
42282_DignitatisHumanae.txt,2596,28,92,869,367,221,88,1545
4228360_Mountaingem.txt,707,13,54,240,96,82,43,461
4228371_VerticalWindTunnel.txt,984,12,82,384,119,106,38,647
42283_NostraAetate.txt,6664,96,69,2299,760,374,268,3701
4228970_IpodHifi.txt,987,17,58,374,115,83,37,609
4230026_GaaAllStarsAwardsPastWinnershurling.txt,2146,45,47,1965,20,15,2,2002
4230041_QuietismchristianPhilosophy.txt,722,12,60,278,73,46,26,423
42307_AugustoBoal.txt,2570,34,75,784,408,185,111,1488
42313_TheWickerMan.txt,2867,39,73,1125,388,201,86,1800
42314_Naturalization.txt,2775,50,55,916,400,210,105,1631
4232191_HariMataHari.txt,1824,27,67,860,160,132,30,1182
42324_WholeLanguage.txt,1544,32,48,587,229,150,73,1039
42325_Phonics.txt,2553,34,75,937,384,206,109,1636
42327_SexEducation.txt,3159,44,71,1181,420,316,108,2025
42328_Diversity.txt,1767,36,49,652,251,170,89,1162
423331_Idef.txt,766,14,54,353,98,41,18,510
423339_Sanrio.txt,758,14,54,398,69,37,18,522
423351_WegmansFoodMarkets.txt,575,11,52,251,53,42,9,355
423353_BritishAvifauna.txt,843,31,27,334,99,83,36,552
4233891_DeerfieldAcademy.txt,1097,24,45,655,56,37,10,758
4233893_CaptainFlamingo.txt,629,13,48,286,76,47,15,424
4233900_MelchorMzquiz.txt,571,10,57,216,64,28,14,322
4236545_AmritSanskar.txt,1514,24,63,533,236,68,34,871
4236643_StLukesChurchGoostrey.txt,1583,19,83,496,233,105,43,877
4238825_MassiveArmorUnit.txt,918,29,31,398,122,52,28,600
4238829_TheatresDesVampires.txt,622,20,31,269,68,46,9,392
4239861_AaaConcordeDistrict.txt,663,17,39,300,62,30,24,416
4239888_AtomicKnight.txt,842,13,64,308,122,62,21,513
424015_Asbestosis.txt,736,12,61,298,96,81,24,499
4240313_PolishNationalRailroadsSummer1939.txt,1817,40,45,745,193,130,59,1127
4240946_Sorginak.txt,2811,28,100,962,446,209,122,1739
4243698_TonyAwardForBestPerformanceByAFeaturedActorInAPlay.txt,1266,17,74,1074,3,7,0,1084
424381_ServerSideIncludes.txt,597,17,35,209,93,49,25,376
424398_KarlKorsch.txt,1016,20,50,402,96,82,20,600
4244145_TiaAndMegumiOumi.txt,678,20,33,263,89,40,28,420
424421_160thSpecialOperationsAviationRegimentairborne.txt,842,24,35,378,95,74,16,563
424440_Htheorem.txt,808,32,25,236,94,100,51,481
4245377_Kherubim.txt,1375,19,72,446,234,118,58,856
4248608_TheLandBeforeTimeXTheGreatLongneckMigration.txt,860,10,86,339,124,47,38,548
4248652_Savandurga.txt,1070,10,107,697,66,19,10,792
425061_StFrancisDam.txt,2661,31,85,1075,334,154,72,1635
425104_Salsasauce.txt,789,17,46,321,120,72,43,556
425106_JointUniversityProgrammesAdmissionsSystem.txt,575,14,41,237,55,49,17,358
4251353_ReligionInNorthKorea.txt,1442,21,68,509,195,124,51,879
4251881_SaltglazedStoneware.txt,603,16,37,284,56,47,14,401
4253551_ReligionInVietnam.txt,872,15,58,348,118,62,35,563
4254057_Kluvfm.txt,568,25,22,225,68,31,19,343
4254144_Rembrandt.txt,3008,48,62,1242,331,191,116,1880
425483_MattKenseth.txt,1280,20,64,499,166,82,28,775
425492_BritishMovement.txt,652,9,72,205,91,62,34,392
4255209_ListOfStatutoryInstrumentsOfScotland2000.txt,3509,12,292,2574,3,18,0,2595
4255224_1994InNascar.txt,2091,141,14,1451,131,14,3,1599
425528_DanielGoldhagen.txt,1618,19,85,665,179,125,56,1025
425530_StrangersWithCandy.txt,972,21,46,426,126,55,23,630
425533_Tsukihime.txt,1745,23,75,556,273,118,70,1017
4255716_AsSchoolsMatchWits.txt,994,20,49,394,112,73,25,604
4255718_Organosilicon.txt,628,24,26,260,71,61,17,409
4256812_FiveDeez.txt,983,20,49,376,132,78,37,623
4259047_BarryParis.txt,598,11,54,273,58,40,15,386
4260131_OriginAndDevelopmentOfTheQuran.txt,4549,57,79,1422,732,332,149,2635
4260133_CyrusOfAlexandria.txt,670,10,67,218,89,28,24,359
4260140_MaxGreen.txt,726,17,42,243,117,37,28,425
4260148_JuanCarlosLorenzo.txt,640,11,58,307,54,47,10,418
4260163_Tauolunga.txt,826,7,118,245,118,66,61,490
4261211_NationalHeadsupPokerChampionship.txt,1145,45,25,748,184,19,5,956
4261231_CbcMonkstown.txt,660,20,33,283,72,65,19,439
4261664_RenatoArago.txt,1055,9,117,507,74,39,13,633
426202_MichiganLegislature.txt,908,11,82,326,114,56,18,514
426204_CraigBenson.txt,692,11,62,289,82,46,14,431
426205_StormChasing.txt,1104,16,69,399,162,107,53,721
426266_RhodeIslandGeneralAssembly.txt,676,11,61,268,77,58,20,423
4262747_AmphoeUmphang.txt,938,17,55,392,122,50,35,599
4262862_UniversityOfAdvancingTechnology.txt,707,27,26,341,73,46,14,474
4262875_RangpurcityBangladesh.txt,600,13,46,227,80,52,17,376
4264362_Exfork.txt,650,11,59,219,91,49,44,403
426530_ClarenvilleNewfoundlandAndLabrador.txt,1184,23,51,471,138,86,22,717
426565_ListOfUnitedStatesNavyDestroyers.txt,5320,49,108,2812,98,46,13,2969
426566_Galle.txt,729,20,36,328,75,44,12,459
4265703_ListOfFictionalPlanetsByMedium.txt,4570,88,51,2708,293,257,92,3350
4266595_JohannGottfriedMthel.txt,705,22,32,250,86,56,18,410
4267860_KudaraNoKonikishi.txt,710,9,78,291,77,34,10,412
4269288_KyleFoggo.txt,924,17,54,401,120,49,14,584
4270598_HandgunEffectiveness.txt,875,16,54,267,136,89,57,549
4271687_OccupationOfLatviaByNaziGermany.txt,1283,19,67,521,150,73,50,794
4271695_ScoutsCanadaScoutBadges.txt,942,17,55,433,80,99,7,619
4271700_SpeckyMagee.txt,1502,128,11,779,138,79,48,1044
427247_Ezboard.txt,1282,26,49,419,235,107,48,809
427248_Tv3catalonia.txt,870,15,58,389,68,74,27,558
42737_DutchEastIndiaCompany.txt,1633,28,58,626,196,130,57,1009
42739_BubbleFusion.txt,2039,32,63,806,292,157,65,1320
4275496_ListOfRadioStationsInCaliforniaByCallLetters.txt,1691,61,27,1055,24,62,11,1152
4275531_CrazyManCrazy.txt,687,9,76,262,84,52,16,414
4275935_SleepingBeautyProblem.txt,701,13,53,237,108,21,31,397
427626_MikhailBaryshnikov.txt,1191,13,91,451,142,83,32,708
427627_MiddlePower.txt,950,12,79,388,113,84,54,639
427655_BoletusEdulis.txt,788,17,46,270,126,88,41,525
4277176_ListOfCharactersInCampLazlo.txt,5167,69,74,1822,846,304,263,3235
4278039_DavidMccomb.txt,781,19,41,384,75,37,23,519
4278092_MyLives.txt,571,7,81,423,10,7,3,443
4278094_LiuNannan.txt,616,9,68,204,69,48,26,347
4278305_DeepThroats.txt,1603,9,178,623,232,68,59,982
4279761_BrucePearl.txt,1196,13,92,443,169,72,37,721
42801_Nutella.txt,1046,16,65,394,156,98,47,695
42802_SophieBHawkins.txt,624,20,31,279,52,30,17,378
42806_Cyclone.txt,1005,26,38,361,120,118,31,630
4281017_AndrewLost.txt,1393,15,92,535,188,54,67,844
4283029_DutyOfCareInEnglishLaw.txt,3514,5,702,1114,505,224,121,1964
4283186_ShoSakurai.txt,977,8,122,364,139,56,38,597
428330_InlineFunction.txt,956,16,59,324,145,82,55,606
428412_Valgrind.txt,787,15,52,286,115,79,37,517
4285358_TorahUmesorahNationalSocietyForHebrewDaySchools.txt,1955,25,78,747,250,165,71,1233
428710_PublicAccessTelevision.txt,3694,55,67,1818,366,307,89,2580
428755_BritanniaBeachBritishColumbia.txt,1321,24,55,467,204,100,40,811
428770_RooseveltIslandTramway.txt,1121,25,44,441,140,55,38,674
4288130_KotDijiFort.txt,1014,14,72,307,159,75,50,591
4289162_DeadlockIiShrineWars.txt,1038,17,61,341,157,106,40,644
4289170_SaintPaulsCatholicChurchworthington.txt,602,7,86,212,97,35,12,356
4290642_MakeoverMakeoverMakeoverTheMakeoverEpisode.txt,1275,28,45,497,217,63,59,836
4290832_LookToTheLady.txt,943,15,62,377,125,69,13,584
4290872_CharlesVonHgel.txt,874,13,67,346,94,57,24,521
4291951_FernandoColunga.txt,589,14,42,215,63,46,25,349
4291958_ParamedicsInTheUnitedStates.txt,2504,28,89,997,299,294,93,1683
4293014_2001NcaaDivisionIaFootballSeason.txt,969,17,57,535,76,35,19,665
429487_OldHighGerman.txt,1676,25,67,649,188,162,63,1062
429490_GoldenHorseFilmFestivalAndAwards.txt,10097,49,206,4269,1280,702,205,6456
429492_RevolutionaryCommunistPartyuk1978.txt,581,10,58,227,78,30,8,343
4295785_CinderellacomicBallet.txt,869,8,108,305,104,59,33,501
4296877_RagsToRichescomputerGame.txt,776,10,77,251,143,45,31,470
429800_EmirKusturica.txt,1161,22,52,548,109,62,27,746
429838_CaptainJohnPorteous.txt,1247,21,59,412,211,65,41,729
429846_BritishCouncil.txt,573,14,40,233,58,48,7,346
429852_BalticShield.txt,2675,23,116,1119,267,273,54,1713
4298539_WilliamLLanger.txt,561,12,46,256,51,25,7,339
429857_PrimusInterPares.txt,1226,30,40,430,157,93,51,731
429910_CharlesKuralt.txt,1690,21,80,556,248,90,75,969
429911_RonnieBiggs.txt,978,15,65,337,159,62,32,590
429917_AngoraRabbit.txt,705,11,64,227,117,79,24,447
429918_JafarAlsadiq.txt,1154,27,42,447,158,88,34,727
429919_Ckcotv.txt,1068,32,33,469,116,69,38,692
4299615_ListOfILoveLucyEpisodes.txt,8661,141,61,3491,1205,306,291,5293
4300665_MilitaryHistoryOfBelarusDuringWorldWarIi.txt,2248,36,62,978,237,157,39,1411
4301279_BusinessMarketing.txt,1519,44,34,647,159,120,37,963
4301287_TheFoot.txt,1208,16,75,392,233,36,48,709
4301763_GrainGrowth.txt,796,14,56,258,119,97,34,508
4302153_OnCombatThePsychologyAndPhysiologyOfDeadlyConflictInWarAndInPeace.txt,1990,30,66,556,322,165,115,1158
4302209_HistoryOfPortlandOregon.txt,682,14,48,283,79,52,17,431
4302369_ASmallProblemben10Episode.txt,2610,24,108,788,487,87,130,1492
4303466_ListOfPhilosophersBornInTheEighteenthCentury.txt,877,25,35,527,22,24,6,579
4304889_PenangChineseGirlsHighSchool.txt,547,7,78,222,73,45,14,354
4304957_ListOfInternationalArchitectureSchools.txt,874,12,72,630,4,3,1,638
4305586_ListOfFoxSportsAnnouncers.txt,588,82,7,496,2,23,1,522
4305615_KimJongKook.txt,509,13,39,258,50,27,20,355
430599_ChooseYourOwnAdventure.txt,3790,49,77,1979,195,129,50,2353
4306047_ListOfProtagonistsInTheKingOfBravesGaogaigar.txt,7712,169,45,2853,1080,511,286,4730
4307132_RedScarfGirl.txt,829,10,82,271,142,53,40,506
4307275_StourValleyWalk.txt,981,22,44,443,73,43,30,589
4307295_Babestation.txt,704,12,58,240,106,54,25,425
4308785_EducationInWestBengal.txt,776,27,28,344,94,42,7,487
430897_Desree.txt,988,30,32,448,90,82,39,659
4309460_TheOneWithTheLateThanksgiving.txt,1046,12,87,336,191,32,47,606
4309468_PrehistoryOfBrittany.txt,2130,35,60,862,294,205,83,1444
430958_OrderOfStGeorge.txt,1162,14,83,509,83,94,20,706
430976_UncannyValley.txt,2323,30,77,831,313,206,102,1452
430994_2ndCanadianInfantryDivision.txt,5726,95,60,2257,738,401,166,3562
4309992_TeddyYip.txt,811,10,81,320,102,39,20,481
431003_Zucchini.txt,608,12,50,181,96,70,38,385
431014_BigFish.txt,803,15,53,330,109,52,22,513
4313290_Riotrooper.txt,786,24,32,349,107,22,17,495
4313861_Dharmacakra.txt,639,21,30,250,69,33,19,371
4314744_LeeRocker.txt,607,8,75,245,77,42,22,386
4316008_NyseGroup.txt,588,7,84,272,57,35,12,376
4316399_HowManyMoreTimes.txt,667,8,83,257,76,57,24,414
4318777_Coxsurname.txt,958,3,319,754,24,47,2,827
4319861_StewartOfDarnley.txt,633,18,35,299,51,30,6,386
432052_AlbrechtGrafVonRoon.txt,953,14,68,322,119,62,11,514
432065_SubstancenewOrderAlbum.txt,626,14,44,228,80,55,31,394
432073_SanGabrielMountains.txt,565,10,56,298,56,27,9,390
432092_PatriarchalBlessing.txt,651,12,54,223,99,45,23,390
4320941_GreatAtlantaFireOf1917.txt,709,10,70,234,99,57,38,428
432099_AmericanFlyer.txt,2491,31,80,969,333,210,76,1588
4321536_IbmBasicAssemblyLanguage.txt,690,15,46,278,90,45,18,431
4322416_JohnnySorrow.txt,646,14,46,185,124,34,34,377
4324587_AlexanderGraypoet.txt,568,9,63,250,48,30,7,335
4327836_MadraKingdom.txt,1702,37,46,652,232,85,34,1003
4327854_Recmanga.txt,704,16,44,213,118,39,28,398
4327859_SalwaKingdom.txt,846,24,35,318,116,32,23,489
4329521_GeneralizedMinimalResidualMethod.txt,1290,33,39,444,163,98,53,758
4330138_Magnetophone.txt,1955,35,55,797,204,192,46,1239
4330579_FriendshipGames.txt,648,9,72,316,60,33,10,419
433170_ListOfActiveAutonomistAndSecessionistMovements.txt,4037,120,33,3187,89,221,33,3530
433171_Sambabrazilian.txt,843,13,64,284,97,73,44,498
433180_TheNumberPainter.txt,900,10,90,245,137,27,30,439
433203_ConservativePartyOfCanadaLeadershipElection2004.txt,1200,33,36,954,74,66,14,1108
433207_RosslynChapel.txt,1421,23,61,622,161,84,32,899
433208_ETrueHollywoodStory.txt,838,21,39,644,31,26,11,712
433210_GameBoyPlayer.txt,1414,24,58,580,189,77,40,886
433214_StenaLine.txt,1317,32,41,689,123,43,12,867
433219_NewDemocraticPartyLeadershipElection2003.txt,598,16,37,257,65,33,12,367
433225_KraIsthmus.txt,884,13,68,350,90,63,32,535
433228_CharlesEdwardDukeOfSaxecoburgAndGotha.txt,1162,18,64,493,94,68,21,676
433230_CaliforniaPolytechnicStateUniversity.txt,2248,41,54,889,314,180,70,1453
4333343_Osymyso.txt,1110,8,138,487,72,34,28,621
4333834_Wmkc.txt,1097,15,73,421,165,65,44,695
4334410_WireWheels.txt,593,11,53,201,85,53,33,372
4334447_TverskayaStreet.txt,558,13,42,225,60,37,15,337
4335084_MikeRileyreferee.txt,610,16,38,216,91,40,28,375
4336717_ChaitanyaBharathiInstituteOfTechnology.txt,1125,26,43,477,125,83,23,708
4337184_MarkGottlieb.txt,728,10,72,273,97,35,19,424
43371_EcumenicalPatriarchNikephorosIOfConstantinople.txt,771,14,55,250,93,51,20,414
43373_ClintEastwood.txt,3275,38,86,1288,384,238,94,2004
43375_Communitarianism.txt,1926,31,62,754,233,214,62,1263
4337685_OriginOfRajputs.txt,1009,14,72,413,113,66,23,615
43376_BostonCeltics.txt,6695,58,115,2573,646,290,160,3669
43379_Ballista.txt,2216,44,50,719,314,185,110,1328
43380_Trebuchet.txt,2549,34,74,850,356,194,83,1483
4338246_ReligiousFreedomPeaceTaxFundAct.txt,892,16,55,295,113,85,22,515
4338277_SmokyMountainWrestling.txt,1123,10,112,654,76,42,22,794
43389_RoutingInformationProtocol.txt,630,19,33,274,88,52,21,435
43390_Xeriscaping.txt,671,18,37,237,116,68,41,462
4339310_TheExpulsionFromTheGardenOfEdenmasaccio.txt,625,17,36,233,72,40,22,367
43396_TramsInMelbourne.txt,1916,39,49,718,265,165,61,1209
43399_Hermaphrodite.txt,1381,17,81,464,167,174,70,875
4340438_Satantango.txt,1074,20,53,347,162,81,52,642
4340454_TheSecretsOfSelflessness.txt,688,7,98,296,49,28,11,384
43410_Vhdl.txt,2767,93,29,1025,347,237,133,1742
43412_Winchester.txt,1704,35,48,676,204,129,61,1070
43413_Aurelian.txt,2245,39,57,774,317,151,66,1308
4341490_ThomasMagnum.txt,1095,12,91,395,151,85,49,680
4341501_CarlSheeler.txt,568,15,37,237,71,33,13,354
4341503_AccursedToys.txt,1029,18,57,399,145,89,36,669
4341533_SnowCanyonStatePark.txt,825,20,41,430,61,50,18,559
4341534_YavanaKingdom.txt,2023,40,50,769,224,104,46,1143
43417_ClaraBarton.txt,1704,32,53,729,193,85,32,1039
4342080_GabrielsWing.txt,1152,9,128,494,159,58,37,748
4342093_AflTeamcoach.txt,834,43,19,546,58,26,11,641
4342101_NewmanSmithHighSchool.txt,586,20,29,271,61,24,4,360
43421_HenryDavidThoreau.txt,3299,45,73,1339,393,242,97,2071
43424_JohnBAnderson.txt,754,12,62,294,79,39,23,435
434295_WraithTheOblivion.txt,2357,24,98,855,306,172,104,1437
434308_TheGhan.txt,617,13,47,276,73,31,11,391
434320_SigebertI.txt,570,11,51,193,80,25,19,317
4344236_SaintMarysUniversityhalifax.txt,658,12,54,291,61,46,13,411
4344419_AllCzechMunicipalitiesN.txt,5920,8,740,4519,121,269,8,4917
4345509_AWorldWithoutDave.txt,556,17,32,232,64,28,27,351
4345905_DalitFreedomNetwork.txt,745,12,62,310,108,54,23,495
4345907_BoysOwnPaper.txt,937,19,49,323,122,79,27,551
4346570_AvilaUniversity.txt,757,17,44,423,53,34,11,521
4348104_CopeStewardson.txt,865,14,61,372,82,47,15,516
4348249_Hr4437.txt,1811,19,95,689,247,129,44,1109
434883_KatherineHillard.txt,1065,18,59,374,177,67,41,659
4351910_SuitcaseClinic.txt,1220,15,81,530,128,125,27,810
4353173_YugoslaviaAtThe1984SummerOlympics.txt,619,26,23,439,5,14,0,458
435380_CampaignSetting.txt,1497,26,57,532,186,211,66,995
435391_MehmetAliTalat.txt,698,15,46,284,83,43,10,420
435393_RafaelchurumbaCorderoSantiago.txt,769,35,21,346,84,37,11,478
435397_AutomaticMeterReading.txt,1097,18,60,445,162,74,51,732
435399_CommonCauseAndSpecialCause.txt,1394,40,34,547,171,111,55,884
4354073_GenoCarlisle.txt,704,10,70,272,81,27,9,389
4354303_DowntownStCatharinesOntario.txt,979,20,48,400,113,66,25,604
4354707_Sifre.txt,1911,16,119,769,187,97,83,1136
4356877_Pakhtunkhwa.txt,576,10,57,231,70,26,19,346
4359184_BramVanVelde.txt,1062,10,106,392,137,58,23,610
4359616_Denzil.txt,953,17,56,342,120,63,35,560
4360652_Bourtreehill.txt,940,22,42,327,160,68,36,591
4360694_ForeignPolicyAnalysis.txt,600,20,30,224,81,77,8,390
436106_BurnieTasmania.txt,1817,39,46,697,239,132,51,1119
436109_JuliusHouseman.txt,906,12,75,358,98,47,16,519
436114_Cupressus.txt,770,10,77,382,80,62,33,557
4361781_Wqadtv.txt,1011,24,42,515,91,51,24,681
4361791_PhilDriscoll.txt,651,11,59,252,113,32,14,411
4361976_Berserko.txt,953,5,190,327,145,55,40,567
4362362_SikuQuanshu.txt,599,10,59,263,58,39,11,371
436441_Pashtunwali.txt,2644,23,114,857,363,252,96,1568
436449_IowaDemocraticPartyCaucuses2004.txt,806,18,44,268,138,59,34,499
4364523_FissionProductsbyElement.txt,1624,30,54,543,242,124,33,942
4364535_Pegun.txt,1057,15,70,349,139,67,22,577
4365619_AngaKingdom.txt,2348,59,39,870,296,101,62,1329
4365640_NobuyukiMasaki.txt,897,12,74,295,146,47,49,537
4366183_HeartsAndMindslost.txt,672,9,74,193,145,33,21,392
4366668_OneOfThem.txt,1324,13,101,412,247,47,57,763
4368501_Pas78.txt,789,19,41,309,97,57,20,483
4370022_PembrokesMen.txt,837,8,104,303,112,44,25,484
4370670_CensureInTheUnitedStates.txt,691,14,49,282,90,40,18,430
437074_JamesKochalka.txt,1536,20,76,697,165,132,25,1019
4371082_Kapoor.txt,643,18,35,327,58,27,15,427
4374365_IntraoperativeBloodSalvage.txt,1008,17,59,395,157,129,35,716
4374586_2000LeTourDeLangkawi.txt,420,24,17,334,16,24,6,380
4374908_MichaelDierks.txt,537,29,18,241,70,26,14,351
437531_JamesSalter.txt,802,11,72,302,96,54,23,475
437532_TemiskamingShoresOntario.txt,652,37,17,325,61,32,12,430
437544_BobSaget.txt,1037,23,45,453,102,54,33,642
4375604_LadetteToLady.txt,857,26,32,334,109,46,31,520
4375606_RichmondSecondarySchool.txt,1221,24,50,528,141,97,37,803
437573_BlackeyedPea.txt,703,17,41,273,102,53,32,460
437579_JonnyWilkinson.txt,3105,42,73,1131,384,155,84,1754
437585_Epigraphy.txt,751,13,57,333,85,69,26,513
4376005_FastingAndAbstinenceInTheRomanCatholicChurch.txt,1394,25,55,501,195,87,61,844
437615_EugenSnger.txt,601,7,85,192,89,54,13,348
4376_BookOfNumbers.txt,1746,49,35,622,205,75,20,922
4377067_DamianStephens.txt,836,7,119,538,23,11,5,577
4377137_Toheartgame.txt,1235,38,32,396,194,98,61,749
4377_BookOfJudges.txt,2198,21,104,704,272,171,89,1236
4378374_KeithParkinson.txt,627,11,57,267,73,37,8,385
4378763_FueledByRamenDiscography.txt,1193,4,298,649,10,16,5,680
4380012_GreaterWingOfSphenoidBone.txt,849,15,56,273,70,108,12,463
4380952_VintageBaseBall.txt,824,10,82,386,92,51,30,559
4380_BooksOfKings.txt,12267,99,123,4051,1756,576,499,6882
4381090_Undertownovel.txt,698,9,77,219,131,38,38,426
4381177_MissionCompromised.txt,930,20,46,474,103,44,24,645
43815_TeenageMutantNinjaTurtles.txt,4788,77,62,1920,644,371,120,3055
4381_BookOfRuth.txt,2576,72,35,1033,317,128,79,1557
4382176_PublicRelationsMeasurement.txt,834,17,49,314,117,68,39,538
43823_RobertAltman.txt,4116,37,111,1751,382,227,99,2459
43824_AssataShakur.txt,2264,36,62,934,317,89,44,1384
4382576_FastBattleship.txt,4533,38,119,1498,609,403,165,2675
4382598_JamesBond007roleplayingGame.txt,1565,20,78,666,179,105,48,998
4382607_EndangeredFeces.txt,803,15,53,368,88,63,17,536
43826_JavaServlet.txt,898,27,33,389,107,49,26,571
438291_SuperTransformation.txt,3020,42,71,1035,454,207,146,1842
4382_BookOfEsther.txt,3306,54,61,1177,477,217,134,2005
4383694_SouichisDiaryOfDelightsmanga.txt,2164,24,90,667,302,127,122,1218
4383708_MeganBurns.txt,667,16,41,330,59,47,11,447
4384758_ListOfBritishFish.txt,580,40,14,449,72,32,3,556
4384759_ListOf23ZipCodes.txt,1738,13,133,1162,2,10,0,1174
4385009_ListOf26ZipCodes.txt,1218,4,304,818,2,6,0,826
4385011_EdibleFlowers.txt,640,13,49,225,113,57,33,428
438701_CharlesMSchwab.txt,948,18,52,394,118,54,33,599
438710_ListOfFictionalShips.txt,1836,11,166,1158,58,55,23,1294
4387522_PandyaKingdom.txt,1191,29,41,460,143,54,31,688
4388_BookOfProverbs.txt,1076,17,63,435,127,51,29,642
4389_BookOfLamentations.txt,654,12,54,227,82,40,16,365
4390330_BishopricOfBrixen.txt,955,11,86,350,110,69,17,546
4390332_XavierNoiretthom.txt,725,9,80,376,22,28,0,426
4390_BookOfEzekiel.txt,2662,41,64,857,370,159,90,1476
4392486_LuisMarden.txt,1723,30,57,697,233,77,48,1055
439260_KevinNash.txt,4522,50,90,1864,577,187,138,2766
4394717_BodyPlan.txt,617,12,51,231,73,63,25,392
4395892_TheWrestlingAlbum.txt,789,6,131,374,85,44,28,531
4397476_Sanulrim.txt,315,10,31,99,28,31,9,167
4397545_NewHampshireLine.txt,1768,37,47,675,225,92,17,1009
439771_LarryHolmesVsGerryCooney.txt,913,13,70,326,145,51,37,559
439784_RichieSexson.txt,685,10,68,279,76,32,12,399
439791_Tabriz.txt,2208,53,41,1011,259,173,48,1491
4397993_DecouplingCapacitor.txt,913,14,65,310,130,72,36,548
439829_Karpathos.txt,762,18,42,287,87,64,25,463
4399103_CapeGarrisonArtillery.txt,1245,32,38,521,167,57,32,777
4401221_TheOpenRoadForBoys.txt,606,8,75,242,84,23,27,376
4401225_BelfastWestdilireannConstituency.txt,726,17,42,322,82,42,16,462
4402440_FrankStokes.txt,991,11,90,435,98,77,38,648
4402925_ManToManWithDeanLearner.txt,712,21,33,314,71,70,14,469
4404582_MarineAirgroundTaskForce.txt,618,12,51,273,80,40,15,408
4405083_JimObriencollegeBasketball.txt,1077,15,71,450,118,62,22,652
4407408_RiverTrekking.txt,940,28,33,355,143,85,50,633
4407798_CommonwealthSecondarySchool.txt,625,19,32,282,69,42,10,403
4407814_BluesInNewZealand.txt,862,10,86,375,101,78,31,585
440866_JamesMurdochmediaExecutive.txt,628,11,57,232,95,34,22,383
440868_MarineOne.txt,625,17,36,232,86,43,25,386
440869_ChauvetCave.txt,709,14,50,251,106,61,29,447
440872_SnappingTurtle.txt,1300,14,92,421,198,128,67,814
440875_InternationalChurchOfTheFoursquareGospel.txt,653,18,36,326,51,24,14,415
4409030_AtelierIris2TheAzothOfDestiny.txt,2979,71,41,1040,396,188,97,1721
4409044_Orrsurname.txt,563,10,56,292,42,29,8,371
4409960_ListOfBusRoutesInGreaterVancouver.txt,625,33,18,253,102,36,18,409
4410543_NagaKingdom.txt,4796,109,44,1991,675,208,119,2993
4410547_Vishnukundina.txt,1867,36,51,771,224,122,38,1155
4410593_FrenchVideoGamePolicy.txt,1140,19,60,501,124,80,20,725
4412298_KansasCityZephyr.txt,968,13,74,443,92,44,25,604
4412750_MadeleineDeVerchres.txt,784,9,87,243,147,36,42,468
441520_LuapulaProvinceBorderDispute.txt,5000,84,59,2040,689,286,118,3133
4415518_Kubotan.txt,696,11,63,200,113,57,48,418
4417627_JoeWaggonner.txt,893,20,44,368,98,79,28,573
441975_Laterite.txt,617,14,44,222,82,82,38,424
4420564_BlackSunRising.txt,867,12,72,316,133,38,28,515
4423173_CyberCityOedo808.txt,946,36,26,386,109,71,34,600
4423752_StarTrekDeepSpaceNineDvds.txt,1134,86,13,719,46,36,4,805
4424212_LiteraryCreationsOfSatyajitRay.txt,628,15,41,252,90,58,15,415
4424218_EdHughes.txt,804,12,67,296,110,39,26,471
442603_ConeOfSilence.txt,888,17,52,313,138,55,34,540
4426428_TakeshiKovacs.txt,766,11,69,258,130,74,35,497
4426434_BobDavidsonumpire.txt,1223,16,76,422,188,93,75,778
4426579_StateResponsibility.txt,1739,23,75,570,205,187,60,1022
4429169_Rayman2Revolution.txt,1952,31,62,711,280,107,62,1160
4430241_LossOfChanceInEnglishLaw.txt,2724,10,272,885,411,164,88,1548
443056_Skimboarding.txt,1531,20,76,465,245,113,90,913
4431503_ChurchOfTheRisenChrist.txt,1135,19,59,527,114,65,15,721
4431874_The1upShow.txt,799,17,47,367,78,46,22,513
4431893_EllowesHallSchool.txt,709,9,78,242,96,95,18,451
4431906_CivilizationIvWarlords.txt,1773,22,80,678,249,139,47,1113
4431917_CanyonsOfTheAncientsNationalMonument.txt,687,7,98,267,89,61,13,430
4431934_PepperDennis.txt,785,11,71,452,36,26,19,533
4432565_RafRaydon.txt,1264,43,29,490,157,96,37,780
4432950_ColorCalibration.txt,650,9,72,262,84,48,20,414
4432972_TheTrinityLion.txt,330,22,15,185,13,17,3,218
4433141_RoyalNavyPropellantFactoryCaerwent.txt,1370,23,59,513,157,114,48,832
4436819_MuddyBuddy.txt,704,17,41,213,108,45,24,390
443705_ListOfValleysOfTheUnitedStates.txt,475,2,237,456,2,0,2,460
443769_TheRoyleFamily.txt,2498,40,62,844,368,172,115,1499
443775_CarlsbadSpringsOntario.txt,653,11,59,238,87,64,15,404
443777_CallForHelptvSeries.txt,1246,23,54,499,182,85,37,803
4437911_HuanXuan.txt,1884,16,117,680,266,98,107,1151
4437923_GwaliorState.txt,3155,22,143,1126,408,166,62,1762
4437_LiberalDemocrats.txt,4903,72,68,1841,542,423,163,2969
4438500_MagesGuild.txt,792,22,36,320,97,54,12,483
4438999_MirJumla.txt,1681,29,57,689,191,102,34,1016
4440247_VenkateshKetakar.txt,672,9,74,222,97,56,32,407
4440_BerkeleySoftwareDistribution.txt,2847,40,71,1139,337,270,108,1854
444113_UsRoute281.txt,641,13,49,299,48,22,12,381
444117_EricEsch.txt,730,13,56,305,82,48,20,455
444118_HelmutJahn.txt,573,7,81,335,32,21,2,390
444123_Muharram.txt,715,16,44,272,101,32,17,422
444148_QuakerOatsCompany.txt,1096,31,35,519,139,52,24,734
444156_HeavyMetalFashion.txt,1962,29,67,712,257,201,132,1302
4441716_Oyoor.txt,740,9,82,276,96,47,21,440
4441777_AshfieldGangRapes.txt,858,27,31,287,138,37,29,491
4442833_MarthaStewartInsiderTradingCharges.txt,1787,23,77,663,289,65,40,1057
4442853_MusetteDeCour.txt,1189,17,69,372,159,133,53,717
4443392_Nextdemogroup.txt,846,17,49,335,113,72,26,546
4443_Barcelona.txt,5081,95,53,2106,526,398,103,3133
44454_Passchendaele.txt,2542,42,60,917,319,187,94,1517
4445572_JonahAVeggietalesMovie.txt,2396,57,42,891,363,129,85,1468
4445744_ChinleFormation.txt,1077,13,82,538,101,56,25,720
4445747_WildBoarInBritain.txt,573,15,38,215,76,49,35,375
4445751_ListOfMiddlesexCccPlayers.txt,2521,50,50,1992,7,4,0,2003
44458_PeterWeir.txt,1169,17,68,483,134,109,28,754
44459_GlennClose.txt,1019,22,46,510,74,53,19,656
4447234_GeorgeNaicker.txt,745,15,49,266,107,35,22,430
4447237_CharlesNapolonBonaparte.txt,2017,21,96,723,244,133,55,1155
44475_Uranus.txt,2238,34,65,770,297,188,108,1363
4447870_DelticPreservationSociety.txt,639,3,213,235,91,37,11,374
444789_PluralQuantification.txt,1167,23,50,404,145,107,62,718
444794_AirraidShelter.txt,3269,49,66,1064,515,261,156,1996
4448290_TomoeMarguerite.txt,736,9,81,225,122,58,19,424
4448326_LitmusbattlestarGalactica.txt,667,11,60,227,109,33,32,401
444862_GranvilleSharp.txt,935,14,66,340,115,55,32,542
444865_EarlOfSouthesk.txt,759,6,126,335,59,38,12,444
444867_FirstBattleOfKrithia.txt,693,14,49,219,96,53,20,388
444868_UssHoustonssn713.txt,1174,20,58,418,190,75,40,723
44486_MelvinDefleur.txt,1290,14,92,611,94,96,14,815
44488_IndependentMediaCenter.txt,3634,63,57,1394,531,288,102,2315
4449002_ScarbattlestarGalactica.txt,668,9,74,240,122,27,28,417
4449383_ProjectFollowThrough.txt,6962,52,133,2727,844,579,263,4413
4449408_MichaelPetersonsurfer.txt,4043,72,56,1193,672,268,246,2379
44495_LinearMotor.txt,929,13,71,331,133,110,49,623
44497_NationalPeoplesCongress.txt,976,14,69,324,144,68,40,576
44498_StateCouncilOfThePeoplesRepublicOfChina.txt,1067,19,56,571,76,48,19,714
44500_Charcoal.txt,1383,17,81,482,203,120,73,878
44501_CastAway.txt,2524,43,58,915,370,137,94,1516
44502_AllegroLibrary.txt,685,14,48,308,84,64,18,474
4450303_Krasnoufimsk.txt,934,26,35,398,85,81,13,577
44510_ChildericI.txt,587,11,53,198,84,18,16,316
4451282_ApEuropeanHistory.txt,610,9,67,259,40,71,3,373
445201_AngerManagement.txt,1799,23,78,550,341,204,109,1204
445218_InformationLiteracy.txt,2754,63,43,1212,336,200,49,1797
4452299_NecessityInEnglishLaw.txt,1670,7,238,554,241,98,67,960
4452304_RoswellConspiraciesAliensMythsAndLegends.txt,2187,48,45,817,288,151,68,1324
445231_BiodynamicAgriculture.txt,1463,30,48,539,205,130,38,912
445233_SnkVsCapcomseries.txt,650,7,92,285,77,24,26,412
445239_ActiveLearning.txt,1063,23,46,403,162,99,38,702
445249_ShellyManne.txt,2439,30,81,985,267,177,118,1547
445252_SibyllineOracles.txt,1348,18,74,458,176,124,58,816
4453532_VideogameTheMovieTheGame.txt,599,8,74,286,45,28,13,372
4453559_ExplorationOfTheMoon.txt,950,21,45,346,121,59,28,554
4454647_SalinaVeche.txt,742,15,49,245,98,62,13,418
4455110_NorthernIrelandConstitutionAct1973.txt,763,13,58,286,106,36,23,451
4457805_WorldCongressOfImamsAndRabbisForPeace.txt,1202,9,133,463,120,72,23,678
4458495_CluebookSeries.txt,1429,21,68,465,205,84,73,827
4458900_LordWily.txt,869,13,66,341,109,41,34,525
445892_EarlOfOrkney.txt,1520,20,76,733,96,65,19,913
445899_DavidKay.txt,1057,16,66,416,173,45,43,677
4459033_JeanneDuprau.txt,1297,15,86,433,193,86,48,760
445952_TransformativeLearning.txt,1947,29,67,827,215,177,46,1265
445959_WindowsExplorer.txt,2142,45,47,845,292,148,73,1358
4461218_ParacanthurusHepatus.txt,789,11,71,275,117,87,37,516
4462880_Cassandrastargate.txt,609,15,40,193,113,36,25,367
4463965_Newsbabe.txt,815,11,74,317,102,58,40,517
446402_Bayon.txt,1075,14,76,376,137,84,31,628
446404_BaylorCollegeOfMedicine.txt,1137,17,66,514,112,89,23,738
4465464_PGWodehouseLocations.txt,2647,91,29,1126,279,172,79,1656
4466186_RafThurleigh.txt,1194,33,36,525,130,73,24,752
4466579_BurnetMaybankIii.txt,657,11,59,368,29,23,9,429
4466735_ParableOfTheUnjustSteward.txt,624,12,52,136,107,44,49,336
4467192_ListOfSilentHillLocations.txt,1107,16,69,542,95,54,52,743
4467200_RichardMLangworth.txt,647,8,80,438,21,14,3,476
4467828_BuildingRegulationsInTheUnitedKingdom.txt,2052,95,21,934,252,128,60,1374
4467855_WalterSullivan.txt,2494,33,75,887,367,111,73,1438
4468860_LafayetteSquareStLouis.txt,1097,10,109,418,154,60,25,657
4469947_TopOfTheWorldTour.txt,784,19,41,379,68,46,15,508
4471637_ElHatilloMunicipalityMiranda.txt,4512,60,75,1808,602,336,95,2841
4471665_BalaHisarFort.txt,719,16,44,260,111,48,21,440
4472559_RonMillerartistAndAuthor.txt,844,11,76,461,57,32,6,556
4472736_EternalMalediction.txt,583,11,53,229,59,35,11,334
4472760_YaleReportOf1828.txt,832,12,69,254,119,52,30,455
4474216_TheJennyJonesShow.txt,786,14,56,283,118,42,25,468
447440_BluecollarCrime.txt,1625,5,325,662,196,155,55,1068
4474434_DeadboyTheElephantmen.txt,630,20,31,265,85,43,23,416
447449_PetrChelick.txt,1158,14,82,367,161,89,38,655
4474907_StuckFetishism.txt,867,14,61,267,131,93,61,552
447492_PolicyDebate.txt,5912,86,68,2005,860,576,280,3721
4475392_DiminishedResponsibilityInEnglishLaw.txt,1411,5,282,447,208,115,60,830
4476548_HRMcmaster.txt,736,13,56,333,71,38,9,451
4477636_UltraluminousXraySource.txt,925,14,66,315,133,108,34,590
4479193_ChaimLeibShmuelevitz.txt,1224,19,64,470,145,70,33,718
4480348_JzefAndrzejZauski.txt,686,9,76,289,54,48,15,406
4483131_AGrimDayPandorasLunchBox.txt,709,10,70,280,99,29,33,441
448504_AlMansurah.txt,665,13,51,262,73,52,18,405
448542_GlossaryOfTermsForMultiraciality.txt,1738,17,102,728,162,235,43,1168
448549_TimelineOfArda.txt,7162,40,179,2884,706,419,72,4081
4486984_BethellsBridge.txt,749,22,34,257,120,51,22,450
4488013_BhaiDayaSingh.txt,682,10,68,315,72,18,15,420
4488035_Mandy24Character.txt,948,18,52,326,144,52,23,545
44911_Syllable.txt,1366,28,48,456,189,174,53,872
449223_Mindvox.txt,2234,39,57,808,290,175,76,1349
4495160_BlackStump.txt,1336,23,58,485,175,101,33,794
4495630_Armanencantadia.txt,808,11,73,262,138,37,35,472
449585_TopicsInCryptography.txt,2038,36,56,1315,104,172,20,1611
449626_StateOfDeseret.txt,949,19,49,361,124,51,34,570
449671_UsamahIbnMunqidh.txt,677,9,75,242,75,45,32,394
449677_ProjectStormfury.txt,2374,52,45,757,421,200,82,1460
44975_Phrase.txt,552,15,36,198,58,56,31,343
4497926_EconomicProgress.txt,2802,53,52,903,359,285,123,1670
4499412_2006InIraq.txt,9994,52,192,4337,1463,530,121,6451
450257_UrbanAgriculture.txt,1754,26,67,770,239,149,34,1192
450313_KateCarnell.txt,1124,26,43,391,154,48,35,628
4504486_GeneralCouncilOfSaintpierreAndMiquelon.txt,629,22,28,332,44,42,6,424
4504964_ThetaNuEpsilon.txt,1152,7,164,476,119,65,35,695
4505414_FireTempleOfBaku.txt,585,10,58,222,74,38,26,360
450675_ListOfWimbledonDoublesChampions.txt,822,4,205,620,20,15,13,668
4507169_LZuan.txt,1460,16,91,540,215,90,66,911
450733_MontrealLocomotiveWorks.txt,1491,24,62,553,203,148,53,957
4508838_CottonvideoGame.txt,804,15,53,322,107,41,33,503
4509276_KathleenAnnGoonan.txt,896,15,59,341,117,66,35,559
4511532_NancyThompsoncharacter.txt,1433,18,79,477,248,55,62,842
4511595_Moneyslane.txt,654,21,31,273,78,36,17,404
4512175_LatinProfanity.txt,4518,121,37,1773,652,377,187,2989
4512183_AlmaghribInstitute.txt,923,18,51,418,101,50,21,590
451283_RabinCryptosystem.txt,1332,40,33,443,211,111,56,821
451287_FrenchAirForce.txt,1005,21,47,401,104,99,25,629
451350_DavidSalo.txt,722,12,60,270,86,51,25,432
451351_KingLeopoldsGhost.txt,1364,17,80,515,173,110,34,832
451358_HullCityAfc.txt,1810,37,48,741,211,101,50,1103
4514687_Eparticipation.txt,584,8,73,207,101,59,23,390
4514751_AbrahamSerfaty.txt,919,11,83,324,106,63,30,523
451817_Taxi2004Film.txt,1479,25,59,485,246,58,73,862
451852_ListOfGovernorsgeneralOfBarbados.txt,1687,5,337,561,194,62,28,845
451853_ListOfGovernorsgeneralOfBelize.txt,823,4,205,238,95,57,13,403
4518807_QuasiprobabilityDistributions.txt,625,20,31,234,74,48,26,382
4520909_SanusiyaOrder.txt,3358,20,167,1150,439,219,91,1899
4522045_Tulasa.txt,645,7,92,222,99,28,18,367
452374_Barranquilla.txt,1655,33,50,693,168,154,58,1073
452443_RoyMeadow.txt,2476,32,77,864,410,183,72,1529
4525681_Bloodstorm.txt,2225,45,49,703,353,154,100,1310
452887_FurTrade.txt,1188,12,99,501,130,102,39,772
452899_LanaWood.txt,1105,68,16,571,68,28,11,678
452912_Trinidad.txt,554,11,50,198,64,70,14,346
4531354_SheffieldCouncilElection2006.txt,107,34,3,41,12,6,2,61
4531372_SoundTransitTacomaLink.txt,1374,27,50,561,170,84,47,862
4532485_AlmatyInternationalAirport.txt,558,14,39,293,57,38,7,395
4535681_TropicalStormHanna2002.txt,948,13,72,374,123,70,25,592
4538216_BigDealgameShow.txt,778,7,111,244,125,61,21,451
4538455_Librarything.txt,673,10,67,247,89,80,13,429
4538793_KevHawkins.txt,1400,15,93,410,254,76,50,790
453943_CentreDemocratsnetherlands.txt,903,14,64,322,118,73,34,547
453959_Hd209458B.txt,1022,19,53,389,134,61,27,611
453982_NGregoryMankiw.txt,644,10,64,256,80,45,14,395
453983_GothiccomputerGame.txt,2118,28,75,739,312,147,69,1267
454007_ShellGame.txt,1134,17,66,370,186,63,50,669
454013_EndIsForever.txt,637,3,212,257,77,35,22,391
454019_BradDourif.txt,700,19,36,297,86,25,15,423
454059_Snapper.txt,943,6,157,587,79,51,11,728
4541200_GarthRanzz.txt,2077,25,83,675,372,105,101,1253
4543339_1634TheRamRebellion.txt,1476,20,73,526,173,144,49,892
4543354_AnglicanProvinceOfAmerica.txt,1139,24,47,445,144,46,22,657
4543401_JensThiis.txt,607,8,75,311,56,29,8,404
4543811_Jordanscompany.txt,1017,22,46,397,149,93,39,678
4543931_ListOfGaelicAthleticAssociationClubs.txt,4044,57,70,3631,8,65,2,3706
4544905_Semionband.txt,736,9,81,361,71,37,15,484
454697_MauriceEwing.txt,580,9,64,272,59,25,7,363
454699_ArgentinaNationalFootballTeam.txt,1117,41,27,453,135,69,23,680
4547775_ListOfHikingTrailsInWisconsin.txt,720,8,90,464,39,10,4,517
4549946_DuffyDaugherty.txt,778,15,51,325,86,39,19,469
455070_Cheshunt.txt,966,17,56,364,128,79,39,610
455072_ScottRitter.txt,2928,38,77,1173,405,118,83,1779
4551009_GForceanime.txt,603,7,86,215,93,61,22,391
4551025_VellalaGounder.txt,1279,33,38,501,166,97,45,809
4551031_RedspottedCatshark.txt,894,16,55,344,140,73,31,588
4551063_TriangleHeart.txt,1635,13,125,571,248,103,72,994
455127_BrazilianExpeditionaryForcefeb.txt,2996,46,65,1133,374,207,68,1782
455138_RichardAshcroft.txt,939,21,44,364,116,67,35,582
455142_ScarlettPomers.txt,701,14,50,325,81,28,18,452
455150_CausesOfTheGreatDepression.txt,4330,38,113,1661,528,314,148,2651
455152_Livery.txt,623,7,89,215,87,43,22,367
4551616_RoyceClayton.txt,611,6,101,109,10,6,0,125
4551637_Wpkf.txt,769,9,85,296,101,44,26,467
45538_MersenneTwister.txt,1024,27,37,435,105,76,18,634
45541_SocialDarwinism.txt,3104,35,88,1123,374,335,128,1960
4554230_Kujiin.txt,1247,29,43,435,174,88,48,745
45547_Refugee.txt,4693,71,66,1862,580,321,129,2892
45551_Alghero.txt,664,13,51,243,78,44,15,380
4555919_IvanPerestiani.txt,677,10,67,371,31,32,4,438
45562_CartagenaProtocolOnBiosafety.txt,2034,45,45,730,253,141,47,1171
4556521_Obalumo.txt,1508,12,125,497,146,163,42,848
4556540_ListOfRegisteredHistoricPlacesInKentuckyfayetteCountyToHopkinsCounty.txt,2217,6,369,2084,1,34,0,2119
45568_TheAbyss.txt,2437,29,84,831,394,150,98,1473
45569_DedekindCut.txt,720,23,31,239,100,60,25,424
4557430_LouisianaGubernatorialElection2003.txt,775,12,64,299,97,86,14,496
4557587_CarlGunterJr.txt,681,14,48,326,73,25,13,437
45576_CountyDonegal.txt,1127,24,46,495,125,97,35,752
455788_AustralianGeneralElection1998.txt,296,9,32,106,21,24,1,152
45580_RichardDedekind.txt,1381,22,62,508,169,98,45,820
45582_Schleswig.txt,755,12,62,292,83,44,24,443
4558521_InnisfreeHouseSchool.txt,1618,39,41,618,231,85,29,963
45586_IndifferenceCurve.txt,2023,38,53,648,260,162,78,1148
4558700_SaptaSindhu.txt,755,8,94,302,82,41,29,454
45592_BartolomeuDias.txt,648,11,58,247,78,33,20,378
45596_ThomasDewey.txt,1472,26,56,572,193,93,52,910
45597_HenryVOfEngland.txt,1379,23,59,526,164,80,47,817
4560376_JasonBard.txt,1070,11,97,321,204,46,43,614
4561870_MuireannNicAmhlaoibh.txt,612,10,61,276,61,49,11,397
456207_Impressment.txt,953,16,59,311,135,86,55,587
456228_WilliamColby.txt,1309,20,65,543,173,72,49,837
4562331_QueenElizabethSchoolHongKong.txt,659,15,43,353,40,21,4,418
4562536_MarriedradioSeries.txt,1003,16,62,331,156,70,37,594
4562965_ElitchGardens.txt,1047,21,49,409,134,89,29,661
4564011_HughMacdonaldSinclair.txt,2443,30,81,925,331,154,81,1491
4566372_BalaSManian.txt,924,15,61,423,109,57,17,606
4566412_TextAndRubricsOfTheRomanCanon.txt,4577,64,71,1720,617,224,181,2742
4570188_KelvinCarpenter.txt,1298,19,68,424,215,82,60,781
4571280_TeinopalpusImperialis.txt,1308,12,109,471,126,157,66,820
457278_MarchCambridgeshire.txt,1697,28,60,604,225,93,40,962
4572982_RichardBingham.txt,3361,34,98,1149,506,137,64,1856
457307_PhoenixVentureHoldings.txt,898,15,59,412,110,44,15,581
4575441_PaceUniversitySchoolOfLaw.txt,1042,13,80,541,79,68,15,703
4575461_JamesDrummondbotanist.txt,2438,27,90,843,374,148,62,1427
4575585_CommunesOfTheProvinceOfMarche.txt,614,11,55,461,33,11,4,509
4576030_Arriflex435.txt,604,7,86,204,80,64,23,371
4577068_Plurix.txt,847,25,33,294,124,88,39,545
4577101_RamShastri.txt,675,8,84,257,75,43,24,399
4577766_HpOfficejet7110.txt,1061,51,20,456,80,77,24,637
4577772_JohnTimoney.txt,596,14,42,232,82,33,22,369
4578161_Dukha.txt,750,9,83,244,123,51,27,445
4578214_DeadAlewives.txt,846,18,47,332,101,71,27,531
457926_BVitamins.txt,1087,20,54,481,145,99,45,770
4579456_JohnWhitneyanimator.txt,636,10,63,236,85,47,14,382
4581558_KhalilollahKhalili.txt,655,10,65,261,88,42,16,407
4583066_1963InOrganizedCrime.txt,715,3,238,341,74,23,17,455
4583155_ColchesterPolitics.txt,968,31,31,560,23,18,1,602
458338_ListOfTelevisionShowsSetInNewYorkCity.txt,919,9,102,454,30,20,6,510
458340_ListOfFilmsSetInNewYorkCity.txt,1647,12,137,879,11,20,0,910
458350_Azurite.txt,1995,34,58,752,224,234,83,1293
458399_Eurocorps.txt,697,16,43,279,82,57,12,430
458423_SouthEndBostonMassachusetts.txt,1746,20,87,775,190,161,60,1186
458427_AradoFlugzeugwerke.txt,573,9,63,228,41,39,15,323
458428_FreddiePrinzeJr.txt,613,13,47,247,81,47,12,387
4584345_TropicalStormJerry1995.txt,966,16,60,321,135,87,24,567
4584383_MichiganMarchingBandHistory.txt,5149,79,65,1953,648,295,115,3011
4584405_ThisEarthOfMankind.txt,1822,25,72,728,224,109,55,1116
4584756_WillieMaddren.txt,892,21,42,366,121,53,18,558
4585432_HareKrishnaInPopularCulture.txt,1725,40,43,755,205,84,33,1077
4585857_CollegeTuition.txt,603,10,60,231,50,82,23,386
4587551_SsFrance1912.txt,943,11,85,282,144,85,48,559
4593487_Werderhavel.txt,604,7,86,240,80,39,20,379
4593569_PearlLadderbanks.txt,747,19,39,229,158,22,29,438
459432_BaronDudley.txt,748,11,68,345,75,41,15,476
459447_HanSui.txt,789,8,98,292,110,32,27,461
459448_CastellCoch.txt,856,8,107,307,107,67,32,513
4594628_EmployeeOfTheMonththeSopranosEpisode.txt,958,12,79,366,153,32,39,590
459462_GuoJia.txt,666,11,60,266,99,35,27,427
459471_BreathingGas.txt,2250,30,75,797,367,211,103,1478
4595671_ListOfJapanrelatedTopicsa.txt,862,24,35,781,9,10,4,804
4595672_GiJoeTheAtlantisFactor.txt,820,18,45,276,105,67,32,480
4596938_TetragrammatonInTheNewTestament.txt,1112,18,61,447,134,60,49,690
4598013_TheBlueBird1940Film.txt,561,28,20,264,56,32,7,359
4598392_SarahKent.txt,1138,16,71,433,142,78,34,687
4598465_AnthonyPDamato.txt,632,14,45,260,64,30,15,369
4598607_SpecificMechaInMedia.txt,1367,13,105,882,39,58,22,1001
4598612_TimelineOfKoreanHistory.txt,2162,162,13,1055,204,147,23,1429
45990_GrandfatherParadox.txt,5153,39,132,1625,795,326,263,3009
4599520_TiruchyLSaravanan.txt,1009,18,56,436,82,91,31,640
4599539_Digha.txt,569,11,51,217,69,52,26,364
4599642_AccursedLands.txt,3064,70,43,926,478,349,138,1891
45998_Fa18Hornet.txt,4746,81,58,1882,613,412,129,3036
45999_GeckolayoutEngine.txt,1289,22,58,546,171,93,45,855
46000_AlexanderJohnCuza.txt,1388,18,77,514,164,90,33,801
4600734_StochasticCooling.txt,727,9,80,224,112,56,46,438
460097_Zoukclub.txt,868,20,43,405,88,40,31,564
460100_SemiautomaticPistol.txt,4245,41,103,1385,575,447,239,2646
460103_WilliamHMurray.txt,1753,30,58,703,233,81,50,1067
460110_SchrdingersCatTrilogy.txt,826,15,55,331,93,78,31,533
460175_JohnnyPaulKoroma.txt,995,9,110,379,137,58,23,597
4602272_JudithJoyRoss.txt,594,11,54,208,75,54,13,350
4602274_RavensAit.txt,678,23,29,301,76,51,24,452
4602276_VereinigteBhnenWien.txt,624,13,48,348,42,23,12,425
4603371_1972InOrganizedCrime.txt,596,4,149,303,71,23,7,404
4603501_TrinityIsStillMyName.txt,745,6,124,242,135,23,27,427
4603561_IndustrialCanalLock.txt,610,15,40,218,86,58,10,372
4604426_LocalGovernmentAct2002newZealand.txt,1116,27,41,389,161,63,27,640
4605025_DazSampson.txt,727,12,60,238,114,43,27,422
460516_LindaDarnell.txt,685,12,57,292,72,25,12,401
460528_HeartSutra.txt,1089,16,68,438,117,82,47,684
460557_SpeedBump.txt,952,14,68,354,133,85,38,610
46064_StoryOfO.txt,793,17,46,316,101,52,20,489
4607205_April22006TornadoOutbreak.txt,1479,25,59,506,226,120,56,908
4607802_CaliforniaFloristicProvince.txt,906,25,36,473,93,71,15,652
4608269_ReturnFromTheStars.txt,827,14,59,259,130,64,46,499
4608869_Lewiscat.txt,754,17,44,357,116,31,10,514
4609097_PostRiders.txt,1107,14,79,422,133,76,25,656
4609533_DavidWSommers.txt,733,15,48,350,77,26,6,459
4609938_UsRoute6InRhodeIsland.txt,1631,24,67,623,178,81,59,941
4611023_ListOfTownTramwayurbanTramwayStreetcarSystemsOceaniaNorthAmericaAndSouthAmerica.txt,19698,146,134,9354,298,206,113,9971
4612114_KlangWar.txt,628,14,44,291,79,31,13,414
461257_SocialCreditPartyOfCanada.txt,2834,54,52,1066,363,212,73,1714
4613795_SamirAlajani.txt,625,12,52,206,92,43,32,373
4614846_OrvilleByGibson.txt,2281,36,63,993,309,129,77,1508
4614883_CoventryBears.txt,578,20,28,257,73,23,18,371
4615977_1979InOrganizedCrime.txt,1208,3,402,600,146,44,14,804
461618_Whyytv.txt,629,13,48,294,51,52,14,411
4616563_MongolInvasionOfSyria1299.txt,721,23,31,253,99,34,30,416
461702_UnionCollege.txt,1393,10,139,735,108,85,36,964
4617652_BProtocol.txt,1378,20,68,464,238,105,60,867
4617838_AnnMaxwell.txt,1526,27,56,634,195,63,48,940
4618292_FrancisGrevemberg.txt,1446,26,55,583,190,88,30,891
4620378_GospiMassacre.txt,1552,25,62,549,226,90,39,904
4622542_ArchdukeJosefFerdinandPrinceOfTuscany.txt,642,11,58,242,82,29,15,368
4622546_DevotionalMedal.txt,4254,29,146,1331,569,365,210,2475
462284_ArnoldRothstein.txt,1238,16,77,501,182,52,32,767
4623754_NcaaSeason82.txt,2574,65,39,1233,274,122,44,1673
4625275_Elasund.txt,827,13,63,273,120,51,16,460
4626404_BoscoSevaKendra.txt,665,14,47,325,54,50,5,434
4626520_ListOfBpelEngines.txt,833,2,416,465,69,66,9,609
462707_Brush.txt,1933,31,62,572,293,199,103,1167
462721_ChalkboardGag.txt,781,8,97,283,124,23,44,474
4627420_RalphEDias.txt,666,18,37,335,58,30,13,436
4627429_IraqiSecurityForces.txt,2405,74,32,1090,266,148,31,1535
462782_CarlaBley.txt,778,12,64,368,73,54,17,512
462803_AaronBrown.txt,831,14,59,363,98,37,28,526
462813_SenateOfPoland.txt,727,14,51,432,45,20,6,503
4628697_DaveMccurdy.txt,580,13,44,268,60,31,6,365
4629123_ListOfStatutoryInstrumentsOfTheUnitedKingdom199610012000.txt,7028,21,334,5071,9,49,0,5129
4631313_RonAllen.txt,1060,13,81,503,95,90,30,718
4631463_MazinSalihMusaid.txt,928,21,44,333,167,27,30,557
4632350_TheWeaversAnswer.txt,712,15,47,262,93,60,29,444
4633666_SixSchoolsOfShaivism.txt,1288,27,47,490,152,106,50,798
4634014_Heavennightclub.txt,1390,27,51,550,177,108,78,913
463434_JudithAnderson.txt,1260,19,66,515,128,68,31,742
463439_GorchFock1933.txt,1310,23,56,443,192,64,49,748
463443_RiceBurner.txt,2628,36,73,975,370,240,126,1711
4635075_MarBaseliosCollegeOfEngineeringAndTechnology.txt,567,10,56,261,56,45,9,371
4635125_Odsherred.txt,946,12,78,302,110,90,49,551
463819_FernandoSor.txt,1125,13,86,417,91,62,25,595
463871_NewsProbe.txt,1822,68,26,738,216,137,37,1128
463873_AntipoloCity.txt,2073,35,59,814,278,90,37,1219
463876_TransportTycoon.txt,1341,22,60,469,195,131,49,844
463879_LordBelhavenAndStenton.txt,987,10,98,445,81,43,15,584
4638993_JosephVincentMoriarty.txt,910,11,82,317,132,52,28,529
463899_TheLancet.txt,645,11,58,251,79,51,16,397
463907_GeorgeFrisbieHoar.txt,833,20,41,344,103,37,19,503
4640039_ConsolidatedFilmIndustries.txt,654,6,109,355,41,28,4,428
4640651_SanssouciAtTheTimeOfFrederickWilliamIv.txt,692,8,86,229,85,51,30,395
4641720_SupplementalNeedsTrust.txt,2051,25,82,608,334,213,95,1250
4642860_AlimbicSystem.txt,606,9,67,211,93,53,24,381
4643899_CategoricalPerception.txt,3425,66,51,1260,436,269,169,2134
4643940_BuckFreeman.txt,740,9,82,222,106,42,18,388
4643942_Autismincidence.txt,2319,32,72,821,266,184,65,1336
4645616_PiedmontCastle.txt,385,3,128,121,60,44,19,244
4647702_ListOfNotableAfrikaners.txt,656,7,93,452,14,33,6,505
4647765_RajadirajaCholaIi.txt,630,14,45,244,83,29,13,369
464961_Couch.txt,764,15,50,240,104,83,40,467
464970_Khorramshahr.txt,1298,21,61,506,163,80,44,793
464989_UssHarderss257.txt,2411,31,77,879,351,148,84,1462
464990_StudentLoan.txt,4630,61,75,1600,676,434,193,2903
465001_700number.txt,1536,5,307,387,30,112,14,543
465004_CanadianFederalElection1957.txt,950,21,45,313,138,102,27,580
4651551_TheWoodlandsCemetery.txt,702,11,63,306,74,51,17,448
4651578_UssMckeandd784.txt,2160,25,86,861,294,84,64,1303
4652160_GameDevelopmentTool.txt,656,13,50,218,113,46,48,425
4652664_Eyecyclone.txt,2523,37,68,782,322,306,129,1539
4655583_SubmarineHull.txt,1108,14,79,380,171,133,61,745
465558_JoshGibson.txt,1123,16,70,422,140,88,36,686
465626_CaucasianRace.txt,1711,29,59,647,211,149,70,1077
4657709_ClubKidsoft.txt,879,13,67,313,138,78,26,555
4658806_Dinogetia.txt,620,13,47,248,75,43,23,389
466014_FitzsimonsArmyMedicalCenter.txt,615,7,87,268,68,44,11,391
4660306_Samikshavad.txt,501,28,17,218,47,24,1,290
4660412_EmilAugustFieldorf.txt,1146,21,54,410,164,64,26,664
466081_ListOfArcadeGames.txt,3800,30,126,3247,18,54,10,3329
466087_ApostolicAssemblyOfTheFaithInChristJesus.txt,3762,59,63,1536,465,276,131,2408
4662017_ListOfShotokanTechniques.txt,693,7,99,523,26,66,4,619
46628_AutomatedTellerMachine.txt,4795,102,47,1915,679,345,181,3120
46630_EmbeddedSystem.txt,2818,63,44,1022,424,306,100,1852
46631_FilmFormat.txt,1000,19,52,408,61,36,17,522
46634_Xenu.txt,5793,76,76,2197,874,308,212,3591
46636_Maoism.txt,2731,42,65,1026,326,232,92,1676
46638_DowJonesCompany.txt,608,15,40,360,44,34,15,453
46639_WorldCouncilOfChurches.txt,2081,44,47,890,224,117,31,1262
46652_EnricoBerlinguer.txt,2018,38,53,705,258,164,73,1200
46655_Buttocks.txt,2195,26,84,728,256,254,117,1355
46656_RadioTelescope.txt,903,12,75,344,108,98,26,576
4665791_Sfzero.txt,798,17,46,326,103,52,17,498
4665841_AttackOfTheAlligators.txt,643,10,64,262,91,22,28,403
466724_DavidWeissHalivni.txt,792,14,56,274,113,56,30,473
46672_HistoryOfWales.txt,5968,81,73,2120,764,382,196,3462
46674_BattleOfTours.txt,8909,91,97,3135,1221,575,334,5265
46675_Xylem.txt,1069,14,76,415,128,94,40,677
46676_BanachFixedPointTheorem.txt,748,32,23,243,109,55,23,430
46683_Amalfi.txt,768,13,59,284,88,47,17,436
4669688_IraqStudyGroup.txt,985,25,39,443,118,56,19,636
4669691_RobertMarlow.txt,572,15,38,233,73,33,22,361
4670317_DoesntRemindMe.txt,697,15,46,235,105,56,24,420
467096_NationalBuildingMuseum.txt,641,9,71,255,90,31,17,393
467099_Sderot.txt,1021,12,85,364,117,65,15,561
46709_CountyCork.txt,1097,19,57,515,103,66,24,708
467101_RufusThomas.txt,1446,26,55,553,180,90,39,862
467103_LittleWalter.txt,672,11,61,250,91,59,25,425
46710_FortTiconderoga.txt,1050,22,47,388,130,79,42,639
467121_Beatboxing.txt,3113,44,70,1275,428,253,116,2072
467124_MissionEarthnovel.txt,2248,35,64,864,298,158,68,1388
4671867_Kamiankabuzka.txt,2249,33,68,832,270,126,44,1272
4671986_TdrClassKn2.txt,598,17,35,212,86,38,19,355
46720_WilliamTecumsehSherman.txt,6437,71,90,2496,795,355,190,3836
46721_EdwardViiOfTheUnitedKingdom.txt,3927,57,68,1476,516,228,123,2343
4672449_ImLuffyTheManWhoWillBecomePirateKing.txt,1591,15,106,511,303,56,79,949
4672881_BandwidthManagement.txt,977,24,40,410,134,60,39,643
4673086_LothooNitharwal.txt,3580,55,65,1380,576,161,97,2214
46733_QueenMother.txt,912,22,41,363,126,32,53,574
46736_ErnestHollings.txt,839,18,46,311,107,48,22,488
46738_Goliath.txt,2255,38,59,774,338,105,73,1290
46742_Aiml.txt,780,37,21,342,108,69,20,539
46743_Heidelberg.txt,2445,44,55,1135,188,152,34,1509
4674748_HermanBall.txt,621,10,62,228,73,37,9,347
4675842_ListOfHamasSuicideAttacks.txt,705,109,6,409,37,15,7,468
4675848_AvengerPenguins.txt,626,13,48,356,60,25,12,453
4676744_JackMiner.txt,683,14,48,265,95,46,6,412
4677356_InternationalUnionOfForestResearchOrganizations.txt,988,26,38,456,92,79,17,644
467819_Slider.txt,680,10,68,267,90,38,34,429
4678440_ClanSmokeJaguar.txt,3896,51,76,1535,513,232,120,2400
4679648_Firaun.txt,1064,13,81,289,201,47,44,581
468185_FrancescoLandini.txt,851,19,44,283,124,58,34,499
468216_Umbreon.txt,1302,23,56,519,140,121,35,815
468224_CatskillMountains.txt,1907,52,36,730,221,141,83,1175
4682254_MorleyAHudson.txt,771,19,40,342,68,42,12,464
4684437_ListOfCharactersInMagicTheGatheringV.txt,605,16,37,223,91,39,18,371
4684444_ConformalCoating.txt,849,8,106,275,141,81,39,536
4685021_2006InAviation.txt,1082,25,43,522,80,51,14,667
4685487_LondonBachSociety.txt,707,9,78,260,95,50,17,422
4685680_PresidentialManagementFellowsProgram.txt,1336,26,51,572,164,85,18,839
4688249_HelgiTomasson.txt,849,6,141,340,96,52,12,500
4688446_GoosebumpstvSeries.txt,2487,15,165,1057,297,113,44,1511
468910_GeorgGottfriedGervinus.txt,656,8,82,208,74,59,17,358
468915_WhileLoop.txt,529,30,17,180,51,50,18,299
4689338_TurboTutone.txt,1287,8,160,433,190,56,41,720
4689919_AndinverterGraph.txt,871,21,41,353,118,102,19,592
4690567_MosaZiZemmori.txt,1553,39,39,548,286,73,51,958
4692085_RugbyUnionInTheUnitedStates.txt,1576,37,42,577,219,116,36,948
469283_Instapundit.txt,836,17,49,286,118,90,51,545
469285_PostalCountiesOfTheUnitedKingdom.txt,1353,37,36,592,156,86,55,889
469304_Latticeorder.txt,2766,73,37,970,350,248,101,1669
469313_Scioncar.txt,1011,22,45,398,126,89,37,650
4693186_Oversoul.txt,608,14,43,193,79,63,21,356
4693197_Gorleben.txt,1584,27,58,549,195,157,65,966
4693728_ListOfKorearelatedTopicsk.txt,762,15,50,610,33,31,2,676
4694434_StandardBooleanModel.txt,605,35,17,215,91,56,20,382
4694818_Extenxls.txt,533,12,44,248,63,34,8,353
4696040_ListOfRegisteredHistoricPlacesInGeorgiaAb.txt,841,18,46,800,1,16,0,817
4697847_XpressMotorsports.txt,731,9,81,272,120,28,12,432
4699516_MarineWingSupportSquadron271.txt,663,14,47,323,58,35,10,426
4699962_ChaeYeon.txt,867,17,51,350,100,70,39,559
470006_SueGrafton.txt,1451,24,60,546,228,85,34,893
470063_JohnTower.txt,2331,36,64,924,263,164,51,1402
4701197_EntropyarrowOfTime.txt,3923,37,106,1069,566,382,243,2260
470371_WesternArctic.txt,655,56,11,312,30,92,20,454
470378_ListOfFijirelatedTopics.txt,3600,43,83,2267,13,87,5,2372
470380_ProWrestlingUsa.txt,768,14,54,324,104,42,25,495
470408_Ampullariidae.txt,1060,12,88,445,116,96,43,700
4704481_LawEnforcementInSweden.txt,681,17,40,290,71,58,17,436
470450_RicGrech.txt,821,12,68,330,100,49,27,506
470473_SouthAfricanNavy.txt,686,33,20,383,72,22,16,493
470476_Hispanosuiza.txt,962,16,60,345,128,67,38,578
470482_SimulationsPublications.txt,786,13,60,281,109,72,30,492
4705005_FalunGongOutsideChina.txt,3288,51,64,1253,530,193,93,2069
4706011_UsnNasBermudaKindleyField19701995.txt,652,9,72,278,81,33,15,407
4707150_JamarcusRussell.txt,910,17,53,372,109,61,17,559
4707200_DowCentennialCentre.txt,969,21,46,447,113,79,26,665
4708717_GoldBoxGameplay.txt,3002,50,60,890,520,153,165,1728
4708896_AmcSchneiderP16.txt,732,9,81,251,82,65,21,419
47088_Nice.txt,1725,40,43,699,185,138,39,1061
47089_TheRegister.txt,719,16,44,287,101,59,30,477
4709336_FloatingTimeline.txt,1226,16,76,390,178,108,63,739
47096_FriedrichEngels.txt,1459,30,48,527,194,100,34,855
4711054_Leghari.txt,765,12,63,424,70,26,21,541
4711484_GirlsAloudOffTheRecord.txt,3092,26,118,953,539,159,172,1823
4713600_MsDemeanor.txt,996,10,99,327,173,41,48,589
4714686_IsaacBabalolaAkinyele.txt,942,11,85,355,119,64,21,559
471481_Wifebeatershirt.txt,834,18,46,324,129,52,48,553
471482_FuadChehab.txt,833,12,69,263,129,65,25,482
4714855_FreeAsABird.txt,1967,25,78,674,299,96,72,1141
4714867_HaroldArceneaux.txt,837,12,69,312,109,53,19,493
4714893_WalterEGaskin.txt,720,12,60,390,54,18,3,465
47153_LouisTheGerman.txt,1191,13,91,392,170,54,32,648
471544_Bladefilm.txt,2611,30,87,978,360,172,88,1598
47154_IvorNovello.txt,680,13,52,274,63,36,13,386
4715948_CultureAndTraditionsOfTheAteneoDeManila.txt,1943,42,46,724,258,116,73,1171
47160_GreenEconomics.txt,3349,57,58,1282,370,385,117,2154
4717457_LiljanaBishop.txt,788,18,43,252,153,49,36,490
4718550_Davissurname.txt,3411,24,142,2707,84,136,10,2937
4718707_MauryDeutsch.txt,683,8,85,240,95,34,30,399
47210_Vestamythology.txt,605,11,55,205,89,35,21,350
472126_Dxpedition.txt,733,16,45,246,112,74,41,473
472190_Toadfish.txt,566,11,51,226,54,51,18,349
47219_Europamythology.txt,1076,19,56,385,161,58,36,640
4722989_BobKelso.txt,1157,16,72,349,185,68,68,670
4722993_MonsignorDonovanHighSchool.txt,972,18,54,426,133,77,37,673
4723644_FaizMohammedAhmedAlKandari.txt,1294,19,68,505,204,65,41,815
472573_MadamCjWalker.txt,565,11,51,234,76,32,9,351
472610_UfotvSeries.txt,4783,50,95,1759,704,340,202,3005
4726212_ListOfFootballsoccerRivalries.txt,1941,47,41,1548,64,50,7,1669
4726322_TheRobArnieAndDawnShow.txt,5185,53,97,1773,777,282,285,3117
4726357_SecondOpinion.txt,800,9,88,296,134,29,39,498
472652_TheCityOfLostChildren.txt,924,20,46,369,130,49,24,572
472657_CajunFrench.txt,1306,20,65,537,181,118,50,886
472666_GreyfriarsBobby.txt,709,17,41,296,91,31,21,439
4726854_WinryRockbell.txt,946,8,118,280,161,50,70,561
4727431_NewYorkStateRoute39.txt,1282,21,61,570,81,63,36,750
4729560_JamesLevine.txt,803,12,66,332,71,48,24,475
4732425_ValuationUsingMultiples.txt,636,37,17,269,69,48,19,405
473284_CultivationTheory.txt,1713,39,43,652,198,139,50,1039
473287_WarrenWeaver.txt,834,11,75,290,85,73,36,484
473295_GreatCouncilOfChiefsfiji.txt,1059,15,70,367,146,63,34,610
4733424_MichaelNeary.txt,817,12,68,226,152,50,32,460
4733909_ConstantProportionPortfolioInsurance.txt,756,20,37,289,96,47,22,454
4733988_ListOfRegisteredHistoricPlacesInMissouriCountiesDi.txt,823,4,205,786,0,12,0,798
4734010_RoyalRhodesianAirForce.txt,1020,22,46,375,131,72,29,607
4734036_Kwtxtv.txt,1092,19,57,575,79,41,19,714
4736211_HistoryOfIdaho.txt,1979,28,70,722,258,171,65,1216
473664_AdorationOfTheMagi.txt,617,6,102,294,48,36,32,410
4736663_FreeWillytvSeries.txt,666,5,133,528,22,17,4,571
4736726_CaliberConversionSleeve.txt,684,10,68,228,97,48,47,420
473723_PeterBoyle.txt,1699,21,80,741,186,85,37,1049
473749_TheWaterboysalbum.txt,941,19,49,384,109,52,23,568
473752_SophieEllisbextor.txt,1119,20,55,424,139,69,34,666
4737756_MichaelAlmereyda.txt,638,9,70,286,77,29,15,407
4738979_NamesForGermany.txt,1809,35,51,638,244,157,73,1112
4739407_SpacecommercialCompetition.txt,701,27,25,189,116,59,31,395
4740018_NormalisationpeopleWithDisabilities.txt,590,10,59,245,67,45,16,373
4741728_InternalReconstruction.txt,5067,48,105,1376,654,584,280,2894
474383_TourismInArgentina.txt,954,25,38,462,80,64,16,622
474389_OregonBoundaryDispute.txt,2765,28,98,1018,325,207,103,1653
4744271_TheHuntForXavier.txt,645,13,49,201,100,53,35,389
4744984_MichaelCharlesGlennon.txt,796,14,56,264,120,49,23,456
4745424_Ayeshanovel.txt,1351,20,67,419,213,83,65,780
4745993_BermudaMilitia16871813.txt,1305,20,65,495,160,59,24,738
4745999_AdvancingPhysics.txt,690,22,31,272,92,43,14,421
4747751_RomanCatholicismInMyanmar.txt,1678,17,98,643,145,96,33,917
474844_Typosquatting.txt,1515,26,58,543,225,159,57,984
4751945_SeventhStreetImprovementArches.txt,561,6,93,207,81,41,12,341
475473_Sarov.txt,772,16,48,303,97,46,18,464
4757579_RegionalVariationInAustralianEnglish.txt,1071,22,48,404,141,115,57,717
4758127_FortiethUnitedStatesCongressStateDelegations.txt,2781,11,252,1299,185,331,11,1826
4758142_CityOfStone.txt,761,5,152,245,132,31,31,439
475847_HerbertYardley.txt,1114,18,61,408,153,80,46,687
475859_EdTownsend.txt,655,38,17,316,66,26,17,425
475861_Jalapeo.txt,610,10,61,204,117,46,19,386
4759205_MohammadDadkan.txt,620,9,68,221,94,40,29,384
4759293_YouCantScareMe.txt,875,9,97,260,119,58,67,504
475931_SebastianFranck.txt,862,9,95,310,93,41,23,467
4760302_TheCatholicChurchAndTheNicaraguanRevolution.txt,2746,30,91,948,354,204,84,1590
4760381_EcwOneNightStand.txt,683,11,62,371,76,18,2,467
4762037_KnightMediacomInternational.txt,614,8,76,329,49,62,7,447
4762040_NicaraguanLiteracyCampaign.txt,768,6,128,240,106,67,35,448
4762886_DanielWebsterJonesmormon.txt,648,11,58,263,81,26,13,383
4763128_SilviaDimitrova.txt,547,21,26,269,47,30,8,354
4763134_ListOfCodeLyokoMedia.txt,1068,17,62,365,167,76,34,642
476499_FalseProtagonist.txt,1085,19,57,359,165,54,59,637
4765213_AlabamaStateRoute14.txt,880,15,58,444,69,37,9,559
4765222_HotelFlorence.txt,617,11,56,228,95,29,13,365
476637_Berimbau.txt,1846,38,48,632,230,166,81,1109
4766716_ListOfNcaaPhilippinesBasketballChampions.txt,618,26,23,264,81,38,7,390
4766785_DcaOpenClassWorldChampions.txt,2181,46,47,1496,26,45,4,1571
4767974_BurnsideCountryFireService.txt,839,32,26,432,92,33,26,583
4769095_1997InNascarCraftsmanTruckSeries.txt,1584,110,14,1092,100,23,4,1219
4769112_AlienSpeciesInSonicTheHedgehog.txt,1254,21,59,410,193,98,55,756
476945_Fugu.txt,3820,48,79,1307,550,365,223,2445
476990_2004InGayRights.txt,3732,15,248,1623,448,288,58,2417
477026_Kriging.txt,1009,23,43,383,152,90,26,651
4770762_FirestopPillow.txt,974,19,51,297,176,69,56,598
477658_NakajimaKikka.txt,1428,32,44,593,147,83,37,860
4777136_NotableSeriesFinales1960s1970s.txt,1976,14,141,695,292,102,66,1155
47772_InstructionSet.txt,1897,31,61,791,248,184,68,1291
4778360_FntnaAlbIncident.txt,844,12,70,312,115,53,18,498
4778369_GirolamoBelli.txt,603,11,54,196,77,49,20,342
47789_QualityOfLife.txt,1465,17,86,572,177,127,58,934
47791_MarsProbeProgram.txt,1666,31,53,605,198,92,46,941
4779379_PierreContantDivry.txt,668,8,83,325,53,56,11,445
47795_VoyagerProgram.txt,1754,33,53,673,242,116,51,1082
47796_Patience.txt,664,21,31,221,95,53,30,399
47801_HmsPinafore.txt,3249,49,66,1199,441,207,110,1957
47804_Lithotriptor.txt,658,8,82,224,87,59,18,388
478065_PancakeSorting.txt,718,10,71,223,78,39,21,361
478078_BaJin.txt,1502,27,55,739,88,87,21,935
478114_AlohaAirlinesFlight243.txt,1126,19,59,418,158,66,33,675
478115_NewZealandCricketTeam.txt,1032,50,20,502,94,66,18,680
4781213_TaxationOfTrustsunitedKingdom.txt,911,15,60,286,134,55,28,503
478145_21JumpStreet.txt,1664,15,110,702,145,87,49,983
4784413_MatranFamilyOfShamizdin.txt,1924,29,66,719,228,107,97,1151
4784813_TentStateUniversity.txt,738,11,67,278,89,65,25,457
4784876_LosDeAbajo.txt,699,13,53,227,99,49,30,405
4786092_ClydeWright.txt,859,16,53,274,126,46,34,480
4786094_LiveFreeOrDietheSopranosEpisode.txt,1019,13,78,415,139,53,33,640
4786098_DavidCopperfieldcharacter.txt,1199,34,35,433,203,51,42,729
4787159_MedicalAlarm.txt,747,21,35,265,116,62,28,471
4789366_BestRevenge.txt,816,23,35,372,86,61,18,537
4790944_OrientationWeek.txt,1296,26,49,447,178,128,50,803
479125_Howstuffworks.txt,562,7,80,247,73,32,16,368
479132_WhatIfcomics.txt,1137,18,63,389,148,86,42,665
479186_Confrontation.txt,1146,32,35,432,143,118,36,729
479187_PortPirieSouthAustralia.txt,1013,19,53,399,145,74,29,647
479215_DonBoudria.txt,710,11,64,272,86,43,17,418
479221_AllSaintstvSeries.txt,1173,27,43,786,41,21,9,857
479234_MarkoMaruli.txt,678,9,75,256,83,53,23,415
4793230_SpinalCordStimulator.txt,776,23,33,313,114,81,15,523
4793576_Hyacinthe.txt,640,9,71,218,86,39,22,365
479842_AdventureGamesLive.txt,2626,39,67,951,303,205,102,1561
4798434_BodyOfFemur.txt,646,23,28,183,83,72,18,356
479905_BrainCandy.txt,1211,33,36,449,185,96,55,785
479907_UniversityOfRhodeIsland.txt,1119,20,55,723,58,45,14,840
479912_MKarunanidhi.txt,2573,34,75,1102,351,156,66,1675
4802474_PeterOconnor.txt,616,15,41,226,84,38,18,366
480283_SouthAfricanAirForce.txt,1274,27,47,606,134,67,14,821
480289_CollaborativeFiltering.txt,2080,25,83,766,282,216,68,1332
480290_SamuelPalmer.txt,1446,16,90,487,195,116,61,859
4805786_UniversityOfTheAssumption.txt,1843,40,46,954,128,61,28,1171
4806354_FritzleinsArimaaMaterialEvaluator.txt,551,17,32,212,58,45,18,333
4806379_ListOfAsteroids7590176000.txt,1331,1,1331,325,0,2,0,327
4807894_RobertLWilson.txt,666,18,37,295,71,26,14,406
4808463_FredDuesenberg.txt,1220,15,81,480,172,70,23,745
4808906_LaurelFallsTrail.txt,660,7,94,232,78,53,30,393
480936_DoctrineOfSignatures.txt,580,10,58,209,73,51,16,349
480939_Equalization.txt,836,13,64,282,128,83,34,527
4809630_AustralianRulesFootballInTheNorthernTerritory.txt,673,30,22,354,67,50,10,481
4811206_Bechukotai.txt,1092,12,91,324,158,63,22,567
4812305_StreetsweepersEntertainment.txt,942,4,235,766,4,7,4,781
4812392_TubeCleaning.txt,1240,14,88,418,187,116,53,774
4813388_TheDaVinciCodevideoGame.txt,582,12,48,244,71,28,21,364
481379_UssClaxtondd571.txt,780,14,55,327,92,31,12,462
4813833_OverTheHedgevideoGame.txt,628,15,41,234,70,36,26,366
4816127_MontaukPointLighthouse.txt,710,14,50,279,114,31,16,440
48180_HumanoidRobot.txt,2221,44,50,794,312,236,70,1412
4818316_Bburago.txt,787,8,98,227,135,62,49,473
48189_Surrey.txt,3050,31,98,1170,379,187,86,1822
48190_CommodityMarkets.txt,2918,50,58,1033,392,292,131,1848
4821570_StoParaPente.txt,1899,25,75,602,259,148,78,1087
4822026_Kotra.txt,517,6,86,335,20,26,4,385
48236_SaundersLewis.txt,807,14,57,361,74,34,14,483
482447_FamilyCoalitionPartyOfOntario.txt,697,16,43,269,79,74,25,447
48245_RALafferty.txt,2365,37,63,1180,185,83,54,1502
482461_GrammyAwardForBestHistoricalAlbum.txt,809,7,115,524,28,12,0,564
48246_SemidirectProduct.txt,1489,34,43,606,147,100,47,900
4825187_Ziu9.txt,725,14,51,242,91,89,26,448
4825870_PowerballexerciseTool.txt,841,13,64,295,114,62,30,501
4826940_KamenRiderGlaive.txt,594,4,148,233,95,23,20,371
4827127_WallenquistOrganization.txt,855,16,53,293,126,53,43,515
4827943_Smallvilleseason6.txt,3395,39,87,1435,484,110,80,2109
4828025_ListOfUnitedStatesSupremeCourtCasesVolume31.txt,600,3,200,309,2,0,0,311
4828042_VirginWebplayer.txt,584,17,34,206,102,39,31,378
4829037_NealHalsey.txt,1031,14,73,651,57,37,4,749
48296_Marburg.txt,1653,31,53,565,194,153,78,990
4830122_LivingWithWar.txt,650,14,46,313,62,33,14,422
4830334_TheGirlsOfOldTown.txt,977,18,54,342,142,55,48,587
48303_JohnIiiSobieski.txt,2002,33,60,771,216,122,60,1169
4830690_Nasoparsha.txt,1390,18,77,440,155,67,34,696
483120_ClosureOperator.txt,928,15,61,381,121,53,32,587
4831344_PartyForAFreeLifeInKurdistan.txt,583,12,48,239,84,33,12,368
4832874_InternalCounterintelligenceService.txt,917,9,101,318,173,53,42,586
4833984_CliveTyldesley.txt,702,9,78,294,78,40,20,432
4834002_NewYorkStateRoute63.txt,1018,20,50,354,94,80,28,556
4834169_TedSannella.txt,611,10,61,285,51,43,13,392
4834539_CaledoniaLandDispute.txt,3725,74,50,1416,513,161,107,2197
483507_PartiAcadien.txt,775,13,59,271,91,60,35,457
4835194_AustralianOlympicMedalistsInSwimming.txt,882,10,88,324,116,73,24,537
483548_ListOfAircraftOfTheCanadianAirForce.txt,535,4,133,384,15,11,6,416
483554_MarceloRos.txt,1177,31,37,434,174,70,20,698
483558_Yakuts.txt,580,14,41,253,65,46,15,379
4835622_2006AustralianFootballCodeCrowds.txt,10615,11,965,3803,17,503,6,4329
483566_JapaneseLaw.txt,1469,50,29,591,166,162,61,980
4835676_AbdulHafizterrorSuspect.txt,2065,43,48,630,465,61,70,1226
483589_Karachays.txt,636,15,42,260,63,43,20,386
4839033_AdeptusArbites.txt,902,17,53,336,127,56,39,558
4839663_VjvideoPerformanceArtist.txt,1531,31,49,677,194,136,45,1052
484280_Irlam.txt,643,9,71,221,87,48,38,394
4843281_SandraGilbert.txt,1493,30,49,656,121,124,36,937
4844594_ListOfUnitedStatesSupremeCourtCasesVolume82.txt,833,3,277,418,2,3,0,423
4845444_Koviar.txt,591,8,73,200,99,52,25,376
4845678_FrameAnalysis.txt,1276,16,79,577,142,91,15,825
484650_FunctionalNeuroimaging.txt,603,9,67,215,88,75,27,405
4846525_FunhousetheSopranosEpisode.txt,910,15,60,384,134,34,28,580
4849303_CanadianCoinage.txt,3122,42,74,953,466,230,126,1775
4850599_IbadanTankerTruckExplosion.txt,790,10,79,238,134,64,45,481
4852332_Rampagerapper.txt,597,10,59,242,65,42,23,372
485313_JohnSweeneylaborLeader.txt,5408,132,40,2288,660,322,130,3400
485315_IrishNominals.txt,2162,70,30,703,266,293,57,1319
4855536_PaulSFiddes.txt,806,36,22,374,52,31,7,464
4855897_ListOfNochiyaye.txt,1320,18,73,925,8,27,2,962
4857008_PAndACampbell.txt,599,7,85,222,78,34,20,354
4857009_BranchesOfMedicine.txt,2129,7,304,846,276,269,52,1443
485701_MehmedpaaSokolovi.txt,3681,53,69,1412,508,205,127,2252
485735_1837InCanada.txt,973,5,194,447,115,43,13,618
485779_Type21Frigate.txt,976,16,61,317,154,75,41,587
4858017_WooldoorSockbat.txt,1470,19,77,489,232,88,54,863
4858029_LastOfTheJediCharacters.txt,1293,25,51,434,239,64,37,774
4858705_TheSlicer.txt,1033,14,73,329,187,32,47,595
4862553_HeirsOfTheForce.txt,1043,17,61,370,156,50,43,619
4863250_StPancrasThameslinkRailwayStation.txt,796,10,79,332,100,45,21,498
4864703_JamesArcherjesuit.txt,2357,41,57,792,343,128,53,1316
4864727_SingaporeArmedForcesBand.txt,1112,25,44,601,92,59,22,774
486476_RodHull.txt,956,15,63,350,136,61,33,580
4864858_ThomasWilliamGlasgow.txt,1048,15,69,402,137,48,22,609
4864923_ThyDungeonmanIi.txt,1236,37,33,476,191,52,50,769
4865795_PietMondrian.txt,3839,43,89,1376,455,348,145,2324
4865936_TheyThinkItsAllOvertvSeries.txt,1726,15,115,670,252,79,37,1038
4867470_Deak.txt,786,4,196,333,109,49,23,514
486777_BankFraud.txt,3008,60,50,991,500,234,124,1849
486786_Postnet.txt,590,15,39,176,89,29,23,317
486809_DanielSchorr.txt,1012,20,50,441,117,38,19,615
486824_LostWoods.txt,819,19,43,282,127,59,34,502
486838_DornierDoX.txt,1221,27,45,450,163,81,36,730
486842_IdeologiesOfParties.txt,779,24,32,423,64,71,27,585
486848_Hectograph.txt,601,9,66,191,87,62,31,371
486851_BiffTannen.txt,2411,25,96,722,409,138,131,1400
486865_GrandTrunkRailway.txt,1778,23,77,743,200,126,43,1112
4872359_WilliamGrantgeneral.txt,1175,19,61,423,159,59,28,669
4873419_GovernmentOfDetroitMichigan.txt,718,15,47,300,87,60,20,467
4873450_AdministrativeDivisionsOfFrenchPolynesia.txt,619,21,29,291,41,52,16,400
4874525_JaloreFort.txt,929,34,27,324,127,70,32,553
487492_CryptographicallyStrong.txt,629,9,69,188,97,62,49,396
4875105_FallenEarth.txt,891,25,35,381,92,72,22,567
487561_RobertFKennedyMemorialStadium.txt,3194,32,99,1431,324,164,64,1983
4877283_UsbHumanInterfaceDeviceClass.txt,1269,32,39,529,161,102,42,834
4877371_NorthwestAfternoon.txt,594,15,39,270,74,40,17,401
4877373_ShutterthaiFilm.txt,1384,22,62,416,246,48,73,783
4877461_FerenezeGolfClub.txt,1153,51,22,415,116,95,41,667
4878938_AchinoamNini.txt,1375,27,50,663,119,76,24,882
487944_RobertNixon.txt,1946,27,72,662,270,121,63,1116
4879636_Runabouttransformers.txt,943,13,72,313,163,39,29,544
487989_Vajiravudh.txt,898,19,47,334,117,68,27,546
4879958_ArturPhleps.txt,1054,22,47,449,103,74,23,649
4882779_ArtifactcomputerGame.txt,982,41,23,339,168,51,36,594
4884487_HistoryOfTheInca.txt,1753,35,50,652,246,99,56,1053
4886098_Cd64.txt,907,10,90,299,149,58,37,543
48872_Scombridae.txt,559,7,79,348,33,40,6,427
48874_HugoChvez.txt,9570,104,92,3637,1324,772,259,5992
48877_CodeTalker.txt,1337,15,89,585,179,92,57,913
48891_JoeDimaggio.txt,3101,47,65,1146,481,177,95,1899
48895_EmbodiedPhilosophy.txt,806,15,53,312,79,84,38,513
48896_Lyrebird.txt,1813,31,58,662,229,165,69,1125
48897_ParticleAccelerator.txt,2260,39,57,831,331,201,92,1455
4889835_PhanRangAirBase.txt,2318,74,31,1073,207,177,33,1490
4890047_BattleOfItaleni.txt,922,22,41,295,147,37,28,507
48903_Nucleosynthesis.txt,1535,17,90,540,197,162,44,943
489064_C124GlobemasterIi.txt,1096,10,109,432,151,62,30,675
489072_SouthernSami.txt,590,31,19,261,58,67,16,402
489074_FriedrichList.txt,3059,27,113,965,371,286,125,1747
489079_Swiftlet.txt,2017,32,63,871,252,186,70,1379
48907_RulesOfChess.txt,2225,36,61,645,397,139,111,1292
48908_RetrogradeAndDirectMotion.txt,1452,21,69,423,213,156,65,857
4890927_AirlinesOfNewSouthWalesPtyLtdVNewSouthWalesno2.txt,708,17,41,274,83,50,15,422
48910_Horizon.txt,972,25,38,315,104,81,33,533
4891153_HistoryOfMachineTranslation.txt,1685,35,48,587,224,150,60,1021
48913_CarolineOfBrunswick.txt,886,15,59,311,133,55,38,537
48918_AlexandraOfDenmark.txt,1204,23,52,438,165,78,52,733
4892673_PalmM500Series.txt,775,15,51,365,63,58,11,497
4894332_JyuOhSei.txt,1285,26,49,489,217,59,32,797
4895341_MsnChat.txt,624,24,26,287,90,24,21,422
4896067_PennsylvaniaCoalCoVMahon.txt,856,8,107,333,101,53,19,506
4896437_MohamedAbdullahAlHarbi.txt,735,23,31,238,147,25,24,434
489678_H2manga.txt,1192,21,56,475,175,72,42,764
489748_Coprolalia.txt,651,10,65,216,91,71,35,413
489750_Tic.txt,691,19,36,256,99,92,34,481
4897528_TrueLife.txt,734,16,45,308,73,31,6,418
489752_GeneviveBujold.txt,719,13,55,312,55,49,12,428
4898649_TourDeGeorgia2006.txt,528,22,24,383,11,18,4,416
490120_GothaG.txt,1159,23,50,421,163,97,31,712
490129_TheSpyWhoLovedMe.txt,1138,15,75,442,159,66,41,708
490134_ConnectedSum.txt,913,40,22,276,127,69,39,511
490135_HomologicalConjecturesInCommutativeAlgebra.txt,733,3,244,306,76,84,34,500
490160_TurinBrakes.txt,834,20,41,318,114,67,29,528
4902493_DuneboardGame.txt,1006,25,40,357,154,55,25,591
4904150_OudeKerkamsterdam.txt,843,14,60,291,148,41,24,504
490771_BlackBeltmartialArts.txt,717,9,79,211,107,88,53,459
490783_IndianRupee.txt,2091,40,52,729,283,121,57,1190
4909106_BadBadRubberPiggy.txt,693,10,69,228,106,51,34,419
4909675_JeffScurran.txt,663,11,60,279,70,47,27,423
4910775_TheGreenTable.txt,1135,18,63,381,146,92,36,655
491220_AshburtonNewZealand.txt,714,14,51,359,76,48,21,504
491221_Electrowetting.txt,599,7,85,205,75,73,20,373
491222_CommodoreSmoker.txt,1337,18,74,407,229,70,75,781
4912478_DorisEatonTravis.txt,1050,19,55,438,117,49,22,626
491253_HongKongMuseumOfMedicalSciences.txt,599,18,33,239,74,41,12,366
491257_MaximilienDeBthuneDucDeSully.txt,1181,16,73,364,146,94,41,645
4912829_ActuariesSocietyOfIndia.txt,1320,32,41,535,143,118,33,829
4912836_CultureOfBahrain.txt,1045,32,32,378,172,108,41,699
4912876_QueenslandRoarFc.txt,2026,47,43,782,230,132,54,1198
4914598_TheTransformerstvSeries.txt,6320,99,63,2327,897,375,234,3833
4915017_SuperRobotWarsOriginalGenerations.txt,821,13,63,355,104,62,30,551
4915621_PhilosophiesOfMilanKundera.txt,3335,35,95,939,490,275,160,1864
4915648_FranoSupilo.txt,1386,21,66,509,140,106,32,787
4918004_StephensonPercySmith.txt,1547,14,110,594,169,98,39,900
4918889_SteatodaGrossa.txt,587,10,58,222,82,61,20,385
491936_Pilates.txt,1504,20,75,502,246,112,74,934
4919457_PhishAndTheirMusic.txt,1551,11,141,498,188,215,97,998
4921637_CatherineMayer.txt,691,10,69,211,114,32,35,392
4921661_MahmoudZoufonoun.txt,1058,22,48,395,109,124,45,673
4921759_CornerDetection.txt,2753,66,41,936,393,213,128,1670
492302_FiveChildrenAndIt.txt,682,16,42,241,78,33,25,377
492315_BudweiserRocket.txt,603,11,54,209,97,35,25,366
492318_Branchdisambiguation.txt,643,12,53,350,31,51,7,439
4923328_TheHusband.txt,1042,12,86,270,242,30,58,600
492347_BeneIsrael.txt,561,12,46,252,52,39,14,357
4924311_VictoriaNationalGolfCourse.txt,689,21,32,264,50,18,2,334
4926605_NickWolfe.txt,912,13,70,317,137,52,38,544
4927587_NoSpringForFrazer.txt,668,15,44,223,120,19,31,393
4928168_UssRichmondKTurnercg20.txt,1207,27,44,578,121,47,18,764
4928801_MurasameLiger.txt,1199,27,44,423,169,109,40,741
493033_MediaInSweden.txt,1287,26,49,538,163,117,26,844
4930475_ListOfQuotesFromShakespeareInBraveNewWorld.txt,961,33,29,397,89,76,36,598
4931601_FollowForNow.txt,757,14,54,291,98,64,26,479
4931672_ListOfTzZonesByName.txt,2193,16,137,1314,21,240,23,1598
4932111_Capacitor.txt,4071,90,45,1400,584,417,171,2572
4933091_ContemporaryArtMuseumStLouis.txt,793,43,18,387,86,50,9,532
4933143_NaplesEasternUniversity.txt,654,11,59,286,56,69,11,422
4933146_MySuperExgirlfriend.txt,2373,33,71,780,383,103,93,1359
49331_Patchwork.txt,1123,11,102,395,199,102,49,745
493352_HenryBacon.txt,684,28,24,411,44,29,10,494
493381_JohnDillon.txt,1069,16,66,378,131,64,31,604
493403_DifferentialGeometryOfCurves.txt,1419,117,12,494,202,141,35,872
493408_Scaramouche.txt,1051,13,80,359,144,70,30,603
4935521_ListOfXmenEvolutionCharacters.txt,6260,19,329,1912,962,613,293,3780
4936616_OperationLobsterI.txt,984,20,49,391,158,49,28,626
49387_IbmDeepBlue.txt,1369,19,72,564,180,97,47,888
4939267_LowRhenish.txt,1109,15,73,447,102,103,37,689
4939357_SechsKies.txt,1378,19,72,497,181,91,47,816
493992_LatinHonors.txt,1185,21,56,459,151,85,38,733
493994_WillyMillowitsch.txt,827,11,75,256,109,68,43,476
4941926_DonPreston.txt,1088,21,51,555,68,51,21,695
4942028_MineClearanceAgencies.txt,1235,42,29,563,155,100,24,842
4944013_Summoner2.txt,834,27,30,264,129,55,43,491
494448_RollinsCollege.txt,1633,42,38,778,149,116,31,1074
4946462_TomPapania.txt,936,10,93,298,160,40,33,531
494664_RuthPrawerJhabvala.txt,991,21,47,504,65,46,10,625
494665_Foxtel.txt,1757,34,51,915,124,92,48,1179
494671_OptusTelevision.txt,2054,43,47,957,180,109,55,1301
4948205_iNeverPromisedYouARoseGarden.txt,582,6,97,201,82,50,25,358
4948739_Kateda.txt,5444,67,81,1811,840,447,236,3334
4949939_KeynshamTownFc.txt,760,32,23,302,98,36,20,456
4950937_MarineAircraftGroup42.txt,624,15,41,299,60,35,8,402
4951410_HuntersFromHunterHunter.txt,2332,40,58,719,355,183,97,1354
4951504_NormanKerry.txt,1024,12,85,443,85,49,18,595
495343_PortugueseIndia.txt,1237,18,68,440,176,94,38,748
4953513_PakistaniCricketTeamInEnglandIn2006.txt,1534,41,37,550,215,98,35,898
495373_TimeOfTroubles.txt,955,14,68,336,140,59,23,558
495383_RandomizedAlgorithm.txt,1826,33,55,621,292,176,80,1169
495385_ArmyOfTheShenandoahunion.txt,577,19,30,258,56,24,17,355
495395_AdventureSoft.txt,577,14,41,247,77,37,20,381
4954087_DiamondsAsAnInvestment.txt,1634,26,62,568,242,152,83,1045
4954769_PieceOfMyHeart.txt,776,18,43,345,81,61,24,511
4954774_Cleopatra1963Film.txt,3097,38,81,1066,499,174,111,1850
4955406_AmericanEagleAirlinesDestinations.txt,940,5,188,886,4,26,1,917
4956266_FirstNationsGovernmentcanada.txt,733,11,66,293,80,58,26,457
4956334_PathtiqueSonataInPopularCulture.txt,695,8,86,275,83,66,14,438
4956886_DarkBeginning1.txt,739,6,123,567,11,9,1,588
4957332_JimWilsonwrestling.txt,1109,14,79,388,184,52,38,662
4957476_MagnumResearchBfr.txt,729,9,81,278,66,44,18,406
4957575_PakistaniBlogosphere.txt,6154,153,40,1964,977,453,319,3713
495758_CultureOfCostaRica.txt,2431,46,52,846,360,240,129,1575
4963082_EdBoyce.txt,2892,50,57,1151,390,131,64,1736
4964069_EpiscopalHighSchoolbatonRougeLouisiana.txt,639,17,37,306,64,40,19,429
4964076_WarlordUk.txt,888,14,63,365,118,48,45,576
496472_Llanero.txt,749,28,26,291,99,53,16,459
496474_CrayonShinchan.txt,6407,46,139,2549,787,467,272,4075
4965161_CasteSystemInKerala.txt,755,18,41,259,108,69,29,465
4967816_CapitalPunishmentInJapan.txt,1644,20,82,524,263,107,63,957
4967841_FatestayNightScenarios.txt,6115,67,91,2077,1051,280,267,3675
4967967_JohnLouisNuelsen.txt,769,11,69,306,83,49,23,461
496924_NorthernMarch.txt,879,16,54,337,105,55,27,524
4972673_JeanedernHallier.txt,916,26,35,310,129,85,28,552
4972737_DemographicsOfLondon.txt,690,15,46,231,64,73,24,392
4973950_RodneyCombs.txt,1341,22,60,415,186,111,55,767
4973967_Knjaevac.txt,839,25,33,321,89,89,14,513
497524_Midgar.txt,1660,23,72,591,252,111,57,1011
497525_GrandTheftAutoSanAndreas.txt,3708,58,63,1550,464,293,106,2413
497559_SovietSubmarineK159.txt,772,16,48,305,107,38,24,474
497562_April2004.txt,833,4,208,379,69,30,8,486
497564_Zooropa.txt,1169,23,50,476,137,67,51,731
497567_Agumon.txt,775,12,64,307,99,65,29,500
497572_TheLegendOfZeldaOracleOfAges.txt,1216,20,60,448,174,71,35,728
497575_TheRedheadedLeague.txt,604,11,54,199,87,41,24,351
4976079_NedisSerbia.txt,1001,21,47,396,124,61,28,609
4976663_CatopsiliaPyranthe.txt,673,12,56,227,61,75,54,417
4977751_FelineCalicivirus.txt,566,9,62,200,92,62,33,387
4979262_KotlinClassDestroyerproject56.txt,537,11,48,209,61,34,7,311
4979492_TheJesusRecord.txt,1106,19,58,636,87,36,16,775
4981453_MarleneLehnberg.txt,2338,34,68,771,424,93,78,1366
4982022_Dungdkar.txt,900,22,40,333,109,80,28,550
4982675_GetAMac.txt,3627,55,65,1321,585,180,135,2221
4983775_WonderBoyvideoGame.txt,1563,30,52,565,202,96,49,912
4984388_FlashmanInTheGreatGame.txt,1072,9,119,407,134,49,48,638
4985419_ShowChoir.txt,1521,26,58,520,208,156,92,976
4985422_Chevrolet150.txt,775,30,25,290,86,111,24,511
498611_NileDelta.txt,593,10,59,248,70,38,18,374
498639_ListOfFinalFantasyViiTerms.txt,1704,27,63,624,247,99,53,1023
4986527_TheMusicalComedyMurdersOf1940.txt,852,18,47,301,150,50,39,540
4986542_HarryDahms.txt,643,6,107,291,47,43,10,391
498673_SigmaNu.txt,5189,125,41,2414,557,289,137,3397
498727_GrowthRategroupTheory.txt,647,24,26,212,77,75,22,386
4989310_AsymmetryOfLift.txt,701,7,100,232,89,70,20,411
499033_RoverMetro.txt,2679,32,83,866,377,202,104,1549
499041_AkzoNobel.txt,808,16,50,456,68,49,5,578
4992585_SongChonggug.txt,647,12,53,221,93,41,33,388
4993017_TheBeachBoysDiscography.txt,941,15,62,377,102,61,32,572
49942_Theurgy.txt,810,21,38,288,100,68,35,491
4995347_ZoroastrianAngelology.txt,630,16,39,223,89,45,16,373
4995921_FireInTheAbyss.txt,687,14,49,261,85,63,28,437
49964_Sequoia.txt,1910,23,83,719,235,187,73,1214
49966_CarlosMenem.txt,1669,23,72,607,216,134,42,999
4996832_IndianapolisMotorSpeedwayRadioNetwork.txt,829,10,82,329,106,48,27,510
49968_Lviv.txt,2547,57,44,957,273,259,76,1565
4997017_HumanBiocomputer.txt,512,13,39,205,56,42,10,313
49972_Rosicrucian.txt,5718,60,95,2181,626,427,161,3395
49973_CensorshipUnderFascistRegimes.txt,1494,28,53,416,254,147,98,915
499767_StandardCharteredBank.txt,1450,33,43,599,150,90,28,867
49976_Chrysoberyl.txt,822,16,51,285,120,93,32,530
4997990_ThelmaEllenWood.txt,741,17,43,236,124,62,32,454
499809_Sarsaparilla.txt,1909,26,73,707,291,194,77,1269
5000645_BradleyKasal.txt,793,17,46,354,95,33,10,492
500135_Marcus.txt,817,26,31,504,45,47,17,613
500205_Thurible.txt,626,20,31,203,81,65,20,369
5003397_SouichiroNagi.txt,2562,28,91,868,426,137,109,1540
5006149_Devan.txt,671,23,29,291,79,37,20,427
5007449_CycloneOlaf.txt,969,17,57,381,125,78,30,614
5007474_EllipticCylindricalCoordinates.txt,514,26,19,157,61,65,12,295
5007872_EdwardCraigie.txt,659,11,59,259,77,43,19,398
5008351_PineBarrensSpeculation.txt,822,5,164,546,24,10,7,587
5008548_MerrittchapmanScott.txt,1951,31,62,735,282,113,54,1184
500860_BonavistaNewfoundlandAndLabrador.txt,822,22,37,322,105,63,23,513
500868_FrederickHauck.txt,1340,17,78,743,99,42,3,887
5010628_AndhraKshatriyaCustoms.txt,846,21,40,298,117,56,24,495
5011715_KumarMangalamBirla.txt,1034,19,54,527,74,38,8,647
5011716_TheBloodyBattleOfBayamon.txt,803,14,57,288,141,40,23,492
5012301_ScientologyAsABusiness.txt,898,24,37,322,115,55,25,517
5013244_PeoplesLiberationOrganisationOfTamilEelam.txt,610,11,55,245,77,40,17,379
5013280_TourismInBosniaAndHerzegovina.txt,550,22,25,262,40,30,11,343
5015591_OperationMeghdoot.txt,1093,15,72,394,144,73,37,648
5016167_TheJuniorMint.txt,685,13,52,236,113,29,30,408
5017038_SilverbergFamily.txt,785,15,52,272,115,45,33,465
5017253_UnionSquareBaltimore.txt,2447,35,69,1043,257,186,46,1532
5017257_Oozinator.txt,693,15,46,250,102,61,23,436
5017287_TuiHaatakalaua.txt,829,4,207,299,118,41,40,498
5018334_JohnBordenaveVillepigue.txt,583,13,44,236,66,30,17,349
5019445_WhitecapstheSopranosEpisode.txt,2342,24,97,841,412,66,76,1395
5020020_JohnConnollyrugby.txt,705,10,70,239,94,38,20,391
5021087_AbrahamaviLoeb.txt,1500,21,71,538,172,138,33,881
5022202_EdouardAlphonseDeRothschild.txt,1115,15,74,438,122,54,18,632
5023197_MensRoleInChildbirth.txt,747,10,74,230,117,66,38,451
5023281_JeanSagal.txt,1005,8,125,391,145,72,45,653
5023289_DaltonPrejean.txt,1143,17,67,355,208,61,28,652
502328_PaulDScullypower.txt,614,17,36,275,71,43,3,392
5023874_NicholasFSeebeck.txt,635,11,57,215,84,58,22,379
5023881_BostonUniversityHousingSystem.txt,2583,33,78,1020,324,224,85,1653
5024972_OperationEdelweiss.txt,554,7,79,239,63,35,6,343
503010_BubbaTheLoveSponge.txt,4332,54,80,1632,680,237,149,2698
503013_XekongProvince.txt,1389,14,99,454,202,141,65,862
5032671_FutureDib.txt,1569,14,112,496,260,69,86,911
5033547_FavianVergara.txt,498,14,35,305,19,28,9,361
5036398_MassimoVignelli.txt,606,10,60,306,44,26,6,382
5037435_FigureMoeZoku.txt,1276,23,55,465,203,86,43,797
5038599_ArthurJJackson.txt,840,15,56,365,79,45,23,512
5040698_NedTouchstone.txt,1155,23,50,476,151,79,38,744
504090_Swedenfinland.txt,765,11,69,238,91,62,40,431
504093_Imaginos.txt,1432,18,79,533,194,77,33,837
504131_GibsonLesPaul.txt,3061,39,78,1153,418,269,123,1963
504133_Assimilationlinguistics.txt,1224,22,55,426,137,107,57,727
504145_FordOrion.txt,709,9,78,257,83,54,26,420
50419_FormOfGovernment.txt,1684,17,99,701,177,154,54,1086
5042239_OtherVesselsInTugs.txt,763,21,36,274,113,45,21,453
5042460_CageRage.txt,1610,36,44,596,233,120,38,987
50425_QuantumHallEffect.txt,593,8,74,244,72,45,19,380
5043452_TheDaVinciCode.txt,5887,78,75,2403,723,317,171,3614
504513_LendaMurray.txt,764,11,69,336,47,36,9,428
5045232_CornishEmigration.txt,617,11,56,251,62,44,17,374
5046331_DutchInventionsAndDiscoveries.txt,3045,43,70,1050,433,272,105,1860
50473_Gargoyle.txt,1269,32,39,494,179,95,42,810
5047413_ArmyOfPeru.txt,1783,40,44,824,118,157,19,1118
5047425_LincolnHighSchoolsiouxFalls.txt,681,12,56,449,47,28,8,532
50477_MartialLaw.txt,2554,42,60,944,339,223,69,1575
50478_HanVanMeegeren.txt,5972,77,77,2407,701,307,127,3542
5048408_AzerbaijanMinistryOfNationalSecurity.txt,1354,9,150,554,105,144,14,817
5048_BrighamYoung.txt,2006,22,91,801,222,94,51,1168
5049009_BartonHWatson.txt,717,7,102,278,89,37,21,425
5049_BurnsSupper.txt,1114,27,41,350,169,72,64,655
5050_BillBryson.txt,933,23,40,395,77,52,30,554
505181_RoyalVictoriaDock.txt,634,8,79,227,94,41,21,383
505189_Continuation.txt,1169,24,48,585,99,76,31,791
5051_BigAudioDynamite.txt,690,17,40,312,65,46,17,440
505224_AlbertLee.txt,1328,30,44,684,137,61,30,912
505225_IteratedFunctionSystem.txt,758,31,24,263,90,60,25,438
5052_Bentley.txt,1147,22,52,497,113,74,38,722
5054833_YugiohGxDuelAcademy.txt,844,25,33,409,82,35,17,543
5056111_GrossmontHighSchool.txt,719,20,35,391,87,44,14,536
5056681_FeelTheForce.txt,833,8,104,292,148,44,30,514
505670_HelenReddy.txt,1637,21,77,636,182,103,65,986
5057773_NathanThompson.txt,631,13,48,209,98,35,17,359
5059992_SlingsbyT67Firefly.txt,632,23,27,252,89,47,9,397
5061539_HistoryOfPedophileActivism.txt,2227,27,82,875,233,196,68,1372
506281_RomulusDerGroe.txt,1631,40,40,537,253,88,80,958
506295_CathyDennis.txt,1072,16,67,467,123,70,35,695
506318_Belgae.txt,1622,18,90,556,232,105,60,953
506331_FordTransit.txt,1467,29,50,566,198,124,48,936
506350_RemingtonArms.txt,1000,34,29,439,123,67,30,659
506388_IanAndSylvia.txt,1019,20,50,342,153,93,35,623
506389_DisneysGrandCalifornianHotelSpa.txt,634,12,52,294,73,35,12,414
5065281_Avicephala.txt,745,11,67,322,70,72,24,488
5065383_LincolnBurrows.txt,1573,24,65,621,253,58,40,972
5065403_FernandoSucre.txt,1097,19,57,395,175,56,32,658
506694_JeffreyDeFourestier.txt,1852,25,74,766,203,124,47,1140
506695_ListOfHerculesAndXenaCharacters.txt,2643,45,58,954,423,135,78,1590
506701_Trustee.txt,839,14,59,295,102,68,30,495
5068093_TheLastKiss.txt,1243,23,54,457,196,66,47,766
5070646_KotaroFuumaworldHeroesCharacter.txt,1225,19,64,412,174,96,60,742
5071751_MatthewLipman.txt,727,45,16,405,47,23,5,480
5071878_WomenOfTheWall.txt,1296,21,61,477,174,84,44,779
5072312_BerlinBorderCrossings.txt,2156,39,55,963,217,183,63,1426
5072353_ListOfChineseAmericanAssociations.txt,333,4,83,252,1,13,1,267
5072365_SpouseOfThePrimeMinisterOfAustralia.txt,576,39,14,288,56,21,9,374
5073623_MikeLong.txt,713,8,89,273,95,54,26,448
507431_ProductionIg.txt,1374,31,44,574,171,113,37,895
507433_kerCasillas.txt,742,12,61,288,88,47,20,443
507450_Dvorakgame.txt,580,15,38,185,102,42,26,355
507485_GrannyWeatherwax.txt,1688,20,84,487,291,113,94,985
507486_NannyOgg.txt,865,13,66,279,133,61,47,520
5075524_VanguardCollegePreparatorySchool.txt,585,20,29,263,61,52,10,386
5075621_FatTax.txt,678,16,42,267,91,56,11,425
5076174_Bioarmour.txt,666,10,66,220,96,98,31,445
5077278_ListOfPeterGriffinsJobs.txt,1243,27,46,553,115,60,41,769
507791_MileaminuteWeed.txt,733,10,73,237,106,106,25,474
507794_VideoProjector.txt,651,10,65,271,73,75,33,452
507796_HmsUgandac66.txt,1487,17,87,570,228,78,28,904
5078515_YouOnlyLiveTwicefilm.txt,2573,33,77,1052,366,157,101,1676
507857_MercedesbenzClsclass.txt,1078,27,39,437,131,78,20,666
507859_LouisSlotin.txt,1188,19,62,430,168,75,40,713
507928_InfernooperatingSystem.txt,560,19,29,253,74,41,20,388
5081127_ScottSpecial.txt,1538,25,61,557,189,114,37,897
508521_GlosterJavelin.txt,962,14,68,353,131,72,25,581
508527_Annecy.txt,866,21,41,347,78,67,12,504
508528_AmberTamblyn.txt,767,17,45,294,115,36,18,463
508559_2004InAviation.txt,561,17,33,287,36,32,8,363
5088154_TheMelammuProject.txt,1128,13,86,438,91,125,27,681
5088781_IlluminationAndRangoli.txt,750,16,46,230,118,46,28,422
5089370_LondonBusesRoute47.txt,756,11,68,397,74,25,23,519
5089448_ShahidHussainBokhari.txt,920,10,92,523,27,12,8,570
508952_GenjoSanzosaiyuki.txt,894,12,74,275,160,54,41,530
5089814_FrancisMartinOdonnell.txt,2535,66,38,1265,176,149,41,1631
5089817_TheBigParadedadsArmyEpisode.txt,618,13,47,207,109,29,19,364
5089819_AtmosphericModels.txt,848,31,27,320,106,81,34,541
509021_OysterCard.txt,2879,55,52,1043,427,179,94,1743
5090909_GordonBeveridge.txt,555,16,34,280,31,10,5,326
5090940_WoodburyCommonPremiumOutlets.txt,722,11,65,281,88,63,31,463
5090956_AdministrativeDivisionsOfNovosibirskOblast.txt,551,2,275,228,0,16,0,244
5091113_TenMaskedMen.txt,707,16,44,393,68,29,17,507
5092142_LaboratoryOfMolecularBiology.txt,1759,29,60,660,261,142,28,1091
5092604_KeitaIijima.txt,637,14,45,217,106,19,24,366
5094787_ThePoseidonAdventure.txt,1123,16,70,439,146,56,36,677
5095880_FieldCathedralOfThePolishArmy.txt,1122,19,59,370,144,90,48,652
509619_TheRippingFriends.txt,1311,11,119,444,204,62,44,754
509620_IntercontinentalCupfootball.txt,748,27,27,307,82,46,25,460
5097759_VoxAc30.txt,824,8,103,364,81,59,22,526
5099655_KingVJones.txt,1550,30,51,492,242,86,55,875
5099728_HistoryOfYork.txt,1583,25,63,554,209,115,48,926
510040_TbdDevastator.txt,895,16,55,314,113,64,39,530
5100737_LebanonCountrysideTrail.txt,664,21,31,269,72,42,21,404
5101329_DontForgetTheDiver.txt,635,10,63,216,102,19,24,361
5102499_WikipediaInPopularCulture.txt,1216,33,36,516,165,62,34,777
51032_Braunschweig.txt,1372,23,59,546,142,135,33,856
5103474_Tamala2010APunkCatInSpace.txt,763,14,54,293,104,47,17,461
5103484_GlbttqCommunityCentreOfOttawa.txt,1027,21,48,396,146,69,23,634
51045_GuidedRat.txt,628,10,62,226,97,53,29,405
5104699_AdvancedDungeonsDragonsTreasureOfTarmin.txt,1042,21,49,350,147,60,47,604
5105151_Debugdiag.txt,38,1,38,16,8,1,1,26
51053_PsychoanalyticLiteraryCriticism.txt,716,26,27,324,64,76,16,480
51054_AmericanBlackBear.txt,4349,43,101,1450,673,374,238,2735
5106249_HealthProfessionalsAndAlliedEmployees.txt,1268,29,43,476,163,93,36,768
51062_Sewer.txt,1232,21,58,480,183,90,48,801
51067_Anomie.txt,754,12,62,256,100,73,29,458
5106875_OregonDailyEmerald.txt,1850,53,34,838,206,91,26,1161
5106877_Antrc97aRadio.txt,596,11,54,214,90,36,23,363
51072_NaturalDeduction.txt,5273,149,35,1730,641,552,207,3130
51074_PeterKropotkin.txt,2114,25,84,737,232,148,63,1180
51078_Thalidomide.txt,3721,53,70,1321,565,321,132,2339
51079_Magnet.txt,2975,56,53,973,409,321,120,1823
5108441_PirManghoUrs.txt,1211,16,75,427,159,110,48,744
5109717_StStanislausCollege.txt,1828,63,29,664,217,130,35,1046
5110027_JohnGAlthouseMiddleSchool.txt,887,14,63,437,108,49,19,613
5110098_GandalaraCycle.txt,978,14,69,374,106,70,22,572
5110114_SomewhereOnlyWeKnow.txt,1557,32,48,552,212,139,64,967
511201_Russification.txt,5145,61,84,1766,599,507,159,3031
5112314_ReginaFierro.txt,606,5,121,245,62,47,11,365
5115174_ListOfBCodesForMesh.txt,2344,5,468,1127,136,95,17,1375
5116253_DavidPietrusza.txt,565,15,37,327,30,16,4,377
5116741_MelanieSlade.txt,683,7,97,254,83,36,19,392
5117137_SocialChoiceAndIndividualValues.txt,2724,54,50,974,283,288,92,1637
5117157_VillehardouinsDeLaConquteDeConstantinople.txt,1571,6,261,491,190,158,70,909
511762_ShadowPeople.txt,1374,19,72,505,202,127,55,889
511786_HenryDodge.txt,591,11,53,217,75,29,17,338
511804_UssNewmanKPerrydd883.txt,630,10,63,264,68,26,9,367
511813_NashvilleStar.txt,2454,40,61,902,328,168,75,1473
511842_LakeBangweulu.txt,665,18,36,246,69,51,21,387
511843_SiberianYupik.txt,727,20,36,285,75,45,30,435
511845_RiseOfNations.txt,1415,22,64,538,179,125,50,892
511846_LakeKivu.txt,674,14,48,270,97,46,20,433
5118829_MarcFord.txt,1506,16,94,675,153,79,38,945
5119948_HuntsvilleAndLakeOfBaysTransportationCompany.txt,607,16,37,239,75,36,7,357
5122666_ImperialRulingCouncil.txt,3619,44,82,1317,437,251,140,2145
5125460_AbdulWahab.txt,1805,28,64,547,391,69,63,1070
5126527_MegumiEto.txt,817,16,51,276,131,37,33,477
5126556_BattleOfEbroRiver.txt,912,11,82,324,146,36,20,526
512851_Hemocytometer.txt,882,10,88,255,144,62,42,503
512852_NoChildLeftBehindAct.txt,3742,47,79,1452,539,326,140,2457
512936_UssWarddd139.txt,660,9,73,267,74,40,13,394
5130366_TeamRocketOrganization.txt,1391,10,139,525,216,104,55,900
5131433_IoannisMakrygiannis.txt,3171,24,132,1017,458,183,138,1796
5131554_IslandOfVanar.txt,612,10,61,221,65,42,23,351
5131_Chordate.txt,491,14,35,282,55,30,9,376
5132535_EvanescenceDiscography.txt,886,31,28,420,22,52,15,509
5132557_1996NbaPlayoffs.txt,756,19,39,432,4,1,0,437
5133130_MaxMedina.txt,1066,15,71,332,186,45,48,611
513322_Conformitypsychology.txt,876,9,97,269,136,90,48,543
5134_Chess.txt,7955,116,68,2804,1091,633,286,4814
5135300_HarmsWaynovel.txt,1293,25,51,574,148,83,38,843
5135303_BowsersCastle.txt,1388,16,86,552,181,84,63,880
5136407_StarWarsEpisodeIThePhantomMenacevideoGame.txt,993,14,70,394,116,75,37,622
5136535_KakeruManabe.txt,604,8,75,175,119,40,38,372
5136_CarmenElectra.txt,1285,25,51,578,134,60,36,808
5138070_EdwinHDodgson.txt,1569,24,65,505,225,82,66,878
513965_RammedEarth.txt,698,10,69,224,116,82,33,455
513972_Tulku.txt,1128,20,56,378,160,95,60,693
513975_MargaretBurbidge.txt,679,12,56,255,77,29,17,378
513989_HamiltonCollege.txt,2975,47,63,1283,369,204,89,1945
513990_PioneerLaseractive.txt,597,12,49,282,61,47,13,403
514036_AssociationForProgressiveCommunications.txt,2171,35,62,1165,185,122,26,1498
514037_QuebecBridge.txt,1132,18,62,375,165,78,50,668
5141940_OldIndianaFunPark.txt,677,10,67,262,88,29,16,395
5142_CharlieChaplin.txt,6865,67,102,2560,852,449,207,4068
514406_Vf1Valkyrie.txt,2547,39,65,973,307,212,70,1562
5144703_CenterForEnvironmentalPlanningAndTechnology.txt,1131,41,27,567,112,63,13,755
5145092_EagleviewMiddleSchool.txt,617,26,23,281,70,34,17,402
5146876_LegalEducationInTheUnitedKingdom.txt,1023,14,73,514,98,43,22,677
5147461_StAlbertSaints.txt,732,11,66,274,74,58,31,437
5148947_MosesHogan.txt,728,5,145,477,31,23,10,541
5149122_RockinTheJointTour.txt,958,15,63,453,100,47,25,625
51497_BattleOfVerdun.txt,1753,33,53,606,221,142,55,1024
5150098_2006MonacoGrandPrix.txt,2516,26,96,906,340,194,68,1508
51503_ProgressiveRock.txt,4645,55,84,1772,495,556,240,3063
51504_DellHymes.txt,1484,31,47,589,157,102,41,889
515094_Neuroeconomics.txt,769,23,33,343,78,62,17,500
515109_PonniyinSelvan.txt,1624,26,62,713,205,75,29,1022
51510_Silk.txt,2110,26,81,781,298,193,90,1362
515115_Poodle.txt,1030,19,54,437,127,92,46,702
51511_Prince.txt,4092,60,68,1373,443,481,275,2572
515128_Vadodara.txt,2132,41,52,922,211,166,52,1351
51512_Etiquette.txt,1314,22,59,526,164,105,40,835
515132_Mcflyband.txt,1881,19,99,727,229,110,75,1141
515133_LeonardDarwin.txt,789,14,56,321,86,46,24,477
515441_DodonasGrove.txt,980,10,98,273,129,90,52,544
515445_MauryWills.txt,722,11,65,293,88,40,23,444
5154466_UltimateCombat.txt,925,10,92,339,127,60,25,551
515508_PembrokeWelshCorgi.txt,798,15,53,271,113,72,49,505
515514_Puch.txt,922,19,48,315,117,101,25,558
515580_Ethnomethodology.txt,1213,30,40,444,165,101,36,746
5156785_GuyGoma.txt,1143,19,60,408,192,51,54,705
5160415_ListOfAvatarTheLastAirbenderMajorSecondaryCharacters.txt,7700,83,92,2652,1254,379,311,4596
516150_TransverseMode.txt,949,23,41,335,124,105,22,586
5161671_995HitFm.txt,736,12,61,297,83,52,32,464
516190_CarolinaMariaDeJesus.txt,976,14,69,270,168,95,34,567
5163201_CrownOfBaekje.txt,819,17,48,281,122,55,21,479
5163279_JackHoxie.txt,1012,14,72,443,111,57,33,644
5164288_WalterGilbey.txt,598,6,99,210,72,42,23,347
5164963_RibonucleaseA.txt,920,23,40,308,105,108,27,548
5165379_PenalLawsireland.txt,2145,19,112,736,304,128,68,1236
5165595_23dFighterGroup.txt,1031,31,33,473,95,93,16,677
516675_JohnnySacrimoni.txt,1445,13,111,519,251,68,54,892
5167046_DaveLPearce.txt,1390,35,39,560,165,101,36,862
5170478_GabinettoVieusseux.txt,1610,25,64,617,158,125,37,937
5170889_BubblesvideoGame.txt,553,4,138,160,82,39,23,304
5171974_FantasyMissionForce.txt,603,12,50,229,86,37,26,378
5172002_LenaLuthor.txt,733,16,45,282,115,30,25,452
517238_24PreludesAndFuguesshostakovich.txt,1210,15,80,420,124,136,42,722
517241_HeatPipe.txt,1599,29,55,581,217,113,54,965
517319_RampurUttarPradesh.txt,896,7,128,354,108,43,21,526
517322_MandyKane.txt,653,15,43,263,79,45,21,408
517323_Nawab.txt,1165,20,58,506,124,86,56,772
5173642_NaimarksDilationTheorem.txt,745,46,16,247,122,69,27,465
5174275_WeightStigma.txt,633,14,45,219,107,99,15,440
5174662_JamesHarperpublisher.txt,960,22,43,404,112,50,17,583
5174671_30Rock.txt,2429,36,67,1009,297,163,70,1539
517692_FortHenryOntario.txt,632,9,70,256,82,32,12,382
5176940_DefenceOfPukekoheEast1863.txt,1221,15,81,454,184,59,38,735
5176951_PolyprolineHelix.txt,658,13,50,226,74,74,50,424
517701_LilahMorgan.txt,1293,16,80,466,183,64,54,767
5180897_TheReligiousPoliceman.txt,1364,21,64,447,201,79,64,791
5181794_IrishDeafSociety.txt,1007,21,47,453,99,70,12,634
5181993_JacobBenReubenkaraite.txt,709,5,141,295,92,39,21,447
5182370_CrimeInMexico.txt,1970,36,54,804,260,163,53,1280
5186194_UtvLive.txt,1516,32,47,730,141,64,42,977
5186233_NecrophiliaInPopularCulture.txt,2541,44,57,984,326,185,101,1596
5186236_NewYorkArmyNationalGuard.txt,867,19,45,395,97,62,25,579
5187298_EconomyOfMontenegro.txt,880,17,51,336,89,84,25,534
5187314_BuckinghamPalaceConference.txt,718,16,44,285,96,33,11,425
518787_TheSonics.txt,1318,22,59,577,162,93,46,878
518789_UssSampsonddg10.txt,1013,14,72,398,122,45,28,593
518796_BritishForcesGermany.txt,568,13,43,331,33,18,9,391
5188403_NightOfTheLivingGrimBrownEvil.txt,594,12,49,249,77,24,24,374
5188621_HenryBrush.txt,1351,16,84,546,180,61,27,814
5188626_DevelopmentOfJehovahsWitnessesDoctrine.txt,1319,16,82,436,183,75,58,752
5189507_BowditchMiddleSchool.txt,673,17,39,280,80,54,22,436
5191188_CtholMishrak.txt,636,8,79,229,87,37,27,380
5193086_CorporationStreetBirmingham.txt,603,12,50,255,71,28,16,370
5193441_GameDay.txt,937,14,66,383,133,36,26,578
5193508_GlutenfreeBeer.txt,864,13,66,268,135,90,38,531
5193655_WascanaCentre.txt,975,14,69,386,128,65,32,611
519419_Angraband.txt,1551,28,55,698,174,121,44,1037
519430_Utv.txt,6239,62,100,2381,774,469,153,3777
519467_FivelinedSkink.txt,919,19,48,342,123,90,25,580
5194749_CanadianSoccerLeague.txt,737,24,30,346,74,46,15,481
5198390_VanessaDale.txt,1613,23,70,530,314,87,77,1008
5198401_Alexians.txt,679,9,75,275,69,44,12,400
5199597_HmsCenturion1732.txt,2051,18,113,658,312,108,52,1130
5200693_GunBlazeWest.txt,824,20,41,324,124,48,25,521
5201365_ZoosexualityAndTheLaw.txt,3510,55,63,1051,520,416,181,2168
5203548_TacticalResponseGroup.txt,686,15,45,299,89,72,23,483
5204539_BaroqueChurchesOfThePhilippines.txt,707,9,78,362,43,33,18,456
520507_NeuqunProvince.txt,846,20,42,404,64,66,16,550
520514_SoftRock.txt,1272,6,212,718,75,43,50,886
520517_LimitpreservingFunctionorderTheory.txt,1193,28,42,420,150,121,50,741
520520_WrestlemaniaXx.txt,971,10,97,525,102,28,8,663
520539_AceOfSpades.txt,952,13,73,370,127,56,18,571
520542_SantiagoDelEsteroProvince.txt,919,22,41,418,77,68,26,589
520593_DrumStick.txt,824,17,48,295,131,65,37,528
520599_WillieBrownpolitician.txt,988,15,65,436,115,61,27,639
5207306_ListOfCrurotarsans.txt,1329,57,23,680,102,57,32,871
5207311_HeroestvSeries.txt,2563,48,53,997,355,151,73,1576
521040_RegisteredRetirementSavingsPlan.txt,765,19,40,285,115,48,26,474
52119_Embedding.txt,783,37,21,265,117,77,25,484
5213374_ListOfCanadianDebaters.txt,2182,20,109,1359,37,341,7,1744
52135_Pneumonia.txt,4767,63,75,1665,703,519,230,3117
52136_Citrus.txt,1566,19,82,680,205,131,79,1095
52138_Shrimp.txt,679,13,52,249,102,57,36,444
52139_AudreyHepburn.txt,6523,76,85,2238,1030,410,246,3924
52141_Inversionmeteorology.txt,1087,18,60,347,132,107,65,651
52143_Megacity.txt,895,24,37,408,75,58,19,560
52147_SawtoothWave.txt,651,16,40,223,88,65,33,409
5214997_PearlOfLaoTzu.txt,1856,20,92,682,286,86,37,1091
52153_CreeLanguage.txt,812,21,38,332,95,72,31,530
521597_ProjectBlueBook.txt,5963,95,62,2223,939,411,250,3823
521601_DecimalDay.txt,1648,25,65,504,247,141,64,956
521637_Prograph.txt,1848,27,68,621,286,131,79,1117
5216471_Caffiends.txt,953,22,43,279,152,53,37,521
521656_Kmsptv.txt,2111,36,58,953,224,136,77,1390
5217803_FridayNightFootballaustralia.txt,986,16,61,343,148,63,36,590
5218770_NanticokeLennilenape.txt,1291,15,86,503,161,105,32,801
5218860_1991InNascar.txt,1904,140,13,1335,124,16,7,1482
5220330_PaperCup.txt,828,15,55,320,118,66,29,533
522070_OdeToBillieJoe.txt,849,22,38,359,99,54,14,526
5222633_KreHolt.txt,519,7,74,289,44,25,2,360
5222637_1995InNascarCraftsmanTruckSeries.txt,1153,85,13,822,68,2,2,894
5222742_JamesHarrisonOliver.txt,648,9,72,288,67,11,18,384
5223733_FreeholdRacewayMall.txt,708,16,44,291,82,56,20,449
5223823_SarwoEdhieWibowo.txt,1700,37,45,666,266,54,45,1031
5224251_EntrepreneurshipEducation.txt,1000,7,142,364,137,96,18,615
522692_Jamelia.txt,939,20,46,350,111,84,24,569
522694_TsushimaStrait.txt,1127,15,75,479,81,94,33,687
522695_AlaouiteDynasty.txt,645,10,64,235,88,31,16,370
522701_TheAnimalsOfFarthingWoodseries.txt,2335,29,80,1150,236,102,62,1550
5227023_JapaneseBattleshipAsahi.txt,642,9,71,229,96,33,9,367
522705_PulitzerPrizeForInvestigativeReporting.txt,1848,13,142,949,116,109,12,1186
522726_UssGeorgiassgn729.txt,571,13,43,233,92,20,7,352
522728_InvoluntaryCelibacy.txt,928,13,71,279,156,104,53,592
522734_KevinPhillipspoliticalCommentator.txt,1352,22,61,533,130,120,42,825
522775_Deadman.txt,913,12,76,347,137,44,33,561
522777_GothicLine.txt,5610,52,107,2077,734,342,164,3317
522800_UssMakassarStraitcve91.txt,665,11,60,290,75,27,5,397
5228649_ObsidiancomputerGame.txt,886,15,59,266,131,65,35,497
5228694_HarryBLiversedge.txt,1633,32,51,755,159,67,27,1008
5230325_ArthurTange.txt,866,10,86,267,94,86,38,485
5231906_RedKress.txt,570,10,57,204,68,16,14,302
5232431_BaigongPipes.txt,887,16,55,311,110,85,26,532
5234183_Landslidesong.txt,590,11,53,199,94,47,21,361
5234192_TidaholmsBruk.txt,600,4,150,194,113,43,13,363
5235183_ConwyMorfa.txt,888,12,74,346,114,61,18,539
5236157_StephenKingsInspiration.txt,6082,89,68,1796,1007,328,227,3358
523810_GetAGrip.txt,638,15,42,404,38,22,8,472
5238485_CarbonMicrophone.txt,746,10,74,305,102,49,29,485
523853_HeSheAndIt.txt,805,10,80,297,117,44,19,477
523879_SimplyConnectedSpace.txt,937,16,58,269,155,71,93,588
523883_Jinrapper.txt,1742,28,62,649,281,123,59,1112
523884_YellowRibbon.txt,1389,25,55,465,196,76,62,799
523886_ExercitatioAnatomicaDeMotuCordisEtSanguinisInAnimalibus.txt,690,5,138,213,89,47,19,368
523891_GoodisonPark.txt,970,23,42,358,106,67,27,558
523892_EdmundKirbySmith.txt,1097,17,64,455,109,49,25,638
5240651_ListOfUsConcertVenues.txt,4338,54,80,3373,15,17,8,3413
5241231_1999AmericanLeagueChampionshipSeries.txt,773,9,85,303,96,34,11,444
524258_MelAllen.txt,1179,21,56,469,140,60,45,714
524263_BrodmannArea19.txt,617,12,51,210,77,74,26,387
5243002_SalvatoreFiume.txt,1311,18,72,519,122,93,23,757
5243867_Gardnersurname.txt,578,3,192,440,4,24,2,470
5244514_RockStarSupernova.txt,784,18,43,358,93,43,13,507
5245074_Novaspace.txt,774,51,15,409,61,55,15,540
5245079_HistoryOfTheNationalHealthService.txt,1107,17,65,380,164,77,38,659
5245543_AhunaVairya.txt,1018,20,50,387,111,64,32,594
5248304_UssSuffolkaka69.txt,628,4,157,246,95,15,8,364
5248315_LouisJMichot.txt,1401,27,51,580,165,94,48,887
524902_TheNational.txt,1919,39,49,689,255,138,63,1145
524903_WariowareIncMegaMicrogame.txt,778,10,77,305,99,47,21,472
524948_CatholicEmancipation.txt,1185,19,62,440,157,77,34,708
524949_BattleOfGooseGreen.txt,1623,15,108,641,230,96,51,1018
524973_Isandlwana.txt,915,10,91,282,149,78,46,555
524975_NationalProbationService.txt,716,12,59,331,79,42,10,462
524980_BattleOfIsandlwana.txt,1691,20,84,585,257,106,77,1025
524986_BatmanTheKillingJoke.txt,2229,29,76,702,352,139,105,1298
5250634_2004UnrestInKosovo.txt,2091,36,58,854,301,99,55,1309
5251141_SpeciesOfPsittacosaurus.txt,1841,46,40,632,256,192,105,1185
525290_TKeithGlennan.txt,595,13,45,270,53,36,10,369
525291_GoodmanAce.txt,2232,37,60,886,282,154,89,1411
525292_Hidalgofilm.txt,1027,23,44,326,169,59,39,593
525407_LandingAtAnzacCove.txt,4957,64,77,1591,769,363,138,2861
5255479_TodMachover.txt,1124,10,112,536,90,86,12,724
5255496_WinginIt.txt,1107,13,85,369,186,60,46,661
5256709_UnicodeTypefaces.txt,1023,33,31,450,119,97,35,701
5258071_UniversityChurchOfStMaryTheVirgin.txt,1754,23,76,647,236,123,41,1047
5258074_MiroslavBrandt.txt,985,18,54,374,109,91,34,608
52590_ThePopulationBomb.txt,935,12,77,355,116,65,41,577
5259101_Snapdragontransformers.txt,897,13,69,332,127,41,32,532
52593_AddisAbaba.txt,1525,23,66,639,169,93,38,939
526026_LaneSisters.txt,598,11,54,216,83,35,12,346
526032_Bedzed.txt,540,12,45,223,98,30,11,362
526054_ReportersWithoutBorders.txt,1270,24,52,572,144,64,22,802
526056_1995RugbyWorldCup.txt,860,47,18,334,98,46,15,493
526058_GAHenty.txt,2780,13,213,1333,104,70,20,1527
526077_Pharmacokinetics.txt,1029,26,39,406,135,93,28,662
5260949_SessionsclothingCompany.txt,589,8,73,219,82,43,16,360
5261916_BrooksPharmacy.txt,939,14,67,403,110,60,30,603
5263130_1948InCountryMusic.txt,570,10,57,366,25,20,10,421
5263161_1944InCountryMusic.txt,555,6,92,325,27,28,10,390
5263174_UlsterDefenceVolunteers.txt,846,17,49,338,109,51,28,526
5264394_RonnieLester.txt,653,7,93,268,68,34,16,386
52649_Acetylcholine.txt,1343,26,51,587,167,132,38,924
526501_EchostarCommunicationsCorporation.txt,729,17,42,336,69,51,17,473
526502_CanadianWheatBoard.txt,870,12,72,311,131,55,32,529
5267102_TheAdventuresOfMimiTour.txt,1607,36,44,733,173,112,75,1093
5267987_CinemaOfVietnam.txt,1439,29,49,755,117,78,20,970
5268212_RichmondHillHighSchoolrichmondHillOntario.txt,840,60,14,509,60,59,11,639
5268223_ListOfBrighamYoungUniversityPeople.txt,1023,20,51,737,23,79,3,842
5269294_ListOfVehiclesInInvaderZim.txt,2076,31,66,642,349,155,112,1258
5270934_ListOfExtremeMakeoverHomeEditionEpisodes.txt,11313,23,491,4761,1500,708,254,7223
5270938_TheFairlyOddparentsEnterTheCleft.txt,1560,18,86,595,191,82,59,927
527165_MartinReesBaronReesOfLudlow.txt,702,9,78,351,47,28,11,437
527169_Schizopolis.txt,1999,35,57,803,297,102,80,1282
5272074_SirCharlesHardyIslands.txt,661,15,44,263,81,30,12,386
5273122_JewsAndJudaismInLuxembourg.txt,782,12,65,243,117,73,28,461
5274089_DifferencesBetweenSpanishAndPortuguese.txt,5875,142,41,2175,765,573,260,3773
5274696_HomeworldsResistance.txt,756,17,44,275,104,59,26,464
5276987_EtCetera.txt,1236,17,72,332,228,71,77,708
5280819_UiucCollegeOfBusiness.txt,1251,32,39,689,94,42,11,836
5281222_GeorgeDespot.txt,1840,45,40,718,256,122,68,1164
528152_WingsuitFlying.txt,1916,31,61,688,287,147,63,1185
528154_EnfieldFc.txt,1096,21,52,451,104,70,22,647
528159_BoXilai.txt,1233,15,82,493,149,95,33,770
528163_LawOfTheRussianFederation.txt,1189,33,36,401,162,146,60,769
5281789_ThomasFHamilton.txt,3386,23,147,1159,509,209,136,2013
528200_RasosCemetery.txt,597,9,66,281,59,41,10,391
528202_DeHavillandTigerMoth.txt,838,18,46,403,64,61,12,540
528259_ParasiteSingles.txt,1314,18,73,381,189,148,76,794
5283437_ThePriceIsRightaustralianGameShow.txt,685,16,42,270,93,34,18,415
5283441_MohammedAbdAlAlQadir.txt,741,14,52,268,138,36,22,464
5283529_DrewAndKateAndKatesMom.txt,768,28,27,303,114,26,33,476
5284659_KeltecSu16.txt,1303,13,100,403,167,149,32,751
5285610_DickWhitefootballer.txt,797,17,46,262,115,37,47,461
5286022_SupermancomicStrip.txt,731,12,60,283,93,42,16,434
5286311_AbdullahAlTayabi.txt,1081,27,40,334,218,33,34,619
5286313_RaqiyahMays.txt,911,15,60,330,133,70,29,562
5287276_RayOLightGroup.txt,764,12,63,316,78,61,18,473
5287354_Ptychopteridae.txt,777,13,59,371,75,49,22,517
5291114_AptPupil.txt,1675,25,67,534,290,83,68,975
529237_AlbertsonCollegeOfIdaho.txt,788,19,41,359,89,52,11,511
529249_MasaharuMorimoto.txt,724,15,48,299,86,53,21,459
5293286_MohammadNasimguantanamoDetainee958.txt,851,19,44,272,185,25,37,519
529338_DominionsIi.txt,2294,40,57,890,280,246,86,1502
5294359_RoyMackal.txt,1260,14,90,545,123,72,24,764
5297232_Bhoomimusic.txt,893,28,31,321,89,81,31,522
529750_JohnsonStateCollege.txt,1935,21,92,952,158,120,32,1262
529753_Elseworlds.txt,835,14,59,346,103,55,32,536
5298897_GregorioMorales.txt,916,9,101,394,95,49,17,555
5298904_Trioxidane.txt,578,10,57,241,70,43,15,369
5299827_LoveLettersFromANobleManToHisSisterPt21685.txt,1921,30,64,562,321,73,90,1046
5300415_BrooklineHighSchool.txt,698,18,38,320,60,48,10,438
5301080_WadeOMartinJr.txt,1630,28,58,692,201,89,45,1027
5303085_ConsumerBillOfRights.txt,755,13,58,271,118,59,16,464
530322_TimFinn.txt,704,17,41,312,90,41,13,456
530331_HistoryOfThePunjab.txt,7343,118,62,2922,932,401,181,4436
530428_BlueCoatSchoolOldham.txt,2116,27,78,803,263,141,57,1264
530435_Baltifood.txt,921,14,65,319,132,58,44,553
530436_Bli.txt,6480,126,51,2267,757,542,247,3813
530485_HildaToledano.txt,2633,38,69,1029,335,136,85,1585
530494_LavochkinLa5.txt,900,13,69,295,127,78,37,537
5305968_DaoudHanania.txt,2711,82,33,1577,71,81,23,1752
5305972_HieronymusBoschnzBand.txt,695,8,86,250,96,66,35,447
530781_Zoqfotpik.txt,644,10,64,187,91,49,26,353
5310739_DeadendElimination.txt,1223,24,50,415,170,107,55,747
5310750_HospitalSantoTomas.txt,601,12,50,239,81,49,15,384
5312299_ImpedanceCardiography.txt,866,35,24,372,99,87,30,588
531408_Waterstones.txt,933,15,62,392,109,73,32,606
531482_TaytuBetul.txt,696,7,99,257,97,38,23,415
531575_SilentSynapse.txt,946,18,52,337,136,102,50,625
531588_LiberalPartyOfCanadaLeadershipConventions.txt,880,36,24,423,113,22,12,570
5316689_UnitedKingdomLocalElections2006FullResults.txt,1379,12,114,1068,164,20,9,1261
5316691_BazettFragaMcremitz.txt,879,15,58,252,148,67,44,511
5316716_RonneburgHesse.txt,636,11,57,220,64,59,11,354
5316728_ListOfNotableStaffAndStudentsOfTheUniversityOfLondon.txt,2072,37,56,1721,21,39,5,1786
5319345_CanyonLaketexas.txt,569,15,37,242,71,41,10,364
531988_WilhelmVonKaulbach.txt,1268,8,158,409,156,114,55,734
5320550_CensorshipInThePeoplesRepublicOfChina.txt,673,27,24,260,95,75,32,462
5320667_ThePrinceOfTennisfilm.txt,1006,18,55,416,125,58,32,631
53217_ExoticAtom.txt,727,13,55,231,92,96,36,455
53221_Gandalf.txt,3951,48,82,1240,623,197,154,2214
53223_Magicianparanormal.txt,557,17,32,195,87,46,25,353
53226_Magicillusion.txt,4435,47,94,1426,676,399,238,2739
53227_Vein.txt,847,18,47,306,131,82,32,551
53228_EtonCollege.txt,3361,29,115,1273,425,235,132,2065
5323168_MichaelPook.txt,625,7,89,202,84,39,24,349
53238_Arm.txt,1168,28,41,399,111,130,31,671
53241_TheElementsOfStyle.txt,1163,17,68,470,107,99,54,730
53242_RobinWilliams.txt,2397,42,57,979,303,131,67,1480
5324563_UnionStationcolumbusOhio.txt,1277,19,67,524,145,64,30,763
53253_BalducciLevitation.txt,1044,19,54,347,143,64,42,596
53254_HistoryOfSardinia.txt,2234,36,62,783,279,169,68,1299
53257_OliviaNewtonjohn.txt,2788,46,60,1125,307,203,91,1726
53258_Pythia.txt,3613,40,90,1277,507,220,98,2102
53259_CableModem.txt,801,17,47,324,95,96,29,544
53260_KensingtonMaryland.txt,1139,30,37,476,118,73,25,692
5326401_ChechenRepublicOfIchkeria.txt,583,16,36,240,64,43,16,363
5326405_HotBulbEngine.txt,2202,35,62,741,323,219,102,1385
532664_JamesBulger.txt,3253,41,79,1100,524,176,93,1893
5326747_CaledoniaStatePark.txt,851,13,65,390,107,46,7,550
532678_SheilaGreibach.txt,1209,38,31,571,99,108,14,792
5329199_BlenkoGlassCompany.txt,669,13,51,269,87,58,16,430
5329289_HowDareYou.txt,938,8,117,443,104,54,39,640
5330260_ShadowDance.txt,1470,20,73,440,263,65,49,817
533081_ChamplainCollege.txt,1337,44,30,679,115,77,18,889
5330956_UniversityOfLucknow.txt,842,3,280,298,102,37,17,454
5332972_Catelon.txt,2118,27,78,756,372,129,72,1329
5334071_StornextFileSystem.txt,684,24,28,296,101,63,21,481
5335737_Tuckersurname.txt,800,4,200,444,49,39,22,554
5335749_Mechwarrior4Mercenaries.txt,3638,68,53,1330,461,366,166,2323
5336990_SoundRanging.txt,2024,50,40,719,353,150,56,1278
533710_IslamInGermany.txt,827,15,55,342,70,86,26,524
533748_JohnJCrittenden.txt,790,15,52,280,101,23,21,425
5338021_BuliuguLi.txt,635,5,127,233,81,36,34,384
5338033_Agogwe.txt,808,14,57,223,138,72,43,476
5338650_ListOfMediaPortrayalsOfBisexuality.txt,712,8,89,351,53,71,20,495
5339589_1963InTheUnitedKingdom.txt,904,14,64,552,31,30,4,617
5339708_RoyGreenhilt.txt,2671,17,157,766,463,166,152,1547
5341860_OpinionPollingForThePeruvianNationalElection2006.txt,567,21,27,169,95,56,41,361
5344131_FrenchCreekStatePark.txt,1074,22,48,463,161,75,21,720
5345735_PatrickStewartsoldier.txt,577,9,64,254,70,28,9,361
5346689_RevolvingDoorsOfVengeance.txt,2423,27,89,822,436,78,156,1492
5347350_GenrespopularMusic.txt,566,9,62,318,48,52,24,442
534751_BadTaste.txt,748,14,53,305,96,48,15,464
534754_Adjutant.txt,842,12,70,318,74,79,31,502
534791_ConstitutionOfMalaysia.txt,1237,30,41,510,120,67,23,720
534792_ChildsPlay.txt,1043,31,33,433,155,43,29,660
534793_GlassHammer.txt,721,12,60,346,62,48,19,475
534800_ArchbishopricOfWarmia.txt,1113,24,46,413,134,69,19,635
5348351_Matebeverage.txt,2132,32,66,635,327,202,118,1282
5350519_NathanielLGoldstein.txt,811,10,81,341,88,52,12,493
5351235_Sapinuwa.txt,967,18,53,330,126,76,43,575
5352189_JackOfFables.txt,607,9,67,215,90,36,30,371
535245_RosettaSpaceProbeTimeline.txt,1349,36,37,513,221,78,53,865
5353231_MohammedObaidullahAlvi.txt,4497,42,107,2228,490,225,107,3050
5353396_GlynnAcademy.txt,681,14,48,265,86,38,13,402
5354485_GeorgeEBrownJr.txt,537,9,59,238,56,22,8,324
5354687_BezdanyRaid.txt,828,12,69,271,110,56,28,465
5355064_BedfordHospital.txt,570,15,38,259,57,61,16,393
5355642_KhalidIbnAlwalid.txt,5460,52,105,1939,800,296,172,3207
5356017_HelenLongino.txt,960,12,80,486,59,49,22,616
5356668_BronxTheatreHighSchool.txt,582,13,44,227,85,38,8,358
5357360_ListOfDougCharacters.txt,2941,44,66,1129,416,201,114,1860
5358273_Ufc4.txt,702,17,41,298,84,50,14,446
535846_MarzipanhomestarRunner.txt,725,14,51,227,119,55,44,445
535859_CitrusBowl.txt,1286,19,67,523,163,91,32,809
535878_Yamauba.txt,729,17,42,218,122,58,37,435
535879_HamburgerSv.txt,1485,23,64,513,179,111,52,855
535887_UweSeeler.txt,788,14,56,256,122,62,32,472
535928_SpiritualEvolution.txt,2934,35,83,1168,283,288,92,1831
535929_FortLeavenworth.txt,1265,26,48,619,117,62,23,821
535930_Paionia.txt,892,16,55,315,115,60,25,515
5359850_EmotionalChemistry.txt,1496,21,71,474,281,63,60,878
5359852_ShitakiriSuzume.txt,680,9,75,170,125,59,33,387
5360916_AyanamiRaisingProject.txt,785,16,49,318,101,56,24,499
5361215_VictorianGeneralElection1999.txt,855,29,29,302,128,53,28,511
5363095_AmericanCustomerSatisfactionIndex.txt,1104,16,69,503,125,86,37,751
5363791_Jadow.txt,1083,8,135,414,147,74,42,677
5363802_MichaelCrafter.txt,571,19,30,223,87,39,24,373
5364726_ChicagoCollegeOfPerformingArts.txt,1157,24,48,413,162,88,21,684
53669_CrdobaSpain.txt,1214,25,48,483,114,120,37,754
53673_MethuselahsChildren.txt,591,9,65,223,80,45,17,365
5367609_JohannesRietstap.txt,750,10,75,262,90,60,19,431
5367617_TheyDiedWithTheirBootsOn.txt,696,9,77,290,83,34,23,430
53682_Calligraphy.txt,3081,46,66,1324,337,257,101,2019
53683_NuclearFallout.txt,3284,55,59,1100,399,354,137,1990
5369902_NotAboutLove.txt,665,11,60,261,79,41,37,418
537019_TemperateRainForest.txt,1266,18,70,687,109,105,22,923
537020_CharlieKaufman.txt,1047,22,47,487,112,56,23,678
5370921_Skyrocketcomics.txt,727,13,55,281,112,43,18,454
53736_HaydenChristensen.txt,981,21,46,404,119,57,28,608
537422_NationalElectricalCodeus.txt,1607,19,84,576,230,133,49,988
5375682_MemoryDisambiguation.txt,2877,27,106,1009,442,179,117,1747
5376374_HumanRightsInSoTomAndPrncipe.txt,962,21,45,357,136,93,30,616
5377518_MechatronicsDesignAssociation.txt,615,24,25,211,96,62,16,385
5378471_OneCrazySummonerGuessWhatsComingToDinner.txt,754,19,39,311,104,33,31,479
5378604_VetsForFreedomActionFund.txt,1343,26,51,634,156,68,22,880
5378608_1972NationalLeagueChampionshipSeries.txt,958,22,43,384,98,71,29,582
5379161_TenixPtyLtd.txt,1277,45,28,654,134,89,23,900
5380115_MediaInvolvementInTheAftermathOfHurricaneKatrina.txt,943,13,72,370,125,64,35,594
538012_ListOfTownsAndBoroughsInPennsylvania.txt,1300,15,86,1284,1,1,1,1287
5380155_ManuelAntonioFlores.txt,583,10,58,230,66,31,10,337
538026_NormanVincentPeale.txt,2087,27,77,813,257,142,92,1304
538054_Pogradec.txt,788,9,87,328,81,45,18,472
538061_BayOfKiel.txt,1076,15,71,368,129,75,41,613
538109_BillBerry.txt,1755,27,65,501,278,130,72,981
5381372_RapeAndRepresentation.txt,646,9,71,267,75,51,19,412
5385199_ColossalBaroque.txt,733,11,66,344,77,44,19,484
5387833_TheHistoryBoysfilm.txt,894,16,55,329,123,49,30,531
5391037_ConstantOfMotion.txt,590,19,31,203,69,59,19,350
539105_ZhangZuolin.txt,2585,34,76,865,398,209,81,1553
539123_JariLitmanen.txt,1647,19,86,544,221,132,71,968
539131_HughGough1stViscountGough.txt,926,11,84,308,128,46,23,505
539139_GeomanticFigures.txt,1279,15,85,430,190,120,60,800
539144_DarlaHood.txt,588,13,45,247,66,30,8,351
539146_RepublicOfChinaReferendum2004.txt,1106,18,61,408,142,76,26,652
539167_BankimChandraChattopadhyay.txt,1184,19,62,464,136,92,32,724
5391750_QueensbayMall.txt,635,13,48,390,48,38,10,486
5391771_Brunswikonomastics.txt,574,37,15,353,17,40,6,416
539185_Gilgit.txt,1023,16,63,461,106,54,24,645
539194_MufprogrammingLanguage.txt,2035,41,49,724,300,131,78,1233
539225_RogerBoyle1stEarlOfOrrery.txt,1154,12,96,414,143,51,23,631
5392882_GospelOakPrimarySchool.txt,731,12,60,192,123,29,40,384
539601_Sulis.txt,1050,17,61,385,138,83,48,654
539602_StateOrganisationOfTheOttomanEmpire.txt,1585,32,49,541,224,144,67,976
539664_SubdivisionsOfTheOttomanEmpire.txt,1585,30,52,732,149,105,60,1046
539722_HandsworthSouthYorkshire.txt,2709,51,53,940,376,184,104,1604
539724_ApplesVaud.txt,789,12,65,285,79,60,17,441
5397745_MiguelEstevesCardoso.txt,603,12,50,257,64,41,14,376
5398743_MaryMurphychoreographer.txt,927,15,61,366,116,47,36,565
5399781_TheBattleOfAnghiaripainting.txt,898,13,69,316,124,58,28,526
5399786_WarnerELeighton.txt,582,5,116,278,37,14,8,337
540271_ColoniesInAntiquity.txt,1181,15,78,392,169,101,39,701
540272_RitaDove.txt,680,11,61,308,53,39,8,408
540278_WNPBarbellion.txt,881,14,62,273,146,64,41,524
540295_EscapePod.txt,943,39,24,439,106,39,23,607
540296_RimfireAmmunition.txt,959,13,73,334,104,93,47,578
540312_KingsdrinkingGame.txt,3483,89,39,1064,550,209,151,1974
540313_TrevorLinden.txt,1024,19,53,434,103,46,23,606
540314_NedMaddrell.txt,690,15,46,207,97,72,38,414
540317_FordExplorer.txt,1530,28,54,573,185,151,41,950
5404867_ErikGrantLea.txt,1284,22,58,478,150,86,48,762
5406480_NormanBlack.txt,993,14,70,439,104,58,19,620
5406531_HeinrichBr.txt,892,14,63,309,115,67,16,507
540686_Mazatln.txt,682,12,56,266,81,43,11,401
540690_RickMoranis.txt,915,20,45,389,95,43,22,549
5407120_PreelectionDayEventsOfTheSingaporeGeneralElection2006.txt,6123,93,65,2526,899,351,157,3933
540753_Lapras.txt,1236,22,56,456,166,123,57,802
540763_MysteryFilm.txt,688,18,38,298,65,44,22,429
540814_LeighBowery.txt,1899,29,65,748,201,156,80,1185
5411411_ShirleyBenson.txt,758,9,84,229,155,36,31,451
5411455_Calciphylaxis.txt,607,22,27,220,95,79,28,422
5412962_ListOfNorwegianAmericans.txt,1084,16,67,717,35,64,11,827
5413000_ListOfRomanianAmericans.txt,610,15,40,399,12,36,3,450
541351_ChampernowneConstant.txt,906,25,36,239,105,65,35,444
5413634_TheInnocentMan.txt,753,16,47,312,103,34,23,472
541389_Erowid.txt,571,10,57,201,75,63,19,358
541390_StanisawMikoajczyk.txt,1024,16,64,345,163,64,27,599
541404_Septuagesima.txt,595,13,45,216,74,32,24,346
541409_FreePapuaMovement.txt,825,15,55,372,93,65,15,545
5416803_IndianRailwayTrafficService.txt,798,14,57,367,104,63,8,542
5417852_InvalidenfriedhofCemetery.txt,644,9,71,304,65,36,11,416
5419065_Filmspotting.txt,669,10,66,269,79,35,30,413
5420654_2005InIceHockey.txt,591,23,25,267,69,43,10,389
5421387_Metapolitefsi.txt,3402,62,54,1169,466,272,141,2048
5422817_2006ChaseForTheNextelCup.txt,1921,64,30,959,195,51,21,1226
5422935_DavidCopperfield1999Film.txt,3267,96,34,1276,496,133,107,2012
5423521_JesusChristTheLogos.txt,1158,9,128,551,102,64,27,744
5423879_SpaceBeaver.txt,803,20,40,310,112,48,27,497
5423881_Rdflib.txt,1096,59,18,479,141,87,25,732
542392_OntarioProgressiveConservativeLeadershipElection2004.txt,1211,23,52,445,169,83,37,734
5424492_Jagdgeschwader51.txt,941,17,55,333,127,57,18,535
542491_Bibliomancy.txt,1361,29,46,457,210,62,51,780
542495_ZitscomicStrip.txt,2942,17,173,904,516,185,179,1784
5427715_LaValse.txt,859,12,71,267,130,69,53,519
5428411_ValleyForgeArmyHospital.txt,768,18,42,240,128,71,26,465
5429040_Partyundergrads.txt,760,13,58,339,96,37,20,492
542931_TheBlackIsland.txt,843,29,29,305,132,55,22,514
542932_IsiahThomas.txt,2312,33,70,898,294,140,59,1391
5429389_DoRunRun.txt,966,10,96,293,158,59,59,569
54303_RaymondQueneau.txt,1450,18,80,596,134,101,39,870
5430716_NormanStillman.txt,568,7,81,289,33,18,5,345
54309_EctopicPregnancy.txt,2035,35,58,596,337,275,100,1308
5431563_WindsorHighSchoolcalifornia.txt,848,20,42,322,135,53,33,543
54316_ListOfMathematicalFunctions.txt,1248,21,59,567,118,174,34,893
54317_Fairy.txt,4065,52,78,1387,626,325,181,2519
54320_EssexCountyNewYork.txt,817,17,48,347,79,43,7,476
54323_FranklinCountyNewYork.txt,875,21,41,365,88,41,8,502
54324_ChesterWNimitz.txt,2652,43,61,1197,251,102,42,1592
54326_FultonCountyNewYork.txt,908,17,53,358,106,41,15,520
54327_HistoryOfDenmark.txt,5134,72,71,1753,714,389,181,3037
54329_GeneseeCountyNewYork.txt,975,24,40,418,108,42,16,584
54338_GreeneCountyNewYork.txt,880,22,40,364,84,42,15,505
54346_HamiltonCountyNewYork.txt,1182,22,53,464,132,71,30,697
54350_CrestoneColorado.txt,1381,23,60,485,195,96,28,804
5435415_UndergroundErnie.txt,955,15,63,372,136,57,27,592
5435625_StMaryDeCastroDover.txt,828,11,75,275,115,53,25,468
543567_ListOfPeopleByNameCam.txt,947,18,52,699,10,52,3,764
543568_LorentzCovariance.txt,931,37,25,334,109,103,42,588
5436114_TimeCrisisProjectTitan.txt,1127,14,80,440,192,48,34,714
5436448_DungeonsDragonsRelatedProducts.txt,2184,26,84,996,253,138,43,1430
5437737_Ferhanensoy.txt,2050,44,46,1195,161,76,11,1443
54379_HoughtonMichigan.txt,1874,47,39,752,245,103,49,1149
54383_Pangram.txt,3845,29,132,1845,377,292,103,2617
54385_ChildSacrifice.txt,656,9,72,220,110,54,23,407
54386_PhilipIiOfSpain.txt,3368,38,88,1238,417,203,105,1963
54390_Disassembler.txt,649,8,81,302,59,53,36,450
54394_ListOfCalculators.txt,1389,22,63,581,108,184,14,887
54395_StrikeZone.txt,992,12,82,328,157,72,33,590
5440243_BeauGeste1939Film.txt,729,12,60,308,101,25,22,456
54403_DizzyGillespie.txt,1691,32,52,680,195,121,48,1044
54410_Triceratops.txt,3126,41,76,1049,486,295,137,1967
5441736_RacialSegregationInTheUnitedStates.txt,2603,39,66,1005,324,236,90,1655
5445060_Livepa.txt,601,14,42,247,78,49,16,390
5445639_TraceyMoffatt.txt,1241,25,49,474,147,100,39,760
5446251_ImsVdex.txt,1346,27,49,524,199,117,18,858
544648_Metafilter.txt,1310,22,59,441,204,137,63,845
544652_HughSegal.txt,667,11,60,258,66,62,13,399
544668_IsmailI.txt,1173,24,48,491,133,63,32,719
5447605_Tusenfryd.txt,527,40,13,229,59,36,10,334
5447918_JerzyFicowski.txt,794,18,44,334,82,40,14,470
5450116_LocalGovernmentAct1958.txt,3244,40,81,1415,351,179,66,2011
5451062_TheFrenchLine.txt,992,11,90,370,136,70,40,616
5451649_JulienCahn.txt,1069,27,39,348,162,54,52,616
5453774_ShahMohammad.txt,801,29,27,297,113,55,23,488
5454986_SphinxForTheMemories.txt,761,15,50,243,123,35,29,430
5455476_AFeastUnknown.txt,1085,15,72,406,147,70,42,665
5456498_TentCity4kingCountyWashington.txt,2878,49,58,1188,397,146,49,1780
5456651_SupportersOfFcBarcelona.txt,617,4,154,306,59,36,16,417
545743_NijCastle.txt,699,18,38,263,89,57,19,428
545748_ChinoHillsStatePark.txt,802,12,66,335,103,52,29,519
545753_MagicalNegro.txt,739,12,61,254,89,70,41,454
545768_Ticketmaster.txt,1553,24,64,551,217,120,68,956
5460482_TalesOfTheShadowmen.txt,984,9,109,652,20,105,6,783
5460521_AnnScheinCarlyss.txt,621,8,77,284,58,37,12,391
5460985_HakuohUniversity.txt,966,15,64,438,92,99,21,650
5461625_Villarrobledo.txt,840,28,30,372,71,56,26,525
546179_CommunesOfTheHautegaronneDepartment.txt,3077,3,1025,475,5,229,0,709
5463663_PokmonBattleRevolution.txt,633,9,70,215,88,63,23,389
5464368_BobBraham.txt,1178,25,47,450,155,45,21,671
5467452_MagaliNol.txt,934,7,133,439,24,51,2,516
5468527_ListOfStatutoryInstrumentsOfScotland2003.txt,5119,17,301,3675,6,18,0,3699
546860_Blackshirts.txt,1217,24,50,540,113,110,19,782
5468_CaymanIslands.txt,2810,60,46,1099,360,207,83,1749
546904_NaderShah.txt,1415,24,58,577,196,75,40,888
5469_HistoryOfTheCaymanIslands.txt,1448,19,76,479,214,89,41,823
5470753_HazelwatershipDown.txt,592,9,65,191,88,51,25,355
5471_DemographicsOfTheCaymanIslands.txt,762,22,34,311,67,92,19,489
5472982_CriticismOfCocacola.txt,4158,65,63,1615,611,284,115,2625
5474031_GreenBayEastHighSchool.txt,601,10,60,266,83,24,13,386
5476231_ApplicationLifecycleManagement.txt,667,13,51,305,82,47,19,453
54764_AndrewLloydWebber.txt,3007,37,81,1165,357,243,100,1865
54765_WarcardGame.txt,842,18,46,250,126,55,39,470
5476930_KatellKeineg.txt,706,17,41,287,79,50,20,436
54770_SimaGuang.txt,640,10,64,261,66,41,17,385
5477737_DepartmentOfHealthphilippines.txt,812,18,45,342,90,45,6,483
5477838_RzvanFlorea.txt,647,19,34,228,60,67,11,366
5478368_TheAryanBrotherhoodInOz.txt,1877,22,85,853,285,92,47,1277
547891_SirindhornInternationalInstituteOfTechnology.txt,1705,26,65,818,132,122,43,1115
547899_ThammasatUniversity.txt,1880,27,69,860,175,139,38,1212
547911_ShahmukhiScript.txt,331,10,33,100,48,22,12,182
547912_UssSpruancedd963.txt,1464,20,73,656,168,83,25,932
547917_VanessaAmorosi.txt,667,16,41,282,79,38,16,415
547986_HowToSucceedInBusinessWithoutReallyTrying.txt,2387,32,74,948,343,102,61,1454
547990_ExplorersOnTheMoon.txt,1626,21,77,499,268,114,81,962
548003_TheCalculusAffair.txt,703,17,41,257,102,43,15,417
5480529_OwenalikShahadah.txt,810,13,62,346,93,61,30,530
5481798_PaulOxleysUnit.txt,618,11,56,262,74,33,22,391
5482921_AntoinePriore.txt,836,14,59,339,108,62,21,530
5482934_ValMayerik.txt,884,14,63,430,65,59,17,571
548295_HugoAwardForBestSemiprozine.txt,1326,38,34,828,151,38,6,1023
5483237_AnarchistLaw.txt,1158,13,89,348,152,144,56,700
548425_FormatWar.txt,1633,16,102,661,216,152,69,1098
5485556_PhishAndTheirMusicalCostumes.txt,798,23,34,312,100,53,20,485
5485559_EckfordOfBrooklyn.txt,1041,15,69,351,112,69,37,569
5485561_RoyalSecuritiesCorporation.txt,705,6,117,319,75,55,15,464
5486119_FakeDenominationsOfUnitedStatesCurrency.txt,651,11,59,268,82,32,19,401
5488797_GantzTargets.txt,4245,53,80,1217,716,277,215,2425
548991_GospelOakToBarkingLine.txt,1086,18,60,410,143,68,36,657
549002_Travelcard.txt,1404,41,34,506,182,103,46,837
549088_LewisSpence.txt,630,11,57,319,27,22,5,373
5492644_MarkAndrewJames.txt,624,11,56,296,68,31,8,403
5493346_ChrisLytle.txt,836,8,104,318,40,18,7,383
549389_WolframVonRichthofen.txt,829,10,82,345,102,26,17,490
549445_CompletenessorderTheory.txt,2392,42,56,774,339,252,120,1485
5495487_IronMansArmor.txt,4299,76,56,1625,586,443,139,2793
5495495_AshrafKarim.txt,1018,14,72,321,201,47,51,620
5496489_480thIntelligenceWing.txt,672,13,51,335,71,48,9,463
5496495_HistoryOfModernKosovo.txt,2436,30,81,820,381,170,86,1457
5497165_FredFredburger.txt,1353,15,90,468,209,66,70,813
5497184_ObsidianConflict.txt,854,34,25,267,133,65,29,494
5498696_CellMicroprocessorImplementations.txt,1068,21,50,381,160,88,38,667
5500323_WillGraham.txt,922,9,102,341,159,40,33,573
5500682_EvangelicalCounsels.txt,764,8,95,195,129,50,41,415
5502006_SmokeBlanchard.txt,2376,17,139,864,296,114,58,1332
5502008_TheFinalReflection.txt,1024,21,48,408,123,70,43,644
5503513_Kohary.txt,576,21,27,237,35,57,14,343
5503576_NorthropSwitchblade.txt,918,15,61,333,134,78,40,585
5504712_ScottSattler.txt,770,11,70,277,99,35,16,427
5507047_MusicDrama.txt,988,14,70,329,117,93,51,590
5507064_1886InIreland.txt,598,6,99,287,58,31,9,385
5511614_SsHeimwehrDanzig.txt,703,17,41,331,68,54,14,467
551253_CaptainTennille.txt,2629,35,75,1135,255,156,77,1623
5514424_AnthonyCorallo.txt,791,5,158,302,113,49,23,487
5514725_TakedaKanrysai.txt,1033,10,103,333,187,53,51,624
5515130_ListOfStrawberryPanicCharacters.txt,3396,67,50,868,604,240,257,1969
5515788_JeanbaptisteAlexandreLeBlond.txt,938,17,55,388,91,87,21,587
5516086_AcambaroFigures.txt,1116,29,38,387,184,74,41,686
5516403_ArcticMonkeysTourHistory.txt,897,15,59,382,99,44,19,544
5517142_BratzGenieMagicalbum.txt,805,46,17,368,68,46,25,507
5517326_RobertLawsonarchitect.txt,4837,53,91,1655,678,413,239,2985
5517329_HenryMoore.txt,2916,46,63,1056,401,197,90,1744
5517335_SylvanusMorley.txt,5377,57,94,1714,747,515,254,3230
5517336_ListOfKirbyPowers.txt,6698,16,418,2485,949,418,270,4122
5517364_ListOfProAndAntiwarezArguments.txt,1603,3,534,525,235,149,111,1020
5522248_BlasterMaster.txt,1496,19,78,523,197,102,55,877
5522264_AmericanIdolCompilationSeries.txt,1166,49,23,522,83,67,22,694
552304_TonyArmas.txt,579,12,48,237,66,33,7,343
552310_AldersonbroaddusCollege.txt,846,17,49,387,82,72,15,556
5523753_1936InPoetry.txt,575,10,57,355,30,33,8,426
5526067_DonyaleLuna.txt,785,25,31,265,110,74,25,474
552773_JazzRoyalty.txt,910,22,41,411,105,60,31,607
5528835_TheGeneralIsUp.txt,1053,23,45,404,129,80,31,644
5529794_DbagClass210215218219Old.txt,683,13,52,234,99,57,27,417
5531150_MothersUnion.txt,1040,18,57,406,123,44,26,599
5531180_ListOfAmericaOneAffiliates.txt,805,41,19,616,5,17,3,641
5534813_ListOfLongIslandPublicSchoolDistrictsAndSchools.txt,2968,126,23,2924,4,18,2,2948
5534835_AdministrativeDivisionsOfSaratovOblast.txt,726,2,363,300,0,27,1,328
5537631_DatapanikInYearZero.txt,587,9,65,310,28,17,6,361
553796_PrincessPatriciasCanadianLightInfantry.txt,1870,38,49,769,210,117,36,1132
55382_Supernatural.txt,4646,40,116,1330,687,527,269,2813
55383_HardDiskPlatter.txt,695,5,139,208,103,96,20,427
5538640_WorkersPartyOfTheUnitedStates.txt,996,19,52,428,116,44,26,614
5538683_DemographicEstimatesOfTheGermanExodusFromEasternEurope.txt,2038,29,70,736,275,162,73,1246
55389_MasterBootRecord.txt,1400,29,48,499,219,103,57,878
55395_HistoryOfOperatingSystems.txt,2488,36,69,862,364,237,92,1555
55397_Hadean.txt,740,15,49,276,88,66,36,466
5540503_Iso639w.txt,2244,1,2244,217,2,12,1,232
5540510_Iso639x.txt,2755,1,2755,302,1,23,2,328
5540844_RobertWinthropSimpson.txt,612,9,68,193,78,34,10,315
5541243_IsaacLeeser.txt,1063,30,35,392,126,59,25,602
5541467_HawaiiArmyNationalGuard.txt,820,21,39,363,100,64,26,553
5542483_CueBid.txt,931,21,44,316,139,86,50,591
5543717_Kurei.txt,3067,39,78,909,606,127,178,1820
554430_CramSchool.txt,1621,24,67,634,209,158,72,1073
554439_AsSalamAlAmiri.txt,218,33,6,109,12,18,2,141
554446_ChloroflexusAurantiacus.txt,589,9,65,239,75,74,17,405
554486_ThomasChalmers.txt,2297,20,114,727,290,176,55,1248
5545235_OffRoadPark.txt,870,42,20,772,17,27,5,821
55456_CopticAlphabet.txt,755,14,53,324,79,49,24,476
55457_10thMillenniumBc.txt,567,8,70,288,66,46,14,414
55459_PrincessOfWales.txt,1077,15,71,408,142,42,56,648
55461_EnglishLiterature.txt,7124,69,103,2599,858,662,289,4408
55465_HighoccupancyVehicleLane.txt,1326,22,60,502,205,103,47,857
55467_DewittClinton.txt,557,12,46,235,62,23,17,337
55469_Catch22.txt,2771,66,41,969,369,226,114,1678
55478_Vladivostok.txt,1588,47,33,686,172,135,52,1045
55480_GobiDesert.txt,3877,41,94,1349,378,357,163,2247
55482_SteubenCountyNewYork.txt,1025,18,56,438,96,42,17,593
55483_RobinsonCrusoe.txt,2008,27,74,699,300,139,63,1201
5548510_OlegFirsov.txt,678,13,52,238,78,62,19,397
55486_TiogaCountyNewYork.txt,961,17,56,380,107,42,18,547
554877_ThresherShark.txt,767,26,29,268,113,85,28,494
554883_TypeONegative.txt,3523,36,97,1451,460,244,118,2273
55490_RoaldDahl.txt,3542,52,68,1313,445,199,118,2075
554943_Diaboromon.txt,582,18,32,238,78,20,20,356
55495_MillersCrossing.txt,902,11,82,371,119,43,24,557
5550776_PierrejeanMariette.txt,1103,15,73,437,123,74,27,661
5552372_193940WinterOffensive.txt,6991,98,71,2483,737,755,93,4068
5554047_EJKorvette.txt,1286,24,53,644,115,91,66,916
5554114_EmilyQuartermaine.txt,7615,139,54,2393,1576,286,419,4674
5555105_DioceseOfAlbarracn.txt,681,18,37,272,36,40,5,353
555517_LemonySnicketTheUnauthorizedAutobiography.txt,759,12,63,290,96,60,24,470
555528_PalsBattalion.txt,621,9,69,239,90,54,11,394
555539_ProductionDesigner.txt,567,10,56,274,44,34,14,366
5555655_MikhailMatinsky.txt,431,9,47,186,26,23,9,244
555566_Longinusliterature.txt,3087,33,93,1094,364,243,138,1839
555584_GreenJell.txt,2775,30,92,1156,335,214,111,1816
555585_Demogorgon.txt,826,17,48,322,96,58,32,508
555588_Ghostsplay.txt,559,15,37,196,86,35,19,336
555597_Misdirection.txt,1009,16,63,315,155,81,35,586
555604_WarrenJeffs.txt,2082,32,65,885,253,103,43,1284
5556196_CrimePrevention.txt,1116,28,39,566,111,61,19,757
555629_TheCannonballRunfilm.txt,2109,36,58,814,298,129,80,1321
5556301_Zemaitis.txt,758,10,75,313,101,59,20,493
555639_TheEnid.txt,737,17,43,243,101,54,39,437
555643_Lady.txt,1280,24,53,497,144,94,49,784
5557270_EducationInMauritania.txt,869,10,86,265,115,115,33,528
5557861_1851InAustralia.txt,717,15,47,315,55,38,24,432
5558903_Ikaris.txt,987,18,54,399,118,57,26,600
5561838_FritzPuempin.txt,555,10,55,278,43,40,11,372
5562657_UniversityCollegeOfMedicalSciences.txt,669,20,33,299,77,45,24,445
5564149_ListOfCharactersFromTheLWord.txt,3572,25,142,1969,183,172,40,2364
5564916_LagoOilTransportCoLtd.txt,684,11,62,277,88,39,24,428
5565500_CharlesDeSainttienneDeLaTour.txt,605,15,40,250,78,34,8,370
5565864_HenryJohnMoberly.txt,750,10,75,295,95,38,19,447
5566466_OsazeOdemwingie.txt,613,11,55,223,69,50,14,356
556700_ComputerWorld.txt,710,15,47,295,67,63,12,437
556739_TonyAbbott.txt,1104,18,61,431,158,67,43,699
556778_RedHatEnterpriseLinux.txt,916,21,43,441,89,54,32,616
5568000_SexAndTheCityCharacters.txt,3207,21,152,1151,415,224,138,1928
5568107_ArmstrongducktalesEpisode.txt,1227,18,68,433,208,52,47,740
557121_YeeHongCentreForGeriatricCare.txt,1542,26,59,701,181,102,33,1017
5571947_Mxw.txt,589,7,84,231,72,52,15,370
5572573_ListOfMusicInProjectGothamRacing3.txt,604,10,60,354,13,14,8,389
5573528_GeorgeMWhitesides.txt,803,14,57,373,70,47,15,505
5574263_Carboxypeptidase.txt,918,14,65,324,142,86,45,597
5574594_BoratCulturalLearningsOfAmericaForMakeBenefitGloriousNationOfKazakhstan.txt,4602,71,64,1670,709,259,154,2792
5575817_2005ChesapeakeBayCrossingStudy.txt,779,9,86,271,92,60,23,446
5578105_MariaJaneTaylor.txt,2002,25,80,969,192,94,38,1293
5578431_ConnieChanPochu.txt,1404,13,108,648,125,90,30,893
557868_NeilMorrissey.txt,1232,24,51,463,165,60,33,721
5579644_DarkLong.txt,653,15,43,329,42,19,9,399
5579651_BadCompany2002Film.txt,831,29,28,324,129,23,29,505
5580587_CollegeOfTheUniversityOfChicago.txt,2116,32,66,936,241,169,75,1421
5580590_Romrod.txt,557,19,29,220,55,37,14,326
5580605_CalebGardner.txt,720,6,120,240,81,55,11,387
5581300_Kulappulli.txt,648,10,64,239,91,47,23,400
5581974_ChrisEconomaki.txt,653,17,38,324,72,24,7,427
558216_RestrictionOfHazardousSubstancesDirective.txt,2273,34,66,920,285,182,81,1468
5584467_2006AutumnInternationals.txt,852,46,18,543,31,27,6,607
55853_GusHall.txt,1015,20,50,388,137,49,16,590
55856_Linz.txt,1574,35,44,656,161,136,35,988
5585705_ListOfEurodanceArtists.txt,1417,28,50,1081,30,55,5,1171
5587364_TomGreenLive.txt,925,12,77,351,140,56,35,582
5588368_FranzMuller.txt,587,11,53,209,102,20,14,345
5588373_TheUniversityRegister.txt,1276,32,39,507,147,67,39,760
5588382_ListOfNotableOldGowers.txt,3522,2,1761,2261,114,130,41,2546
5588393_ShalomInTheHome.txt,596,20,29,175,91,44,29,339
558882_SonicTheHedgehogTheMovie.txt,2597,35,74,928,382,142,100,1552
5589326_MountLebanonPercussion.txt,2252,16,140,1071,218,140,51,1480
5589341_TomJonesDiscography.txt,734,10,73,458,20,8,11,497
558959_RailwayElectrificationSystem.txt,2349,43,54,827,357,218,92,1494
558970_TheSecretOfNimh.txt,1099,19,57,416,161,81,37,695
5590041_HarrietARoche.txt,658,13,50,299,69,31,10,409
55917_SimnBolvar.txt,1920,41,46,715,215,166,52,1148
559294_SuicideSquad.txt,3056,71,43,1264,356,139,97,1856
5596031_MyLittlePonypilotEpisode.txt,1131,18,62,458,137,62,24,681
5596043_KingScoopaKoopa.txt,996,7,142,311,160,64,50,585
5596064_OberweisDairy.txt,709,15,47,293,89,39,21,442
5596099_CatholicLiturgy.txt,1522,23,66,544,188,108,54,894
55972_MiddleEar.txt,1168,17,68,419,147,76,36,678
55974_FederalCommunicationsCommission.txt,4388,78,56,1810,553,313,131,2807
5598680_FacingTheFlag.txt,3278,37,88,1001,487,267,160,1915
5599331_PatrinaLoukoumia.txt,678,9,75,223,97,53,21,394
559959_Xb42Mixmaster.txt,600,12,50,210,92,45,16,363
559961_RepublicOfGenoa.txt,940,9,104,325,114,80,26,545
559970_Jetty.txt,1467,11,133,477,182,100,51,810
5599890_GaoYunnorthernWei.txt,1708,15,113,596,281,76,79,1032
5599899_200607HeinekenCup.txt,900,101,8,364,89,58,8,519
560043_CrazyIvan.txt,692,10,69,261,91,49,32,433
560047_OceanicClimate.txt,582,10,58,240,55,77,29,401
560055_BabylonnewTestament.txt,796,9,88,263,105,60,30,458
5601184_OmaghBombingnames.txt,899,30,29,350,126,49,17,542
5602233_TheDutchess.txt,563,14,40,204,39,25,17,285
5602866_ListOfTributesToDimebagDarrell.txt,5408,71,76,1622,846,328,292,3088
5603581_UnitedStatesAirForceInGermany.txt,970,31,31,490,85,56,21,652
5603728_OmarAhmadOmarAlhubishi.txt,1129,23,49,467,137,50,40,694
560394_Shadowpsychology.txt,665,11,60,229,81,60,30,400
5605402_AbdulrabMuhammadMuhammadAliAlsayfi.txt,1124,23,48,467,136,50,40,693
5605758_CultureOfNewOrleans.txt,2336,49,47,877,258,254,88,1477
5605973_AbuNasrAltunisi.txt,962,21,45,391,124,43,41,599
5607419_ChristianServiceBrigade.txt,667,9,74,290,76,42,17,425
5607420_KaeruNoTameNiKaneWaNaru.txt,1376,27,50,501,183,87,47,818
5607626_KurukshetraWarDay4.txt,613,19,32,266,72,26,12,376
5608705_MultipleMasterFonts.txt,848,13,65,326,117,80,29,552
5609549_JosephRouletabille.txt,950,21,45,523,57,43,21,644
5611268_SanSilvestroInCapite.txt,594,14,42,243,74,28,7,352
5612471_RiversOfBeleriand.txt,1322,27,48,462,187,90,32,771
5612503_ListOfLeafBeetlechrysomelidaeSpeciesRecordedInBritain.txt,747,26,28,592,89,18,2,701
5613397_LeontiusHypatiusAndTheodulus.txt,597,9,66,196,101,18,15,330
5614163_MarkLindley.txt,576,30,19,341,26,35,12,414
5614164_Phonofilm.txt,973,14,69,435,112,65,25,637
561531_JohannBessler.txt,995,12,82,305,175,59,40,579
561535_LockheedMartinX35.txt,1378,32,43,555,179,112,35,881
5616297_SailorMoonEpisode012.txt,566,12,47,206,81,20,25,332
5616310_SailorMoonEpisode013.txt,631,13,48,205,105,27,25,362
5617256_BsFzeroSeries.txt,783,17,46,275,121,59,32,487
5622164_GaietyTheatreLondon.txt,854,14,61,302,116,52,33,503
5622173_olskaKoarkarskaLiga.txt,2623,16,163,965,270,245,77,1557
562222_AWrinkleInTime.txt,2743,48,57,984,368,228,115,1695
562224_TecumsehsWar.txt,1190,19,62,471,163,60,38,732
562231_CantarDeMioCid.txt,699,16,43,290,96,35,23,444
5622494_GeorgeChurchill.txt,841,9,93,244,125,53,36,458
562289_TupolevTu4.txt,702,11,63,230,109,75,18,432
5624949_CardiffCityFc.txt,2081,40,52,870,241,121,51,1283
5625681_ConsolidatedRobotics.txt,748,9,83,284,91,55,34,464
5625696_CyclingProficiencyTest.txt,600,10,60,199,97,48,22,366
562615_MoniqueSerf.txt,1413,14,100,453,182,137,42,814
562629_SanjayGandhi.txt,1190,22,54,446,191,78,44,759
562630_PeelSlowlyAndSee.txt,911,17,53,461,63,43,15,582
5626618_LincolnMinsterSchool.txt,570,19,30,184,94,47,23,348
5629513_AlfredJamesBroomhall.txt,1296,14,92,494,183,63,30,770
5629531_GayGamesVii.txt,926,22,42,490,60,35,11,596
5630479_HumanBotFly.txt,658,8,82,184,110,62,53,409
563233_MachikoSoga.txt,750,12,62,414,54,47,10,525
5632745_ManuelArmijo.txt,1100,13,84,394,161,50,34,639
5632763_PsychedelicsInPopularCulture.txt,1189,42,28,508,131,89,22,750
563285_UniversityOfMinnesotaDuluth.txt,729,11,66,369,64,34,11,478
563290_Adansonia.txt,772,10,77,326,95,55,30,506
563295_SedeVacante.txt,1149,12,95,427,110,70,35,642
563302_Louiseopera.txt,851,16,53,266,148,29,27,470
563303_UniversityOfStThomashouston.txt,2963,52,56,1407,289,221,48,1965
5633345_TourismInBuenosAires.txt,765,16,47,317,73,55,20,465
5633696_Wmul.txt,777,37,21,468,39,40,9,556
5633700_UnionCountyIndustrialRailroad.txt,910,18,50,449,78,36,18,581
563379_FootballLeagueSecondDivision.txt,602,14,43,209,77,38,23,347
5634968_FsnDetroit.txt,804,12,67,548,40,45,9,642
5636702_IllinoisVCaballes.txt,1304,11,118,463,185,87,46,781
563704_ListOfRiversInMinnesota.txt,3077,35,87,2555,28,110,7,2700
5640356_HistoryOfDukeUniversity.txt,2072,28,74,830,262,138,38,1268
5641051_GabrielMannsinger.txt,802,25,32,287,129,39,29,484
5641052_TheChargeOfTheLightBrigade1936Film.txt,752,19,39,349,84,27,21,481
5641359_SocitDeTransportDeLoutaouais.txt,2544,109,23,941,306,139,77,1463
5642027_CanadianHorseRacingHallOfFame.txt,520,14,37,304,13,7,3,327
564375_Yeshu.txt,5710,57,100,2052,824,311,222,3409
564387_Flowpsychology.txt,1045,25,41,411,135,69,37,652
564429_Maliseet.txt,739,8,92,258,95,44,41,438
564470_EnriqueVIglesias.txt,667,11,60,324,51,43,12,430
564476_PalangaCityMunicipality.txt,926,34,27,402,104,50,16,572
5645933_Shantisagar.txt,595,9,66,308,41,20,17,386
5646612_Kraband.txt,550,23,23,364,18,12,6,400
5646893_LafayetteHighSchoollexingtonKentucky.txt,928,25,37,433,128,63,25,649
564739_MidwoodBrooklyn.txt,1294,36,35,571,140,72,28,811
564789_RichardSavage4thEarlRivers.txt,593,8,74,206,71,29,10,316
5648113_TigrinyaGrammar.txt,2673,32,83,841,318,302,78,1539
564859_LaLaw.txt,1094,10,109,471,100,67,28,666
5649146_SuchitraMitra.txt,3597,13,276,2242,144,68,18,2472
5651365_NewtonSurmaville.txt,587,10,58,202,73,44,20,339
5651414_Warrendomestic.txt,689,11,62,199,112,64,44,419
5653009_ThomasBrowne4thViscountKenmare.txt,797,7,113,287,105,57,25,474
5653956_ListOfProgramsBroadcastByJetix.txt,802,30,26,456,2,17,4,479
56542_Hannabarbera.txt,3343,46,72,1409,394,247,93,2143
5654584_Chatsum.txt,575,21,27,232,77,46,16,371
56551_VocationalEducation.txt,1588,28,56,698,137,152,51,1038
56552_JetLag.txt,720,8,90,250,91,73,27,441
56554_IbmSelectricTypewriter.txt,2711,37,73,982,377,252,113,1724
565567_JamesEliWatson.txt,988,13,76,377,133,54,25,589
56557_BloodGlucoseMonitoring.txt,1069,24,44,457,120,97,37,711
56558_BloodPressure.txt,3147,64,49,1144,430,376,145,2095
56561_Anesthesia.txt,3486,59,59,1409,415,376,111,2311
56565_CircadianRhythm.txt,1354,20,67,580,161,141,41,923
56566_Chronobiology.txt,616,12,51,279,64,61,15,419
56567_HyperbolicFunction.txt,782,63,12,282,77,96,17,472
5656866_Scissorman.txt,694,17,40,241,102,33,25,401
56568_PleiadesstarCluster.txt,2493,44,56,786,358,203,116,1463
5656947_GabrielAndMaximShamir.txt,640,9,71,284,54,43,15,396
56569_Ashgabat.txt,776,16,48,276,112,52,36,476
56570_Puppet.txt,2019,39,51,732,273,166,95,1266
56574_MariaEdgeworth.txt,626,9,69,231,58,39,15,343
56576_HumphreyBBear.txt,652,11,59,236,94,50,31,411
565879_TheIncredibles.txt,4405,60,73,1655,635,297,155,2742
565883_MakarovPm.txt,1906,26,73,679,261,172,77,1189
565944_ListOfVideoGameConsoles.txt,920,15,61,587,27,30,15,659
5662358_Grendelniven.txt,2020,16,126,656,381,77,74,1188
566547_1927InAviation.txt,648,17,38,313,52,39,8,412
566551_FrankStronach.txt,1226,22,55,457,178,74,38,747
566558_1916InAviation.txt,639,23,27,305,57,51,3,416
566560_1918InAviation.txt,933,19,49,427,106,57,8,598
566561_1919InAviation.txt,968,21,46,460,92,56,8,616
566564_1949InAviation.txt,667,22,30,339,53,39,4,435
566565_PulitzerPrizeForFeaturePhotography.txt,922,4,230,475,43,39,8,565
566569_1950InAviation.txt,628,19,33,313,42,28,11,394
566570_1951InAviation.txt,596,26,22,308,34,40,4,386
566571_1952InAviation.txt,609,23,26,296,40,35,10,381
566572_1953InAviation.txt,545,21,25,268,41,32,5,346
566601_1972InAviation.txt,595,22,27,301,39,26,5,371
5666660_TreatyOfPaynesLanding.txt,1219,13,93,435,199,44,42,720
5667815_StateAndReligionottomanEmpire.txt,2694,38,70,945,361,222,110,1638
5668199_CamelotThemePark.txt,1149,16,71,439,195,74,26,734
5669330_BhabhaScattering.txt,602,24,25,232,81,44,11,368
5669338_DesiccatedThyroidExtract.txt,2019,20,100,686,299,226,93,1304
566956_SlaveI.txt,736,7,105,299,105,42,18,464
566959_StandardElectrodePotential.txt,914,29,31,367,108,88,23,586
5671006_JeishMuhammad.txt,788,10,78,317,115,38,31,501
5671088_LoneWolfAndCubBabyCartAtTheRiverStyx.txt,1290,18,71,452,178,49,44,723
5671092_Gliese876D.txt,689,11,62,234,82,62,18,396
5671102_Gliese876B.txt,599,9,66,205,64,72,13,354
5673410_HivaidsInBrazil.txt,2448,21,116,1033,244,197,70,1544
5674224_IbrahimjSulaymanMuhammadArbaysh.txt,564,16,35,217,108,18,17,360
5674904_GeorgiiAndVladimirStenberg.txt,821,12,68,341,84,54,25,504
5675469_VeoliaTransportNsw.txt,1009,16,63,544,59,28,7,638
5676178_RalphBurns.txt,1019,86,11,539,71,48,15,673
567643_CentreiceHockey.txt,563,16,35,170,82,35,23,310
567653_AlGoreControversies.txt,1235,17,72,442,201,64,41,748
5677128_SurfonicWaterRevival.txt,632,10,63,387,44,18,4,453
5677152_RandyMatson.txt,630,10,63,243,75,31,7,356
5677214_KensicoReservoir.txt,1126,15,75,423,148,55,28,654
5678794_TenBears.txt,1460,13,112,309,269,81,61,720
5679328_LondonBusesRouteP12.txt,880,15,58,447,91,45,35,618
5679750_AALuce.txt,610,12,50,238,68,36,22,364
568047_HobartAndWilliamSmithColleges.txt,2682,45,59,1244,261,177,59,1741
568120_CamilleHenry.txt,606,24,25,208,47,17,13,285
5681911_ListOfCharacterFusionsInBoboboboBobobo.txt,4659,17,274,1872,545,352,171,2940
5681932_DannyPadilla.txt,1085,61,17,419,132,77,32,660
5682234_MasterOfTheDjinni.txt,1176,13,90,377,183,41,45,646
5684236_EWallaceChadwick.txt,3243,54,60,1166,414,211,130,1921
5685254_UnitedWorkCollectiveCouncil.txt,584,14,41,217,69,47,14,347
5685741_AlleyPondPark.txt,731,11,66,277,91,51,19,438
5686076_ChristianFeminism.txt,1269,15,84,470,181,95,45,791
5687203_FarhadMehrad.txt,1208,31,38,461,158,83,20,722
568730_FreedomlandUsa.txt,2289,39,58,1052,238,129,42,1461
568741_HmsArgonautf56.txt,583,8,72,201,87,44,17,349
568773_ApocalypseOfPeter.txt,659,9,73,215,89,54,33,391
5689757_JohnForbesphysician.txt,688,8,86,280,76,39,4,399
569077_BarbarianFc.txt,774,27,28,304,90,49,26,469
5691040_CharlotteWilsonvso.txt,960,15,64,345,142,49,28,564
569135_LabourStudents.txt,1511,29,52,660,158,88,48,954
5691928_2006FifaWorldCupKnockoutStage.txt,734,36,20,542,17,16,1,576
56929_ForeignRelationsOfUganda.txt,1122,11,102,383,151,127,55,716
5693186_AntoineMacgiollaBhrighde.txt,1015,21,48,407,155,43,22,627
5693609_DaoXin.txt,1113,15,74,447,144,62,25,678
56937_ListOfCommonDiseases.txt,496,32,15,341,33,27,4,405
56938_InstituteOfElectricalAndElectronicsEngineers.txt,2393,33,72,1051,266,202,41,1560
56941_SchuylerCountyNewYork.txt,1059,23,46,421,118,43,22,604
5694775_DorianTyrell.txt,1572,19,82,548,245,71,66,930
5694862_CirqusVoltaire.txt,785,13,60,279,116,40,24,459
5696084_NewNegro.txt,2374,12,197,888,272,213,62,1435
5697745_Pharzoof.txt,659,16,41,217,110,36,24,387
569820_LosingMyReligion.txt,562,26,21,253,59,46,12,370
569822_InfieldFlyRule.txt,682,7,97,175,114,47,59,395
569829_StJohnsNorthwesternMilitaryAcademy.txt,746,19,39,320,95,32,11,458
569878_BbcRadioSheffield.txt,776,15,51,357,66,55,25,503
56989_HollywoodSquares.txt,4486,56,80,1535,603,305,142,2585
56990_TowerOfHanoi.txt,1397,25,55,428,197,116,45,786
569917_BbcRadioCleveland.txt,946,27,35,484,63,35,21,603
56995_NorthAmericanElectricReliabilityCorporation.txt,1212,23,52,509,160,81,56,806
56996_AbsolutelyFabulous.txt,2180,29,75,861,259,164,98,1382
5701268_Golion.txt,2805,44,63,1108,339,184,95,1726
5701598_TheSixWardsOfHouston.txt,2298,58,39,985,287,193,47,1512
570215_InsulatedGlazing.txt,663,12,55,218,118,52,35,423
570221_GodzillaVsMechagodzilla.txt,801,22,36,295,111,56,38,500
570227_GodzillaVsGigan.txt,974,24,40,385,124,69,37,615
570229_StreetSignTheft.txt,1319,28,47,514,192,107,50,863
5705758_ListOfLanguagesByFirstWrittenAccounts.txt,753,9,83,366,30,39,9,444
5705774_BinghamtonCrew.txt,1618,19,85,652,213,91,31,987
57059_Ndjamena.txt,511,17,30,193,54,30,16,293
5707459_TheBlackMistScandaljapaneseBaseball.txt,739,6,123,322,108,27,16,473
5707506_AgnescomicStrip.txt,689,14,49,202,112,68,48,430
5708665_ShlomoHaleviAlkabetz.txt,1097,11,99,417,138,57,25,637
5708677_PseudozizeeriaMaha.txt,912,14,65,356,69,95,51,571
570913_HarrahsEntertainment.txt,1105,49,22,552,128,32,21,733
570922_ActionAtADistancephysics.txt,752,10,75,259,121,67,30,477
570946_EarlOfOrmonde.txt,987,20,49,429,73,53,10,565
5709608_Creote.txt,939,20,46,278,156,57,74,565
570965_EastchesterNewYork.txt,2522,40,63,1051,296,146,49,1542
570969_DifferentStagesrushAlbum.txt,481,11,43,195,40,21,12,268
570981_JohnRobson.txt,896,13,68,356,102,60,29,547
571011_NorthernLightsnovel.txt,2640,41,64,855,440,169,104,1568
571020_StateUniversityOfNewYorkAtCobleskill.txt,594,9,66,407,35,21,5,468
5710651_MoltensaltReactorExperiment.txt,2258,33,68,775,334,195,74,1378
5712203_SkyPilotsong.txt,626,16,39,217,81,38,23,359
5713438_GalaeronNihmedu.txt,1306,11,118,457,183,79,54,773
5713554_LargestCitiesInTheUnitedStatesByPopulationByDecade.txt,848,29,29,324,74,52,5,455
5715681_PaulTisdale.txt,625,17,36,242,70,37,17,366
5716007_BildLilliDoll.txt,1251,14,89,438,187,93,48,766
5716179_ListOfHospitalsInScotland.txt,1053,51,20,947,14,4,4,969
5716325_6lowpan.txt,796,13,61,324,122,46,19,511
572084_BbcHomeService.txt,1008,24,42,437,110,73,20,640
572118_TrapperJohnMcintyre.txt,975,20,48,324,155,52,47,578
572121_PrivateParts.txt,655,15,43,236,96,44,26,402
5722745_BerthatvSeries.txt,548,22,24,244,65,23,17,349
572349_PrinciplesOfPsychology.txt,798,17,46,251,103,74,35,463
5723710_4thUnitedStatesCongressPoliticalParties.txt,1451,11,131,793,100,33,10,936
5723844_BruceSpringsteenWithTheSeegerSessionsBandTour.txt,1896,24,79,727,223,178,78,1206
572408_KansasCityMetropolitanArea.txt,3270,40,81,1679,252,213,71,2215
5726754_TransformersTheWarWithin.txt,1415,20,70,506,231,73,49,859
5728734_RawDeluxe.txt,610,11,55,318,46,38,14,416
5729246_75CmL45M32AntiAircraftGun.txt,705,9,78,218,108,54,24,404
5730558_SamSparks.txt,591,11,53,232,76,27,16,351
573174_InteriorDesign.txt,808,13,62,338,94,69,18,519
573185_GeorgetownUniversityLawCenter.txt,781,15,52,415,67,69,11,562
5732455_Tightropealbum.txt,537,19,28,261,63,11,9,344
5733714_MediaVision.txt,938,21,44,520,86,65,24,695
5733801_NhlAllstarTeam.txt,2829,78,36,2198,3,78,0,2279
5734754_OmaDeviceManagement.txt,730,18,40,288,125,52,19,484
573493_LegionOfChrist.txt,2625,42,62,944,318,164,83,1509
573549_CharlesPasqua.txt,714,20,35,256,88,33,16,393
5736611_JosephAbboud.txt,614,19,32,269,79,41,19,408
5737021_ClaustrophobiacodeLyokoEpisode.txt,1536,24,64,545,252,71,59,927
5737611_CharlesHWorkman.txt,723,11,65,305,62,33,28,428
5739203_AmnesiacodeLyokoEpisode.txt,1598,22,72,593,245,62,69,969
5739314_BattleOfDalry.txt,931,22,42,323,123,52,48,546
5740238_BrockenJr.txt,1071,17,63,484,117,44,30,675
5740757_FamilyLawAct1975.txt,818,14,58,294,104,70,25,493
5741495_MilitaryHistoryOfTheOldSwissConfederacy.txt,805,10,80,275,82,101,21,479
5741779_BatonBob.txt,719,11,65,261,109,38,34,442
574203_Bullmythology.txt,1186,18,65,417,155,94,44,710
574247_ListOfMilitaryOccupations.txt,1217,7,173,573,45,51,12,681
5743005_TriinstitutionalMdphdProgram.txt,623,12,51,316,45,57,11,429
5743126_PennRadio.txt,4880,51,95,1814,758,296,191,3059
5744103_MuseumInBielskobiaa.txt,1554,17,91,552,191,119,25,887
5744621_CochinHaneefa.txt,721,16,45,375,8,11,1,395
5745150_Melco.txt,820,9,91,570,41,29,4,644
574577_HansConried.txt,575,8,71,304,17,33,4,358
574580_RollsroyceOlympus.txt,1202,24,50,475,148,91,26,740
5746289_AgustnDeJuregui.txt,988,19,52,333,137,62,17,549
5746975_MokshadacharanSamadhyayi.txt,3746,27,138,1565,476,189,92,2322
5747984_Bellsblackadder.txt,761,17,44,266,115,49,35,465
5750530_StarWarped.txt,986,46,21,409,150,44,25,628
5751783_ZeroGravityZone.txt,2792,46,60,966,476,108,139,1689
5752709_MarineCorpsMessNight.txt,1502,74,20,669,142,61,15,887
5753059_ThaboSefolosha.txt,674,13,51,218,112,43,22,395
575371_SquashTennis.txt,1807,29,62,647,258,123,81,1109
5754384_ShouttearsForFearsSong.txt,1081,28,38,360,131,94,51,636
5756685_MonarchiesInTheEuropeanUnion.txt,1645,26,63,505,227,118,69,919
575735_HandleyPageHalifax.txt,1992,27,73,1034,198,113,28,1373
5758519_MichelBakhoum.txt,1025,12,85,382,118,72,30,602
5759479_OnlyTheGood.txt,1652,19,86,535,262,81,95,973
5760536_LuisPatti.txt,681,10,68,255,101,35,14,405
5760713_LuteinizingHormonechoriogonadotropinReceptor.txt,933,16,58,373,135,92,19,619
5760720_AndrsHurtadoDeMendoza.txt,663,12,55,256,70,45,17,388
5760723_AlabamaCivilWarConfederateUnits.txt,758,13,58,501,1,73,0,575
5761752_CarlSandburgHighSchool.txt,661,24,27,389,43,23,5,460
57620_ForeignRelationsOfNorway.txt,1023,27,37,406,122,98,22,648
5762110_SugraHumayunMirza.txt,1080,20,54,416,137,60,28,641
57621_Dragonfly.txt,939,17,55,393,98,89,40,620
57622_Sunflower.txt,931,22,42,340,140,70,42,592
5762383_ChronologyOfTheNorthernIrelandTroubles.txt,3226,128,25,1457,462,150,28,2097
57623_Blueberry.txt,2052,39,52,897,265,165,63,1390
57625_CommonCriteria.txt,1536,23,66,562,219,107,54,942
5762736_PastTenseds9.txt,1074,13,82,340,198,42,35,615
57627_EastmanKodak.txt,632,23,27,299,69,56,8,432
57628_MultipleChemicalSensitivity.txt,2470,39,63,1056,292,263,90,1701
57630_Monsoon.txt,1770,25,70,662,202,173,80,1117
57631_SanSalvador.txt,1333,26,51,510,162,125,55,852
57634_CarlOrff.txt,1061,22,48,376,140,90,35,641
57637_RichlandWashington.txt,2521,43,58,1151,277,150,38,1616
576387_FiniteFieldArithmetic.txt,1407,48,29,516,142,123,29,810
57638_SantoDomingo.txt,2492,56,44,1017,254,215,61,1547
57639_GeographyOfGuatemala.txt,701,12,58,341,47,74,7,469
57641_HistoryOfNamibia.txt,4345,84,51,1625,579,283,127,2614
576423_TomTomClub.txt,676,15,45,288,76,51,21,436
57644_Sofia.txt,3195,71,45,1413,291,278,78,2060
576463_NcaaWomensGymnasticsChampionship.txt,1704,40,42,985,18,9,3,1015
576465_AbcNotation.txt,679,19,35,296,81,62,15,454
57648_Taipei.txt,2150,50,43,1016,197,143,52,1408
57652_Tegucigalpa.txt,2248,41,54,862,268,200,95,1425
57654_Tehran.txt,3857,79,48,1883,378,293,88,2642
5765570_IncidentsAtDisneyParks.txt,3223,62,51,1162,532,207,69,1970
57656_JacobsonRadical.txt,571,16,35,222,57,68,27,374
57659_Tunis.txt,1115,29,38,444,127,79,30,680
57668_RickWakeman.txt,1595,22,72,701,147,80,34,962
5767295_TheRisingTour.txt,2009,24,83,763,237,159,85,1244
576748_SephirothfinalFantasyVii.txt,2635,32,82,978,362,185,91,1616
576812_HomeworldCataclysm.txt,1933,32,60,655,274,140,58,1127
5769429_JoeHorlen.txt,761,24,31,283,82,48,12,425
5769473_OlgaVinogradova.txt,683,3,227,294,46,54,3,397
5771097_DisarmoniaMundi.txt,591,13,45,243,71,52,15,381
5773684_AbdallahIbnUbayy.txt,1242,30,41,340,200,81,52,673
5774246_LatinSettlement.txt,609,7,87,192,87,41,27,347
577465_Tansen.txt,693,16,43,268,92,42,27,429
577479_GauharJan.txt,2692,20,134,906,359,242,104,1611
577515_Momotar.txt,648,15,43,206,101,45,25,377
577570_BloodhoundSam.txt,748,16,46,291,97,56,21,465
577576_Caillou.txt,1193,13,91,462,153,95,48,758
5775869_PhoenixArtsCentre.txt,659,65,10,354,53,47,17,471
5776897_PashtoFilmsIndustry.txt,2050,28,73,853,285,107,67,1312
5777861_Dinetah.txt,723,22,32,301,79,50,17,447
5777866_AWNorblad.txt,790,18,43,299,110,54,27,490
5778070_ArchibaldLow.txt,2420,35,69,860,343,156,97,1456
577843_GhaznavidEmpire.txt,1049,16,65,449,106,56,22,633
5778825_KinnikumanSuperPhoenix.txt,1092,18,60,413,174,43,29,659
577897_Walgreens.txt,708,18,39,312,90,49,16,467
5780772_GuildOfCalamitousIntent.txt,1516,21,72,529,236,93,60,918
5781007_MedalOfHonorvideoGame.txt,780,29,26,317,104,47,18,486
5782370_AstrogeologyResearchProgram.txt,830,16,51,357,103,57,13,530
5783680_SecondElder.txt,566,7,80,195,89,25,20,329
5783706_KurkiOfLaukko.txt,1321,26,50,538,158,101,37,834
578724_WallyWood.txt,2130,29,73,999,213,120,56,1388
5788500_HugoChvezsandbox.txt,966,11,87,362,132,102,32,628
5789712_ThomasAndFriendsVideoReleases.txt,3787,186,20,2509,135,95,51,2790
5789727_Savonnerie.txt,794,9,88,285,101,65,17,468
578989_FutureStrategicTankerAircraft.txt,674,13,51,278,82,56,11,427
5791355_BruceMuseumOfArtsAndScience.txt,672,21,32,300,66,41,13,420
5791682_GideonMace.txt,877,7,125,376,146,56,26,604
5792211_NewMoonOnMonday.txt,637,16,39,285,53,51,11,400
5793568_CoreyBeaulieu.txt,937,28,33,447,107,54,30,638
5793882_SuperDavetvSeries.txt,1441,10,144,468,246,88,89,891
5795249_RejimenSemboyanDiraja.txt,927,26,35,492,91,40,8,631
5795531_DeLaSallePhilippines.txt,991,26,38,523,99,49,11,682
579634_OttoStrasser.txt,720,8,90,259,82,48,23,412
579707_SsCanberra.txt,695,10,69,268,84,55,28,435
579712_MabelNormand.txt,687,17,40,271,105,35,23,434
579801_FictionalBook.txt,1424,21,67,579,149,116,49,893
5799079_ListOfMembersOfTheRealAcademiaEspaola.txt,2650,95,27,1640,103,63,5,1811
5801254_GoodbyeJapan.txt,590,12,49,273,47,68,8,396
580130_EarthAlliancebabylon5.txt,1138,21,54,432,176,65,39,712
580139_ListOfFictionalUnitedStatesPresidents.txt,19840,430,46,9597,2075,1091,398,13161
5803839_DemocraticPartyOfTheSanFernandoValleydpsfv.txt,658,9,73,317,68,50,5,440
5803914_RexMRogers.txt,1588,8,198,1019,42,61,11,1133
5804873_TheAdventuresOfCovanTheBrownhaired.txt,772,13,59,188,138,46,29,401
5806141_HistoryOfThePhilippinespre1521.txt,1247,18,69,473,160,89,27,749
5806151_AmongTheFree.txt,614,8,76,212,93,37,20,362
5807102_HistoryOfThePhilippines18981946.txt,3017,48,62,1089,440,189,80,1798
58079_FiveDynastiesAndTenKingdomsPeriod.txt,3425,147,23,1642,340,198,122,2302
580806_DesmondPlummer.txt,616,8,77,232,86,28,11,357
580879_CheekKissing.txt,1163,29,40,357,158,113,82,710
580888_WorldOfTiers.txt,2282,30,76,755,340,170,61,1326
58088_Sakhalin.txt,3031,37,81,1218,326,211,83,1838
58089_Itv.txt,1293,31,41,503,165,107,50,825
5810892_MissionsOfTheChurchOfJesusChristOfLatterdaySaints.txt,1015,17,59,329,137,80,41,587
5811454_RosetteChristopher.txt,3601,52,69,1159,581,146,157,2043
5811888_DanielVovak.txt,1266,15,84,527,173,71,43,814
581220_ContraceptiveSponge.txt,695,19,36,264,99,49,19,431
5812489_Hickstead.txt,618,12,51,327,28,23,2,380
5813191_TheJanuaryMan.txt,1261,19,66,415,213,59,37,724
58143_ThorinOakenshield.txt,685,9,76,201,102,39,38,380
58146_Battletoads.txt,2207,41,53,786,301,182,93,1362
58147_TheManchurianCandidate1962Film.txt,1632,29,56,624,228,89,55,996
5815020_PeterJHamilton.txt,579,13,44,245,67,38,11,361
5815689_EarlyIrishLiterature.txt,6953,36,193,1985,922,658,371,3936
5816323_PortOfTheAmericasportOfPonce.txt,1693,28,60,670,178,137,43,1028
5818041_1978FifaWorldCupQualificationconcacaf.txt,926,69,13,377,61,21,3,462
5818044_CerebellarAbiotrophy.txt,1374,19,72,601,158,126,55,940
581876_LimbourgBrothers.txt,681,11,61,241,86,44,22,393
5818877_FusionGamingConvention.txt,672,24,28,317,73,39,15,444
5818912_RiverRoddlesworth.txt,747,16,46,353,85,26,18,482
581931_Cholecystectomy.txt,630,11,57,211,89,79,23,402
581933_FirstBaseman.txt,1194,14,85,378,177,126,57,738
5820212_ListOfRayTheAnimationCharacters.txt,2260,42,53,643,406,138,99,1286
5820537_JimmyWPhipps.txt,702,16,43,332,66,31,5,434
5821789_Mammothzoids.txt,948,20,47,321,153,74,39,587
5823469_ColinDunne.txt,592,8,74,241,71,19,14,345
582372_CharterOak.txt,779,13,59,268,103,49,14,434
5825619_HaloCorporation.txt,894,10,89,360,122,76,24,582
5826563_MudLakewisconsin.txt,1144,3,381,868,38,1,36,943
5827603_LouisianaBayouBeast.txt,2372,26,91,1111,210,83,34,1438
5828273_ShawneeMissionParkway.txt,554,11,50,248,66,22,10,346
582967_ZhangZhungCulture.txt,1033,15,68,413,135,76,36,660
583021_BoydRice.txt,2185,25,87,837,312,156,104,1409
583023_ListOfLinuxGames.txt,681,30,22,517,15,23,5,560
583025_GretchenFranklin.txt,1227,25,49,440,175,84,35,734
5830574_DraganPrimorac.txt,717,10,71,315,58,46,21,440
5831149_MortgageLoanDocumentation.txt,906,31,29,381,128,77,46,632
5832149_YemeniteReunification.txt,1257,4,314,500,160,99,27,786
5833326_BaskettSloughNationalWildlifeRefuge.txt,684,10,68,298,78,48,12,436
583396_191819NhlSeason.txt,766,25,30,309,104,50,21,484
583407_ReturnToOz.txt,2966,23,128,1006,467,168,113,1754
583459_MillionManMarch.txt,764,12,63,375,71,44,14,504
583467_JimSoorley.txt,565,10,56,231,72,52,15,370
5836943_GeorginaRiver.txt,637,7,91,195,64,64,37,360
5836993_BartolomeoPacca.txt,1399,11,127,488,196,83,45,812
5838181_ManilaDoctorsCollege.txt,725,12,60,309,77,62,12,460
5838210_MisterMiracleshiloNorman.txt,1034,18,57,411,137,69,29,646
5838218_LesXx.txt,1078,43,25,553,97,47,10,707
5840789_MariaOssowska.txt,601,5,120,328,36,34,8,406
584082_AmrKhaled.txt,813,24,33,306,115,46,20,487
584097_MerchantAircraftCarrier.txt,640,18,35,283,83,45,16,427
584149_BrushRabbit.txt,795,11,72,279,125,70,45,519
584156_MonteiroLobato.txt,1346,24,56,556,148,108,57,869
5842145_FearAndLoathingInLasVegasnovel.txt,1473,24,61,493,186,93,64,836
5842980_P2xReceptor.txt,862,15,57,356,99,101,23,579
5844633_JoelKlatt.txt,1174,13,90,415,154,52,35,656
584492_VanessaCarlton.txt,1091,15,72,473,126,69,14,682
584493_Midkemia.txt,3489,40,87,1256,438,275,125,2094
584543_UniversityOfChicagoGraduateSchoolOfBusiness.txt,3040,39,77,1756,179,191,45,2171
5845673_AnimalsInSport.txt,1120,30,37,376,176,113,57,722
5849125_OskarPanizza.txt,2179,32,68,933,245,186,47,1411
5850728_InstantNoodles.txt,3183,56,56,1183,440,340,157,2120
585146_PierreMauroy.txt,877,12,73,467,37,23,8,535
585165_800Metres.txt,698,18,38,194,93,69,43,399
585167_Wildcatscomics.txt,4808,52,92,1850,690,340,178,3058
585168_GrassValleycompany.txt,947,14,67,679,41,41,7,768
585172_Go1999Film.txt,1899,30,63,605,310,90,80,1085
585173_AcousticPhonetics.txt,726,9,80,341,57,72,14,484
585174_CompanionsOfSaintNicholas.txt,1404,22,63,507,203,95,74,879
585196_UltimatePlayersAssociation.txt,1039,29,35,497,106,68,12,683
5851983_WelcomeToTheNhk.txt,2409,36,66,803,361,156,107,1427
5853363_StarDragon.txt,665,16,41,208,113,65,28,414
5853396_RegimeChangebook.txt,1207,19,63,390,212,47,53,702
5854625_TheProfessorsHouse.txt,1108,20,55,404,134,80,58,676
5855834_RoadRunnersDeathValleyRally.txt,900,13,69,351,127,45,26,549
585625_WrongwayConcurrency.txt,3284,43,76,1290,305,256,79,1930
585629_Kiev.txt,4692,97,48,1801,550,459,170,2980
585637_Bnfl.txt,854,19,44,356,112,53,20,541
5858472_GibsonMelodyMaker.txt,561,13,43,225,61,55,11,352
5858513_1998MinnesotaTwins.txt,695,15,46,305,86,48,18,457
5859421_CatlikeAliens.txt,1074,10,107,458,119,94,28,699
5860091_EinarSigurdsson.txt,653,10,65,241,114,24,22,401
5860746_2006NebraskaCornhuskersFootballTeam.txt,2182,34,64,800,304,131,61,1296
5861108_IsabellaOfPortugal.txt,565,11,51,216,62,26,20,324
586257_MichiruKaioh.txt,1471,28,52,532,202,118,72,924
586330_MrTambourineMan.txt,722,18,40,278,85,59,19,441
5864927_ListOfAmphinectidaeSpecies.txt,1443,37,39,1070,25,4,1,1100
5864938_EmpireOfChina19151916.txt,981,14,70,373,107,44,34,558
5865939_SpanishConquestOfMexico.txt,6611,101,65,2113,1002,424,274,3813
5865942_BbcMindgamesMagazine.txt,754,21,35,312,97,58,10,477
586664_UsRoute91.txt,1988,17,116,793,205,111,90,1199
586719_MarcelDionne.txt,1412,22,64,601,152,72,25,850
58708_WaterBuffalo.txt,1494,20,74,603,197,119,66,985
58715_1066AndAllThat.txt,632,12,52,221,77,37,20,355
5871691_Thinwire.txt,581,13,44,242,71,60,26,399
58719_JudyGarland.txt,3188,31,102,1139,433,208,111,1891
58721_ChemicalIndustry.txt,969,12,80,418,108,108,23,657
5872605_MessianicProphecyInChristianity.txt,3546,58,61,1115,561,117,92,1885
5872628_JemsegNewBrunswick.txt,1449,13,111,491,204,102,60,857
58726_MargaretIOfDenmark.txt,1281,18,71,421,180,70,56,727
58727_Alum.txt,2069,30,68,673,340,163,89,1265
58730_PerthScotland.txt,3857,58,66,1549,434,272,120,2375
58731_PeterNaur.txt,618,8,77,249,63,34,9,355
58732_JamesIOfScotland.txt,677,11,61,263,71,32,19,385
58733_Staffordshire.txt,836,20,41,371,79,59,26,535
587362_ManitobaGeneralElection1999.txt,1261,123,10,881,21,81,77,1060
587381_Dangerousalbum.txt,2128,31,68,1270,168,74,39,1551
587388_History.txt,2609,28,93,1367,232,135,53,1787
587392_LightframeConstruction.txt,1015,14,72,390,153,97,37,677
587394_WalterWarlimont.txt,1533,29,52,560,226,88,48,922
587395_BloodOnTheDanceFloorHistoryInTheMix.txt,871,11,79,501,58,26,10,595
587400_Ghatkopar.txt,2604,39,66,1132,319,192,98,1741
587408_WahineDisaster.txt,1127,14,80,398,163,67,31,659
587420_Kandivali.txt,857,20,42,394,114,66,30,604
5874821_MoniqueCovt.txt,1309,24,54,448,172,126,70,816
5875823_Safeworking.txt,710,14,50,209,123,48,31,411
5877183_WindowsLibraryFiles.txt,600,18,33,245,87,47,22,401
5878660_NaturalHeritageDistrictOfJejuIsland.txt,591,6,98,212,78,61,26,377
5880002_ListOfHersiliidaeSpecies.txt,1196,13,92,890,20,9,0,919
5881030_Verucchio.txt,1006,16,62,330,112,76,28,546
588478_R46newYorkCitySubwayCar.txt,1516,14,108,518,248,75,51,892
5885166_50HomeRunClub.txt,1206,6,201,395,134,92,33,654
5887344_SpeedLimitsInAustralia.txt,706,11,64,239,84,91,18,432
5887360_Vfa115.txt,1124,16,70,500,118,46,17,681
5887475_ChteauDeGaillon.txt,1246,16,77,443,152,118,21,734
5888093_JasonWhitenascar.txt,683,15,45,244,95,51,15,405
5889015_BadriMaharaj.txt,1031,12,85,384,142,55,23,604
588902_MelvilleFuller.txt,739,15,49,306,90,30,19,445
5889040_ConstitutionalCourtOfTheRussianFederation.txt,917,16,57,348,119,68,19,554
5889658_ProgramInAmericaAndCaliforniaExplorations.txt,568,16,35,239,79,36,14,368
5890287_Rockwiz.txt,721,20,36,270,96,60,24,450
5891225_2001ASpaceOdysseyscore.txt,587,12,48,239,64,33,14,350
5894263_OcTranspoRoute96.txt,1422,61,23,574,156,81,54,865
5895213_UssArtisanafdb1.txt,726,11,66,252,94,32,23,401
589586_Maidu.txt,923,22,41,376,102,89,32,599
589605_Tsimshian.txt,1608,34,47,787,148,120,49,1104
5896082_JohnFritchey.txt,574,10,57,226,74,36,10,346
5896755_TheEndOfItAll.txt,686,8,85,173,98,66,37,374
5896788_PriestpenitentPrivilegeInTheUk.txt,2463,45,54,738,368,128,91,1325
5897378_AnInstinctForMurder.txt,879,12,73,274,171,39,39,523
5897787_BillTheMindertvSeries.txt,2512,30,83,788,415,97,99,1399
589925_LarryFineactor.txt,1484,25,59,579,191,72,54,896
589981_FranksWildYears.txt,720,7,102,516,17,8,1,542
590052_MortalKombat4.txt,1642,32,51,588,246,121,70,1025
5903755_JonathanClub.txt,634,11,57,242,76,43,9,370
5903807_Irekei.txt,1284,21,61,417,182,76,41,716
5904466_InternationalClassicalGuitarCompetitions.txt,770,54,14,447,24,35,10,516
590696_DefiniteDescription.txt,645,19,33,211,116,40,29,396
590718_MercuryCougar.txt,6047,72,83,2084,754,585,237,3660
5907816_VettaiyaaduVilaiyaadu.txt,604,10,60,296,77,26,10,409
5910303_Biloaustralia.txt,2150,51,42,943,271,142,50,1406
5910550_ShawnSpencer.txt,1229,13,94,569,172,49,34,824
5911594_SpellinggBeepsychEpisode.txt,1370,18,76,504,215,58,48,825
5912207_HoromonaPohio.txt,869,9,96,357,122,35,12,526
5916040_mileMuselier.txt,681,11,61,233,76,47,18,374
5916046_TobiasLear.txt,1324,20,66,461,213,86,57,817
5916332_OppositionalDefianceDisorder.txt,812,16,50,266,111,85,36,498
59166_Cassowary.txt,1017,16,63,365,151,95,44,655
59171_Mumps.txt,2659,59,45,976,372,178,82,1608
59172_JudasIscariot.txt,6366,82,77,2271,886,368,254,3779
59173_IdEgoAndSuperego.txt,971,19,51,366,105,87,33,591
591782_SundiataKeita.txt,738,11,67,328,83,36,24,471
5918373_104thFieldBatteryRoyalAustralianArtillery.txt,620,10,62,237,77,37,14,365
592096_BobbyAbreu.txt,1216,33,36,459,112,89,17,677
592151_EvenAndOddFunctions.txt,753,27,27,236,87,95,72,490
592161_KayStarr.txt,1152,15,76,472,116,62,35,685
5921874_CarmelJackson.txt,1253,15,83,354,245,66,81,746
5922194_ScribbleJam.txt,674,11,61,274,85,53,18,430
59234_BroadbandInternetAccess.txt,3287,63,52,1236,409,333,142,2120
5924074_EmploymentAct1982.txt,1333,29,45,439,229,75,37,780
5924761_CharlesCleggfootballer.txt,1053,17,61,315,169,52,39,575
5926955_CarltonLassiter.txt,1206,13,92,407,185,84,53,729
592784_Rosario.txt,3699,69,53,1584,353,302,85,2324
592798_TheAssociation.txt,1504,17,88,566,167,103,53,889
592843_GertrudeLawrence.txt,829,15,55,343,81,37,17,478
592851_CanwestGlobalCommunications.txt,998,17,58,450,113,88,26,677
5930560_HistoryOfPawnbroking.txt,7591,51,148,2168,1187,499,299,4153
5930588_SamuraiChamplooSidetracked.txt,736,10,73,214,124,49,39,426
5930785_Ventryn.txt,655,11,59,226,111,39,17,393
5930794_K2BlackPanther.txt,907,20,45,316,127,77,35,555
5931857_DragoKolar.txt,799,15,53,424,23,35,4,486
5932464_PiaMiranda.txt,895,15,59,431,74,59,18,582
593247_HarvardSquare.txt,1011,21,48,421,112,98,41,672
593250_UssFlorenceNightingaleap70.txt,589,9,65,257,66,15,7,345
5932762_MouseGuard.txt,1974,55,35,731,279,134,69,1213
5934833_GracieBarra.txt,1314,15,87,1055,45,28,7,1135
5937384_KennethLay.txt,2123,21,101,1030,230,102,22,1384
5938086_ListOfAsteroids121901122000.txt,1333,1,1333,332,0,0,0,332
5938715_ListOfAsteroids123201123300.txt,1303,1,1303,302,0,0,0,302
5938742_ListOfAsteroids123301123400.txt,1322,1,1322,319,0,1,0,320
593874_AnitaPage.txt,702,12,58,295,68,42,12,417
5938764_ListOfAsteroids123401123500.txt,1332,1,1332,331,0,0,0,331
593879_JohnThwaitesbritishPolitician.txt,627,8,78,216,93,36,23,368
593886_RisingDamp.txt,807,16,50,279,117,62,34,492
5939024_NorthAmericanBurlTreen.txt,1634,31,52,508,256,144,91,999
5939104_ListOfAsteroids125101125200.txt,1303,1,1303,302,0,0,0,302
5939119_ListOfAsteroids125201125300.txt,1313,1,1313,310,0,1,0,311
593964_TheSacrifice.txt,815,11,74,273,119,66,30,488
5939678_ListOfAsteroids127901128000.txt,1363,1,1363,362,0,0,0,362
5939702_ListOfAsteroids128001128100.txt,1393,1,1393,382,0,2,0,384
5939727_ListOfAsteroids128101128200.txt,1350,1,1350,349,0,1,0,350
593973_WarragambaDam.txt,745,19,39,284,96,62,22,464
593975_ArnoldNordmeyer.txt,858,14,61,323,127,51,27,528
594265_RobertDudleyStyledEarlOfWarwick.txt,1960,37,52,774,267,73,52,1166
594329_LineOfBattle.txt,2180,31,70,645,294,189,73,1201
5945062_OnePercenteraustralianFootball.txt,881,8,110,250,160,55,49,514
5948108_TriggerPad.txt,728,8,91,244,104,60,53,461
5948957_PrinceArisugawaTakehito.txt,615,15,41,272,48,34,11,365
5949144_KarlMaySchool.txt,2867,28,102,1058,314,257,76,1705
594964_Magicicada.txt,895,23,38,303,116,85,37,541
594976_WendyCope.txt,591,10,59,302,51,20,12,385
5950281_Biogeomancer.txt,600,9,66,235,88,51,11,385
595120_SamuelByck.txt,1094,16,68,382,191,35,39,647
5951240_TheOddfest.txt,610,9,67,270,74,46,21,411
5951297_PeterPetrelli.txt,2251,25,90,678,443,117,114,1352
595137_OlympicStadium.txt,959,16,59,488,93,37,29,647
5952919_CjCarellasWitchcraft.txt,858,15,57,326,113,83,33,555
595367_Macaroon.txt,734,12,61,279,112,53,36,480
5953919_ContemplativeEducation.txt,697,23,30,267,80,64,25,436
5955096_Geppettofables.txt,1777,18,98,492,311,125,96,1024
5956836_SingaporeInMalaysia.txt,1102,17,64,399,135,92,32,658
5960345_WilliamLyndwood.txt,624,8,78,209,78,57,29,373
596056_TheTypingOfTheDead.txt,913,20,45,314,135,72,30,551
596114_GreyGooseVodka.txt,575,11,52,244,67,52,20,383
596136_WembleyArena.txt,754,17,44,386,67,41,16,510
596210_TheMousetrap.txt,1046,21,49,341,164,49,47,601
596221_TristanChord.txt,1718,23,74,603,194,162,61,1020
5962878_CombinationGun.txt,1111,16,69,382,139,111,58,690
5963847_YearUp.txt,1178,57,20,561,126,69,15,771
5964167_SuzanneLacy.txt,673,27,24,345,33,44,4,426
5964541_CharlesPaulConn.txt,611,29,21,324,47,20,13,404
596497_MazerRackham.txt,828,12,69,267,143,57,31,498
596516_MahjongTiles.txt,1581,35,45,511,196,152,63,922
5966695_AfricanamericanStereotypes.txt,672,26,25,254,88,74,26,442
5966720_StereotypesOfLatinos.txt,680,9,75,259,90,68,27,444
5967710_RalphGraham.txt,565,12,47,232,67,37,10,346
5968710_FifaFootball2004.txt,747,13,57,424,57,39,14,534
5971894_ListOfAsteroids6630166400.txt,1312,1,1312,310,0,0,0,310
597229_ProductLifecycleManagement.txt,2644,43,61,1081,374,220,92,1767
597296_KevinPChilton.txt,673,15,44,334,62,26,10,432
597313_MaryLCleave.txt,625,10,62,331,50,37,5,423
5973231_ListOfMusiciansSignedToEmi.txt,756,10,75,605,25,16,10,656
5973244_AnnieCamden.txt,587,13,45,280,63,16,17,376
5974081_Deepavalifilm.txt,604,8,75,199,107,18,21,345
5974165_RiverKent.txt,1029,11,93,396,111,80,47,634
5974208_SteveStigmatic.txt,2610,46,56,839,413,192,131,1575
5974777_ListOfPfunkProjects.txt,4937,47,105,3466,91,49,26,3632
597584_TreeTraversal.txt,1401,43,32,536,175,103,57,871
5976346_UnionphilanthropicSociety.txt,651,13,50,373,44,44,13,474
597652_VictorioCEdades.txt,1704,24,71,665,224,111,50,1050
597656_Moff.txt,609,15,40,260,81,34,17,392
5976746_AlbemarleStreet.txt,601,15,40,292,64,26,13,395
59789_DerekParfit.txt,2106,24,87,609,328,198,146,1281
59790_Farm.txt,651,20,32,230,109,53,28,420
5979291_GeneticOriginsOfDownSyndrome.txt,856,14,61,262,111,103,26,502
5979574_JohnDemita.txt,598,6,99,347,16,6,4,373
59799_MissionSanGabrielArcngel.txt,793,11,72,357,77,37,16,487
59801_UniversityOfVirginia.txt,5396,74,72,2063,623,438,159,3283
5980275_MikaKallio.txt,522,18,29,198,49,24,19,290
59804_HaveSpaceSuitwillTravel.txt,1481,19,77,512,224,99,62,897
59806_allYouZombies.txt,1377,29,47,402,214,75,61,752
59808_ByHisBootstraps.txt,1309,19,68,364,224,70,68,726
5980941_ListOfCharactersInRobotboy.txt,1910,31,61,639,320,127,95,1181
5980952_1995MinnesotaTwins.txt,615,14,43,251,66,54,22,393
5981234_MustangSoftware.txt,699,27,25,289,111,41,19,460
5982934_GlossaryOfBagpipeTerms.txt,17707,68,260,6712,2247,1364,527,10850
598293_Divinyls.txt,843,17,49,342,103,51,27,523
59831_TheGreenHillsOfEarth.txt,849,18,47,348,93,60,24,525
59832_TheLongWatch.txt,2962,36,82,848,438,273,161,1720
598345_CellSite.txt,709,10,70,270,93,61,27,451
598346_CapturingTheFriedmans.txt,1093,27,40,408,189,49,40,686
598347_Banausos.txt,1186,20,59,435,143,96,38,712
59834_TheManWhoSoldTheMoon.txt,1263,23,54,408,218,81,48,755
598386_GordonParks.txt,1659,38,43,734,189,104,25,1052
598397_ShaunOfTheDead.txt,2920,29,100,1080,373,184,99,1736
598398_BrianDuffy.txt,633,18,35,308,60,28,7,403
598405_PotchefstroomNorthWest.txt,1449,31,46,602,156,126,46,930
5985748_ListOfVampiresInFolkloreAndMythology.txt,513,45,11,304,25,14,4,347
5985775_200PoVstrechnoy.txt,387,10,38,216,19,27,5,267
5986299_1830sInTheUnitedStates.txt,580,4,145,200,80,48,26,354
598688_ThomasLigotti.txt,1170,19,61,543,112,79,33,767
598738_NorthCarolinaGeneralAssemblyOf1778.txt,1054,12,87,751,101,20,1,873
5987957_WesternSaloons.txt,973,26,37,417,125,60,27,629
5987959_JuliaLennon.txt,2538,33,76,871,418,133,102,1524
5989620_KingsCollegeHarmonicaBand.txt,580,7,82,250,62,48,10,370
5989642_UnitarianChristianGroupsAndPublications.txt,907,42,21,347,104,99,38,588
5989657_MedicalCommunityOfAncientRome.txt,3665,50,73,1205,574,286,125,2190
5990635_TwentyFourSevenTour.txt,1093,15,72,707,28,24,9,768
5991221_EorpwaldOfEastAnglia.txt,847,10,84,302,89,67,36,494
5993511_VictorSmolski.txt,1219,28,43,505,133,85,34,757
5993806_QuantumRelativeEntropy.txt,755,62,12,244,96,68,25,433
599435_SiegeOfSidneyStreet.txt,622,14,44,231,92,26,18,367
599440_JohnHeminges.txt,823,6,137,325,102,42,20,489
5994440_ForestMage.txt,746,12,62,314,92,46,28,480
5994479_TheVeryBestOfTheEagles2003.txt,590,12,49,378,18,13,7,416
5996626_ForeverYoungalphavilleSong.txt,577,10,57,227,62,52,29,370
599776_DeploymentOfJapaneseTroopsToIraq.txt,1046,20,52,372,168,80,29,649
5999515_2006LsuTigersFootballTeam.txt,872,40,21,331,111,47,17,506
6001170_TheBoxSet.txt,577,8,72,322,23,16,9,370
6001176_JesseHawleyfootball.txt,823,14,58,304,113,46,32,495
6003729_DirectSupportProfessional.txt,859,17,50,448,70,42,18,578
6004352_FranciscoCeinos.txt,662,12,55,259,67,40,15,381
6004361_BurtIngwersen.txt,1044,20,52,378,158,57,43,636
6004694_KingsOfProfessionalWrestling.txt,926,14,66,452,86,29,21,588
6007241_MissWorld2005.txt,1204,349,3,909,40,39,8,996
6008203_YuTodoroki.txt,606,17,35,289,47,32,10,378
6008902_McclellanMagnetHighSchool.txt,589,10,58,268,62,36,10,376
6009199_WoodRadio.txt,1123,19,59,469,132,80,35,716
6009824_Bitag.txt,1702,26,65,648,225,115,87,1075
6010868_BadDreamstheWireEpisode.txt,2241,30,74,909,368,59,68,1404
6014698_AtaruKinniku.txt,599,14,42,260,88,29,12,389
6014922_OssieSolem.txt,888,18,49,313,128,53,37,531
6014946_ListOfActsOfParliamentOfTheEnglishParliament1700To1706.txt,8711,20,435,4654,422,241,24,5341
601621_HubbertPeakTheory.txt,7525,107,70,2990,923,631,291,4835
601657_SlappySquirrel.txt,800,16,50,335,86,48,37,506
6016593_HippolyteEtAricie.txt,1335,21,63,517,191,86,42,836
601663_ListOfMonotremesAndMarsupials.txt,2092,16,130,1751,126,157,13,2047
6017509_Scalpingtrading.txt,1378,26,53,469,210,100,62,841
6018452_MyrtleBeachPavilion.txt,1152,16,72,435,153,78,38,704
6018453_Helvetism.txt,3835,46,83,2015,395,453,170,3033
6018545_2006RinkHockeyEuropeanChampionship.txt,492,65,7,260,34,21,11,326
6018557_SaratogaRaceway.txt,571,20,28,219,72,37,9,337
6019792_GlossaryOfPaintballTerms.txt,5029,129,38,1651,721,337,251,2960
6019813_OperationalTransconductanceAmplifier.txt,848,28,30,286,102,102,22,512
602068_Cynocephaly.txt,759,8,94,284,79,75,22,460
602070_CommunesOfTheMoselleDepartment.txt,902,3,300,155,6,44,4,209
6024579_DeepSnowraveMaster.txt,793,11,72,277,118,41,26,462
6024597_CrunchTheRockdog.txt,783,12,65,287,116,31,28,462
6025611_HistoryOfTheSydneyRoosters.txt,2908,43,67,950,400,220,107,1677
60256_JeanDeLaFontaine.txt,3021,34,88,912,416,247,177,1752
60257_MarineMammal.txt,600,11,54,257,74,58,19,408
602650_TypeSafety.txt,1632,27,60,577,239,158,82,1056
60265_SelfprogrammingLanguage.txt,2475,67,36,806,390,175,111,1482
602663_KarlRobertEduardVonHartmann.txt,740,7,105,292,88,52,28,460
602675_BirdsOfPreycomicBook.txt,1383,13,106,586,168,83,37,874
602676_OriginsOfBaseball.txt,2970,53,56,1023,436,205,126,1790
602678_ExtraterrestrialSkies.txt,4942,95,52,1568,511,467,270,2816
602691_KarlChristianFriedrichKrause.txt,654,8,81,248,70,46,14,378
6027152_ParadiseEstate.txt,617,11,56,237,91,25,22,375
6027285_HumpRidgeTrack.txt,629,15,41,256,88,37,15,396
6028452_MokonaModoki.txt,803,14,57,294,108,58,20,480
6030119_BombersgaryNumanSong.txt,622,9,69,243,74,52,14,383
6030138_RoyalCanadianSeaCadetTraining.txt,1102,27,40,542,122,79,27,770
6030161_Legacyband.txt,719,8,89,278,106,48,16,448
603034_CharlotteOfSpain.txt,644,11,58,285,72,24,17,398
6030993_IowaHighway92.txt,1110,11,100,490,79,36,27,632
6033686_SalehMohamedAlZuba.txt,696,16,43,263,133,27,23,446
6033880_TheTomorrowBoys.txt,870,8,108,266,165,35,30,496
6033971_DavidWPipesJr.txt,1183,24,49,514,122,78,24,738
6033974_1stScoutRangerRegiment.txt,556,18,30,274,58,36,17,385
6035018_ClashAtDemonhead.txt,1096,22,49,408,172,74,39,693
603768_SingaporeExpo.txt,607,10,60,215,81,51,24,371
603791_Nezhadeity.txt,663,13,51,230,88,51,37,406
603834_IransPremierFootballLeague.txt,949,21,45,425,97,60,32,614
603843_MonaSahlin.txt,1694,33,51,600,232,104,54,990
603861_SunshineCoastQueensland.txt,972,30,32,448,94,88,18,648
6041740_Ldnsong.txt,666,15,44,267,89,48,22,426
604183_MetroidZeroMission.txt,1644,23,71,620,227,128,84,1059
6045861_EddieAndersonfootball.txt,1329,23,57,518,168,65,29,780
6046419_ListOfSchoolsInTheNorthWestOfEngland.txt,3324,179,18,2873,29,88,29,3019
6046552_DavidCarruthers.txt,1800,48,37,696,273,72,55,1096
6047397_AmatlnDeCaas.txt,965,31,31,357,98,93,16,564
604896_LifeCycleAssessment.txt,1195,24,49,490,166,93,38,787
604897_MillieHughesfulford.txt,691,9,76,346,53,27,5,431
6049138_Kyushindo.txt,1186,25,47,383,176,90,46,695
604941_BrentWJettJr.txt,735,16,45,357,70,33,12,472
604950_RobertOfBellme3rdEarlOfShrewsbury.txt,848,17,49,289,129,61,20,499
6051414_ListOfUtahStateLegislatures.txt,852,22,38,431,1,18,0,450
6052297_SonnyGrandelius.txt,585,13,45,229,62,19,13,323
6052628_LycanthropedungeonsDragons.txt,708,19,37,253,94,89,36,472
605272_Wgnam.txt,643,14,45,305,61,38,18,422
605275_BattleOfLongewala.txt,1045,16,65,391,149,72,35,647
6052935_Tsuyokiss.txt,2460,52,47,771,386,184,124,1465
605336_ClarkeCollege.txt,1418,29,48,553,176,91,29,849
6053554_AgainstTheDay.txt,4527,85,53,1845,479,313,152,2789
605386_RedGrange.txt,1200,23,52,454,163,59,25,701
605392_MotionToSetAsideJudgment.txt,613,7,87,186,103,44,23,356
6055278_GeorgeHibbert.txt,628,10,62,254,70,32,18,374
6057379_Mapmyindia.txt,697,10,69,246,98,69,24,437
606000_Papillomavirus.txt,4261,51,83,1868,492,417,132,2909
606034_UssEnterprisencc1701d.txt,909,14,64,413,102,66,13,594
606046_UssEnterprisencc1701a.txt,1035,18,57,418,138,65,20,641
6060518_ReligionInTheNetherlands.txt,828,14,59,295,92,74,21,482
6060520_NorthwindHighlanders.txt,1037,24,43,358,169,57,44,628
6062205_Centralworld.txt,593,14,42,245,88,41,18,392
6063415_WcauNewsTeam.txt,2219,43,51,962,234,85,62,1343
6063545_WpvitvAnchors.txt,1824,23,79,727,249,70,59,1105
606354_PrimeMinisterOfSouthKorea.txt,1133,15,75,503,70,18,6,597
6064502_Stembike.txt,741,22,33,266,84,50,34,434
606476_SayAnything.txt,1460,15,97,586,178,67,45,876
606485_CopleySquare.txt,595,15,39,254,64,36,12,366
6069221_Essembly.txt,614,6,102,196,86,65,23,370
6070908_TatraT3.txt,948,24,39,309,124,98,41,572
607106_LarryBowa.txt,602,9,66,218,69,40,11,338
607122_JebBradley.txt,1109,24,46,429,134,76,19,658
607128_ConstructionsOfSubjectivityInFranzSchubertsMusic.txt,777,9,86,237,108,78,46,469
6072130_MichaelTShelby.txt,731,20,36,329,77,43,5,454
6073102_ListOfCollegesByMascot.txt,3171,245,12,2909,9,43,5,2966
6073394_Dave.txt,580,14,41,187,92,71,26,376
6073758_DeathHeart.txt,582,15,38,198,91,50,28,367
607502_HenriNouwen.txt,989,17,58,326,140,52,38,556
6075079_SiegeOfFlorence15291530.txt,1015,16,63,328,172,36,36,572
607567_LaceyVMurrowMemorialBridge.txt,758,10,75,259,126,48,18,451
607571_WhiteSoxcubsRivalry.txt,3205,26,123,1162,409,226,129,1926
607572_OrganizationalStructure.txt,903,24,37,338,109,104,33,584
607574_SixFlagsOverTexas.txt,3073,44,69,1516,319,151,60,2046
607576_WoodenRollerCoaster.txt,1458,11,132,693,141,104,57,995
6075989_EastEuropeanCraton.txt,568,5,113,274,40,41,12,367
6076925_EmilyAnnAndMaggieHaysNickelMines.txt,1250,21,59,421,180,147,49,797
6076948_OrphansOfTheHelix.txt,803,9,89,229,131,59,47,466
6076954_CarmenContrerasbozak.txt,570,17,33,247,79,27,10,363
6078582_YeopMahidinBinMohamedShafiff.txt,585,16,36,265,85,20,9,379
6080829_AndrAndrejew.txt,2686,115,23,1531,174,108,35,1848
6080831_StateOfShinshi.txt,1156,15,77,466,158,56,28,708
608199_WarOfAggression.txt,1003,14,71,358,113,58,15,544
608209_XunZi.txt,3200,32,100,916,550,219,163,1848
608223_LaneTheologicalSeminary.txt,1333,18,74,476,185,86,30,777
6082474_2006NotreDameFightingIrishFootballTeam.txt,4604,54,85,1745,572,314,92,2723
6082489_ColquiosDosSimplesEDrogasDaIndia.txt,1546,29,53,776,165,105,48,1094
6083474_SmartDisplay.txt,870,23,37,394,98,53,25,570
6084776_AlejandroCasona.txt,689,12,57,464,39,19,1,523
6085651_Sefa.txt,676,10,67,218,114,51,34,417
6087522_Adeyto.txt,1295,45,28,647,108,85,15,855
60883_Watch.txt,5136,103,49,1725,689,594,266,3274
60886_LevYashin.txt,916,20,45,358,95,50,22,525
60891_Surveying.txt,2380,28,85,866,374,162,90,1492
60895_LandOfHopeAndGlory.txt,655,14,46,254,104,58,27,443
60899_GreasySpoon.txt,1522,39,39,612,191,171,74,1048
60900_Carp.txt,1064,18,59,430,144,124,43,741
60901_PompAndCircumstanceMarches.txt,675,8,84,274,74,52,15,415
60904_SergeyBrin.txt,654,12,54,288,74,32,20,414
60906_SocialistUnityPartyOfGermany.txt,2360,25,94,867,293,201,65,1426
60907_GeneRayburn.txt,1476,26,56,577,179,98,33,887
60908_CommonCarp.txt,581,13,44,181,74,77,18,350
60909_MatchGame.txt,7169,129,55,2771,903,473,236,4383
6091153_DeLaSalleUniversitymanilaCollegeOfLiberalArts.txt,647,8,80,340,14,54,5,413
60911_PressYourLuck.txt,5542,64,86,1703,830,351,236,3120
60912_QjamesBond.txt,2391,42,56,979,318,122,116,1535
60918_ScottishFootballLeague.txt,894,33,27,341,124,49,25,539
60921_BattleOfTheSomme.txt,6848,85,80,2207,915,574,226,3922
6092440_MartyPuccio.txt,811,20,40,296,133,46,35,510
6092442_Stienski.txt,633,50,12,273,73,42,17,405
609289_HarpsichordConcerto.txt,902,12,75,374,62,53,19,508
609294_PortCharles.txt,1119,20,55,551,102,45,42,740
609309_DestroyerEscort.txt,1444,25,57,622,157,90,49,918
6093378_SuperMonacoGp.txt,836,16,52,380,100,54,24,558
6098209_ListOfAsteroids130601130700.txt,1315,1,1315,313,0,0,0,313
6098910_MitchellBrothersOfarrellTheatre.txt,1561,19,82,608,220,109,35,972
6098911_TheSaruyamaAlliance.txt,1077,21,51,395,139,51,39,624
6102720_JacobCochran.txt,1019,15,67,360,150,80,35,625
6102770_OnTheMake.txt,1396,23,60,530,190,116,55,891
610351_ProsecutorsManagementInformationSystem.txt,1283,19,67,523,161,68,31,783
6103717_TMarshallHahn.txt,689,12,57,322,56,26,8,412
6103723_ListOfAsteroids133001133100.txt,1349,1,1349,344,0,0,0,344
610378_JeremyBeadle.txt,599,11,54,260,57,30,20,367
610386_Kundapura.txt,573,15,38,215,86,33,16,350
6104940_SteppinOutWithTheGratefulDeadEngland72.txt,555,8,69,376,6,6,3,391
6106602_1001NightsOfSnowfall.txt,606,14,43,234,68,35,16,353
610755_DiYu.txt,1188,19,62,454,144,80,33,711
610773_PerunitSystem.txt,594,27,22,220,77,57,21,375
610832_HardCoreLogo.txt,917,18,50,334,141,61,42,578
6108790_StopTheClocks.txt,1440,30,48,521,195,78,51,845
6109866_PasukanGerakanKhas.txt,1387,37,37,751,134,54,33,972
6111425_ClanHamilton.txt,1474,38,38,543,174,108,49,874
6111456_GuideToDaresAndBadHabits.txt,1087,15,72,352,177,52,53,634
6112660_Gellish.txt,777,14,55,262,99,76,11,448
6113705_CatherineOfGenoa.txt,610,9,67,175,78,35,23,311
611475_Qufu.txt,1391,16,86,493,157,107,32,789
611480_HistoryOfRyukyuIslands.txt,2726,39,69,962,385,245,92,1684
611482_RykyKingdom.txt,1704,18,94,705,211,114,43,1073
6114886_TomMastny.txt,610,9,67,231,83,41,21,376
6114944_TerrorismInSyria.txt,670,11,60,314,71,41,11,437
6115319_MilitaryAndEconomicAidInThe2006IsraellebanonConflict.txt,904,21,43,362,130,56,26,574
611919_SriLankaJunglefowl.txt,705,16,44,243,85,86,35,449
6121294_BloodPackfilm.txt,1188,16,74,412,188,55,45,700
6122973_HectorZazou.txt,1020,17,60,567,81,80,5,733
612479_HydrogenLine.txt,1149,17,67,424,138,75,42,679
6125158_TheCreeperjeepersCreepers.txt,1774,25,70,527,270,115,92,1004
612538_Cz75.txt,903,13,69,377,87,92,23,579
612549_RichardMorrisHunt.txt,1147,11,104,535,103,64,18,720
6125870_JamesBeatonIi.txt,908,6,151,302,100,53,23,478
612625_Jokerit.txt,2435,39,62,979,255,197,81,1512
612633_DeHavillandExpress.txt,1231,18,68,410,184,109,48,751
612650_LuceIrigaray.txt,635,14,45,233,76,40,16,365
6129006_RoyalUnitedServicesInstitute.txt,760,19,40,312,90,44,14,460
6129142_EarlWRenfroe.txt,903,24,37,378,94,58,20,550
612934_Telemarketingcanada.txt,592,8,74,189,99,42,14,344
612945_Assur.txt,882,14,63,360,97,64,15,536
6131677_Wftl.txt,555,34,16,261,51,37,17,366
6131698_VehicleInspection.txt,832,19,43,336,107,62,22,527
6132875_SriLankanRiotsOf1958.txt,973,34,28,339,177,57,29,602
6132894_Wfpg.txt,581,5,116,267,78,31,14,390
6133859_ZoeyMebookSeries.txt,924,24,38,278,146,62,56,542
61343_Intestine.txt,949,11,86,316,141,86,41,584
61344_Lightning.txt,7115,113,62,2374,1068,658,305,4405
61346_CommutativeRing.txt,1028,16,64,375,122,114,40,651
6135527_PutnamCityNorthHighSchool.txt,1759,22,79,770,196,120,53,1139
6135750_LumenChristiCatholicHighSchool.txt,3766,61,61,1363,493,259,94,2209
6136_CarbonMonoxide.txt,1629,38,42,648,231,149,53,1081
613714_NewEnglandHighway.txt,2428,52,46,1035,237,161,55,1488
6137903_SaharanAirLayer.txt,579,9,64,206,71,40,29,346
6138440_KarenPeckAndNewRiver.txt,948,58,16,504,64,37,14,619
6138_Conjecture.txt,746,16,46,230,117,71,47,465
6139396_FairlieBranch.txt,816,15,54,302,119,43,32,496
614023_FrenchNationalPolice.txt,662,8,82,328,52,52,14,446
614030_Ozone.txt,588,14,42,238,73,42,15,368
614036_Megiddoplace.txt,1447,28,51,536,197,117,36,886
61404_SylvesterStallone.txt,3063,32,95,1249,352,192,109,1902
61406_UniversityOfBarcelona.txt,1754,34,51,645,207,89,35,976
614085_GoodManufacturingPractice.txt,801,12,66,329,105,59,26,519
6140_Claudius.txt,7095,64,110,2289,1085,499,320,4193
614729_MungoJerry.txt,1258,16,78,559,107,67,31,764
6147746_ConfessionInJudaism.txt,457,11,41,139,76,20,21,256
6148078_HenryAlley.txt,1179,17,69,542,49,32,9,632
6149282_It1966Film.txt,1833,18,101,603,293,71,51,1018
615057_BayanlgiyProvince.txt,687,18,38,265,77,56,21,419
6150962_ForeverInTerror.txt,755,15,50,295,111,61,25,492
6150970_RobotechTheMovie.txt,601,10,60,272,70,46,22,410
615108_PoyntingrobertsonEffect.txt,654,17,38,228,80,59,30,397
6151648_IlkaTanyaPayan.txt,676,10,67,228,91,34,24,377
6151958_GulTiger.txt,634,14,45,237,95,46,28,406
6152294_Nepalband.txt,823,23,35,372,92,38,9,511
6153149_SouthDevonRailwayCometClass.txt,635,6,105,229,96,15,10,350
6153166_Defibrotide.txt,887,17,52,314,148,108,36,606
6154833_DaryoushAshouri.txt,487,8,60,214,34,65,3,316
6154866_TripuriCulture.txt,3038,67,45,1112,449,177,83,1821
6157004_XakTheTowerOfGazzel.txt,1095,11,99,418,139,71,48,676
6157005_KualaKrai.txt,1265,19,66,538,142,72,26,778
6158003_Wxxm.txt,1619,24,67,672,199,113,37,1021
615807_Romrio.txt,1346,22,61,481,158,96,36,771
615810_Zico.txt,1832,34,53,715,194,144,49,1102
615815_TefiloCubillas.txt,645,12,53,263,49,44,6,362
6159324_EastsideBirmingham.txt,1994,39,51,700,346,127,65,1238
6159646_AssertiveCommunityTreatment.txt,1192,9,132,460,139,142,40,781
616252_Palencia.txt,1171,14,83,457,141,80,22,700
616254_OneidaTribe.txt,992,16,62,484,82,47,17,630
6162556_Dominationrapper.txt,627,8,78,243,86,48,18,395
616255_GovernmentOfCanada.txt,1749,20,87,559,259,145,67,1030
6165734_IncidentsAtSixFlagsParks.txt,1952,37,52,695,319,117,42,1173
6166673_AdelaideRaiders.txt,593,12,49,222,73,41,21,357
6167361_CommunityOfChristdifferentiationFromLatterdaySaints.txt,1724,21,82,628,220,123,72,1043
6167375_LaissezFaireBooks.txt,914,21,43,392,108,60,17,577
616886_Flickerscreen.txt,1102,12,91,348,178,104,62,692
616898_KateRoberts.txt,823,14,58,361,65,38,19,483
6171222_AmericanIndianReligiousFreedomAct.txt,824,17,48,283,115,100,27,525
617355_KingdomOfCornwall.txt,576,13,44,224,89,37,17,367
6175703_Gcsej.txt,738,10,73,289,85,67,23,464
6176085_GntherEnderlein.txt,2055,44,46,874,234,187,47,1342
6177059_Takuu.txt,954,16,59,366,130,67,29,592
6177287_LouisianaBarExam.txt,747,11,67,249,133,51,30,463
6177297_CuthbertAllgood.txt,1355,33,41,442,218,76,56,792
617991_VickersWarwick.txt,664,22,30,293,97,37,7,434
617993_TheMarked.txt,736,15,49,408,56,28,18,510
617999_MelchiorDeVog.txt,545,6,90,284,37,50,6,377
618076_Opticks.txt,695,8,86,214,88,75,27,404
618077_PowerEngineering.txt,667,19,35,231,92,84,32,439
6180870_SoulmanAlexG.txt,835,15,55,456,62,39,18,575
6180875_CityOfDublinSteamPacketCompany.txt,674,7,96,265,58,27,12,362
6182210_PopulusTremuloides.txt,679,8,84,237,94,68,28,427
6182536_HumansanitaBlakeMythology.txt,1197,24,49,382,200,108,63,753
6183527_JohnAndersoncalScale.txt,861,18,47,387,110,31,18,546
618435_Subjectivism.txt,882,13,67,244,128,88,35,495
618442_FlamingoRoad.txt,2579,27,95,1016,362,129,99,1606
6186410_LaudaSion.txt,877,5,175,449,92,70,21,632
6187286_QiryatChaimRailwayStation.txt,587,16,36,269,54,35,8,366
6187362_WojciechBobowski.txt,926,15,61,336,117,81,28,562
6187371_DaveAllison.txt,850,14,60,293,94,25,14,426
6187396_ArnoldAdoff.txt,1331,11,121,720,112,43,15,890
6187_Cologne.txt,4329,56,77,1658,475,385,125,2643
618873_GalloromanCulture.txt,723,20,36,293,73,85,19,470
618874_Tauri.txt,3498,48,72,1190,495,287,147,2119
618883_Acinetobacter.txt,1703,33,51,931,148,153,45,1277
6188_BuddhistCuisine.txt,1073,10,107,335,165,111,65,676
618900_StargateCommand.txt,2551,29,87,1033,352,169,75,1629
618929_GhostbustersIi.txt,3511,39,90,1381,481,165,115,2142
618936_ReligiousLeadersByYear.txt,690,8,86,61,3,8,1,73
6192201_JohnnyGraham.txt,807,16,50,350,116,50,14,530
6192207_IanMoor.txt,1025,35,29,483,98,75,22,678
6192441_TheCheetahGirls2soundtrack.txt,945,21,45,348,117,57,28,550
6194384_ThatsNoLady.txt,822,21,39,356,99,39,33,527
6194389_YoctangeePark.txt,900,23,39,396,95,47,28,566
619526_WangYangming.txt,866,17,50,325,125,58,17,525
619594_Aciclovir.txt,949,20,47,379,147,115,50,691
6195963_Quickmixtransformers.txt,1379,29,47,525,184,104,52,865
6195971_EnricoRastelli.txt,682,11,62,218,107,46,31,402
6195_CalvinCoolidge.txt,5652,63,89,2099,812,331,172,3414
61976_AdmiralKuznetsovClassAircraftCarrier.txt,1263,21,60,538,140,75,34,787
61978_NelsonNewZealand.txt,1194,24,49,476,137,78,36,727
6198225_ChnSangpyng.txt,717,11,65,192,124,53,33,402
61982_RobertRedford.txt,2072,25,82,873,216,168,46,1303
61983_Tannin.txt,1034,28,36,378,152,122,45,697
61987_JamesFrancisEdwardStuart.txt,683,10,68,255,98,27,18,398
6198_ConventionOnBiologicalDiversity.txt,1292,22,58,664,118,89,23,894
61990_Trilobite.txt,1983,34,58,682,282,217,95,1276
61992_BattleOfTheCoralSea.txt,1833,27,67,683,252,143,75,1153
61994_GermanPocketBattleshipAdmiralGrafSpee.txt,1855,29,63,764,240,109,53,1166
619967_KarlSeitz.txt,665,6,110,244,89,51,30,414
619973_Betwsycoed.txt,685,18,38,279,66,69,12,426
619978_BethesdaGwynedd.txt,670,10,67,219,92,54,21,386
619980_Thermocline.txt,648,10,64,207,83,36,36,362
619983_ListOfAppleIiGames.txt,950,32,29,757,18,11,6,792
619987_ListOfReligiousLeadersIn2004.txt,872,10,87,549,4,98,1,652
61998_JohnGrisham.txt,1024,17,60,383,118,68,28,597
61999_DanielleSteel.txt,877,15,58,416,73,42,13,544
62001_Priphriqueparis.txt,651,12,54,224,68,69,18,379
62004_GertrudeStein.txt,2652,59,44,1000,348,181,100,1629
62008_AcademyAwardForCostumeDesign.txt,2510,17,147,1646,14,40,5,1705
6201122_JeanTaubenhaus.txt,628,9,69,265,73,31,5,374
6201_Cites.txt,1808,20,90,661,277,121,62,1121
6202471_BirminghamGateway.txt,1109,24,46,355,194,51,40,640
6202821_EvolutionEngine.txt,842,14,60,288,108,88,31,515
6204340_OrganizationOfTheUnitedStatesCoastGuard.txt,1196,28,42,597,140,68,41,846
6204765_StationGroups.txt,2016,30,67,728,297,133,87,1245
6205_ChaitinsConstant.txt,793,15,52,254,110,67,40,471
620669_SunilDutt.txt,685,23,29,289,65,30,12,396
6206_ComputableNumber.txt,1287,28,45,355,193,175,62,785
620734_ListOfBandsWhichPermitRecordingsOfTheirPerformances.txt,759,30,25,574,24,21,9,628
6207543_CharlotteJones.txt,895,12,74,293,160,58,34,545
62078_UssHousatonic1861.txt,684,10,68,272,95,31,19,417
62079_HLHunleysubmarine.txt,2430,24,101,952,341,117,70,1480
6207_ElectricCurrent.txt,1639,33,49,519,192,219,61,991
62084_TheAdventuresOfRobinHoodfilm.txt,928,21,44,373,138,35,24,570
6208640_HawkesburyRiverRailwayBridge.txt,922,26,35,310,131,62,28,531
6208852_OldBlack.txt,592,8,74,240,78,50,25,393
6208860_HongQigong.txt,648,7,92,232,86,48,28,394
6209225_GilgalRefaim.txt,1235,23,53,394,156,123,45,718
62092_Trotskyism.txt,2370,35,67,833,326,175,77,1411
62093_PrincePhilipDukeOfEdinburgh.txt,4159,59,70,1601,558,206,141,2506
62097_GrandIllusionfilm.txt,2646,40,66,924,343,239,82,1588
621056_Krumping.txt,1985,16,124,714,278,181,87,1260
621057_Clowning.txt,614,6,102,175,152,44,28,399
621063_AmericasNextTopModel.txt,2328,27,86,1000,303,144,52,1499
621076_Smartask.txt,2436,32,76,897,335,138,87,1457
62107_TrafalgarSquare.txt,2292,51,44,886,299,167,51,1403
6210_ClarkAshtonSmith.txt,1229,41,29,616,84,69,27,796
621109_HollandaiseSauce.txt,802,27,29,277,129,65,49,520
6211397_Klaverjas.txt,801,10,80,255,106,57,34,452
62113_GoodbyeMrChips.txt,1026,17,60,372,150,76,31,629
62114_LouisXviiiOfFrance.txt,1455,15,97,480,199,96,50,825
62117_MrSmithGoesToWashington.txt,1204,16,75,491,163,54,29,737
62118_Ninotchka.txt,585,11,53,251,72,46,10,379
62119_BradfordsLaw.txt,562,10,56,205,67,43,31,346
6211_ContextsensitiveGrammar.txt,651,12,54,181,92,84,31,388
6212049_PlmCollegeOfNursing.txt,805,21,38,430,64,40,18,552
62120_OfMiceAndMen.txt,2287,26,87,786,339,136,99,1360
6212456_AlcibiadesfictionalCharacter.txt,766,15,51,324,77,58,24,483
6213073_Lengvenis.txt,538,8,67,238,26,6,3,273
6213695_Lateralussong.txt,757,18,42,201,128,56,36,421
6213705_NorthCarolinaHighway147.txt,691,7,98,295,58,43,22,418
6213708_August2006InSports.txt,3093,36,85,1628,189,149,26,1992
6215390_YaghnobiPeople.txt,578,9,64,198,84,43,17,342
621697_100GreatestKidsTvShows.txt,491,7,70,305,34,12,8,359
6216_ChineseRoom.txt,2145,29,73,660,349,185,126,1320
621709_Gounki.txt,539,26,20,208,64,35,24,331
6217572_CampSealth.txt,778,14,55,333,133,37,11,514
621764_WipoCopyrightAndPerformancesAndPhonogramsTreatiesImplementationAct.txt,1635,31,52,629,284,71,51,1035
621828_AustinBlair.txt,892,14,63,321,130,50,25,526
621881_TigerBarb.txt,845,17,49,272,119,93,31,515
6219224_HhsaaStateFootballChampionshipoahuPrepBowl.txt,841,21,40,368,83,37,15,503
6220183_PaulGardiner.txt,639,17,37,269,63,46,16,394
6220_Circle.txt,1692,42,40,600,193,114,39,946
6221048_TropicalStormDanielle1992.txt,1265,19,66,499,132,114,37,782
622150_HostsFile.txt,1720,26,66,622,258,141,53,1074
622165_UlrichGrafVonBrockdorffrantzau.txt,1069,16,66,333,167,67,26,593
622201_HerodsTemple.txt,2262,52,43,700,320,160,100,1280
622203_ListOfNewZealandPlaceNamesAndTheirMeanings.txt,939,2,469,421,99,49,13,582
622205_LineOfSuccessionToTheSwedishThrone.txt,1540,53,29,1078,9,65,5,1157
6225059_NeilMerryweather.txt,1250,24,52,557,143,74,37,811
6225265_HostilitiesBetweenNorthAndSouthKoreaSince1953.txt,839,44,19,385,100,37,11,533
6226241_Meljol.txt,750,25,30,247,107,64,34,452
6226_ClaudioMonteverdi.txt,1248,19,65,435,166,124,44,769
6227809_PrefectureApostolicOfTheDeltaOfTheNile.txt,642,7,91,233,50,41,10,334
6227909_ChteauDeSaintgermainenlaye.txt,685,10,68,235,87,58,13,393
6227921_OGuarany.txt,593,7,84,219,80,47,21,367
6229_ColossusComputer.txt,2533,32,79,979,358,189,81,1607
6230126_BaltimoreCountyPublicLibrary.txt,3887,138,28,1919,425,246,46,2636
6230_CanadianShield.txt,1174,16,73,418,154,111,57,740
6231066_SriLankanRiotsOf1977.txt,646,20,32,235,118,37,19,409
6231089_PlanarDopplerVelocimetry.txt,647,14,46,257,102,49,20,428
6231653_ThomasWLawsonship.txt,1874,17,110,857,168,107,35,1167
6231_ComicBook.txt,3586,61,58,1347,436,411,175,2369
623236_RussificationOfFinland.txt,590,8,73,213,58,65,20,356
623239_AlexanderMccallSmith.txt,647,9,71,324,35,34,9,402
623248_ErwinGriswold.txt,1116,18,62,476,104,60,20,660
623249_Scandza.txt,944,13,72,317,111,88,37,553
623253_LondonMonarchs.txt,1177,37,31,488,104,60,24,676
6232617_BelfastHarlequins.txt,2213,48,46,962,216,136,44,1358
6232745_TrianaOrpheus.txt,1187,17,69,369,185,84,61,699
6232754_BadNenndorfInterrogationCentre.txt,1890,31,60,605,325,133,54,1117
623280_Bishopalien.txt,1091,19,57,372,179,64,40,655
623282_BerlinThunder.txt,550,10,55,210,41,34,10,295
623343_Domotics.txt,908,17,53,414,102,76,21,613
623346_TheTwoDeathsOfQuincasWateryell.txt,651,9,72,225,95,33,19,372
6233961_MyBestLaidPlans.txt,655,12,54,187,115,32,30,364
6234941_FibulaeAndAncientBrooches.txt,4023,75,53,1471,502,457,130,2560
62381_IreneVanDyk.txt,1002,21,47,358,130,65,41,594
6238792_BuffaloFireDepartment.txt,669,17,39,360,46,28,9,443
6238818_DeliverybladeTheSeriesEpisode.txt,832,12,69,242,162,19,25,448
623942_BryanDOconnor.txt,1292,18,71,608,126,63,18,815
6239512_CosNatola.txt,584,10,58,288,70,40,14,412
6243340_AndrDussollier.txt,1011,4,252,510,110,44,2,666
624351_Esthero.txt,1234,16,77,635,102,61,36,834
62436_Puberty.txt,5973,92,64,2141,669,729,237,3776
624388_ThursdayIslandQueensland.txt,775,11,70,284,107,51,27,469
62440_TheSting.txt,2540,31,81,1054,367,117,89,1627
624433_FallenAngels1995Film.txt,554,19,29,271,60,32,11,374
624440_ChiisagataDistrictNagano.txt,621,5,124,248,47,5,3,303
6245171_SimonMeredith.txt,746,18,41,223,156,32,27,438
6245226_LegalPurgeInNorwayAfterWorldWarIi.txt,933,13,71,431,122,36,8,597
6245494_AlienfilmSeries.txt,2233,41,54,890,286,116,74,1366
6248134_RadlettMurder.txt,1465,15,97,481,249,75,55,860
6249097_Shahenshahfilm.txt,599,11,54,253,93,24,17,387
6249364_KerrySeniorHurlingChampionship.txt,479,2,239,313,18,5,0,336
6250346_AlansonBHoughton.txt,630,18,35,290,69,19,9,387
625036_BattleOfKircholm.txt,1010,13,77,326,142,84,48,600
6250694_PrescriptionForDeath.txt,576,14,41,221,85,26,20,352
625082_MeadowlandsRacetrack.txt,711,18,39,277,96,43,18,434
625085_TristateCrematory.txt,1277,13,98,398,216,94,59,767
625514_TeachersDay.txt,1563,35,44,662,204,78,37,981
625529_AgnesScottCollege.txt,1581,23,68,759,149,137,17,1062
625534_Ensignrank.txt,1080,17,63,403,136,81,51,671
6255895_ListOfMyanmarrelatedTopics.txt,1978,28,70,1126,10,42,9,1187
6256842_NascarRacing.txt,610,16,38,243,89,36,23,391
6257064_DaviKopenawaYanomami.txt,867,10,86,276,135,54,31,496
6257446_ListOfOldSalopians.txt,1598,29,55,882,6,115,4,1007
6258059_ListOf19ZipCodes.txt,1912,9,212,861,0,14,0,875
6258743_TheAdventureOfIronPussy.txt,896,18,49,375,120,51,35,581
6259442_MainNorthLine.txt,1524,22,69,578,191,65,52,886
6261316_Fabergcosmetics.txt,1125,26,43,519,129,53,16,717
6261627_LarryTraskcomics.txt,790,9,87,275,124,53,24,476
626168_LagosState.txt,546,20,27,226,60,37,18,341
626183_LodoDenver.txt,858,15,57,320,121,60,29,530
6263617_ValparaisoUniversitySchoolOfLaw.txt,790,19,41,368,71,60,14,513
6264536_AndrMathieu.txt,813,11,73,291,107,49,20,467
626523_OscarGoodman.txt,1379,34,40,541,205,52,41,839
6265761_BeynonAlberta.txt,633,7,90,220,92,37,32,381
626604_OriolePark.txt,744,11,67,248,103,64,41,456
626608_ChristopherPriestenglishNovelist.txt,1224,14,87,647,76,58,20,801
6266135_1991InNascarBuschSeries.txt,1663,130,12,1177,110,9,2,1298
626621_Colaba.txt,876,14,62,342,114,38,19,513
626623_PaulBrownStadium.txt,693,14,49,286,81,53,20,440
6266775_FacingGoya.txt,771,11,70,308,88,47,23,466
6269624_CommandAndDataModesmodem.txt,1360,15,90,444,219,68,63,794
6270002_GeorgeCAxtell.txt,871,16,54,418,76,34,7,535
6270308_JohnBlackfiction.txt,1619,25,64,540,315,101,73,1029
6270634_Wqkl.txt,1495,24,62,621,150,119,45,935
6271591_ThomasJosephCarr.txt,1086,10,108,332,162,58,43,595
6272189_ChteauDeMeudon.txt,978,14,69,345,132,58,18,553
6272268_NakedInDeath.txt,1530,24,63,513,220,83,75,891
627315_UniversityOfMontpellier.txt,621,12,51,227,76,39,12,354
627326_BalkansCampaign.txt,663,16,41,287,74,34,11,406
6273281_LemooreUnionElementarySchoolDistrict.txt,683,3,227,333,87,27,23,470
6274492_Simtropolis.txt,699,15,46,261,96,47,21,425
6275165_FlyingSquidStudios.txt,662,16,41,260,100,54,23,437
627659_ListOfStateLeadersIn1970.txt,1847,8,230,1164,4,44,1,1213
627693_ListOfStateLeadersIn1962.txt,1500,8,187,926,6,35,1,968
627694_ListOfStateLeadersIn1961.txt,1326,8,165,815,2,28,1,846
627695_UnitedStatesMarineCorpsForceReconnaissance.txt,2525,46,54,1114,295,231,99,1739
627707_SinclairBroadcastGroup.txt,1979,36,54,856,243,114,50,1263
627711_ListOfStateLeadersIn1960.txt,1475,8,184,926,1,33,1,961
627720_ListOfStateLeadersIn1959.txt,1280,9,142,796,2,27,1,826
6280965_Ducthvac.txt,1148,22,52,421,163,130,68,782
6281967_GammaAlpha.txt,1340,18,74,477,163,100,46,786
628341_Wtta.txt,923,14,65,407,110,44,33,594
628346_RajaYoga.txt,1090,30,36,439,153,58,40,690
628348_CypriotPound.txt,518,13,39,165,65,30,20,280
628351_Wicd.txt,652,11,59,331,62,25,15,433
628353_Kgan.txt,864,16,54,385,114,32,20,551
628406_Wztv.txt,1217,17,71,463,153,96,57,769
628407_Wuxptv.txt,661,10,66,255,98,38,17,408
628782_Christchurch.txt,3331,92,36,1514,351,238,86,2189
628786_Iarnrdireann.txt,784,20,39,339,86,64,28,517
6293557_ListOfCastlesInAustria.txt,487,13,37,449,5,9,1,464
629563_LondonWasps.txt,1646,31,53,637,205,104,50,996
629784_LazLanguage.txt,772,18,42,308,77,71,29,485
6298284_VeraBennett.txt,580,16,36,222,88,26,23,359
6298627_CowboyPool.txt,675,6,112,220,98,44,26,388
629882_ZachariahChandler.txt,2631,26,101,922,367,144,95,1528
629891_BabyVox.txt,1336,16,83,450,195,117,50,812
6299574_MelBurton.txt,695,16,43,244,131,38,33,446
6299577_JuniorRoberts.txt,643,10,64,200,121,26,30,377
6299586_ListOfNotableNitAlumni.txt,812,34,23,482,51,32,15,580
6300279_ricHalphen.txt,554,21,26,213,74,39,11,337
6301236_OldNorthStateCouncil.txt,1577,27,58,740,182,63,34,1019
6302231_CapitalAreaFoodBank.txt,661,11,60,312,61,35,15,423
6303441_AylaBrown.txt,867,23,37,322,130,50,26,528
630641_JonathanLethem.txt,1238,33,37,537,113,88,31,769
630646_AmerindLanguages.txt,730,6,121,335,50,46,11,442
630894_ClevelandAbbe.txt,965,11,87,377,122,68,29,596
630966_Heckler.txt,1712,29,59,598,274,107,76,1055
630967_ListOfZipCodesInWestVirginia.txt,3756,16,234,1750,1,23,1,1775
630984_Honfleur.txt,569,13,43,217,51,39,13,320
631040_Dofetilide.txt,685,16,42,303,77,58,15,453
6311700_SaltSprayTest.txt,730,22,33,317,95,56,23,491
6312142_WhereTroyOnceStood.txt,964,18,53,380,121,54,26,581
6315160_AviationHighSchoolredondoBeachCalifornia.txt,621,11,56,274,78,47,10,409
6315178_KingNaresuanfilm.txt,661,17,38,306,77,31,9,423
631594_WellandelectoralDistrict.txt,448,19,23,201,41,20,3,265
63164_JangoFett.txt,1805,26,69,708,268,86,64,1126
63165_DarthMaul.txt,2807,27,103,1096,379,177,107,1759
631671_AngiospermPhylogenyGroup.txt,825,13,63,336,111,72,37,556
63168_MaceWindu.txt,3070,35,87,1247,371,153,109,1880
63169_PosseComitatusAct.txt,896,15,59,389,102,47,30,568
6317069_Bhojani.txt,1261,4,315,503,187,56,30,776
63170_C3po.txt,1278,14,91,448,191,69,42,750
63171_Yoda.txt,3091,42,73,1217,404,195,124,1940
63172_MontmartreCemetery.txt,853,27,31,510,22,75,5,612
63173_JoyceKilmer.txt,4068,45,90,1665,480,207,124,2476
63174_AntoineDeSaintexupry.txt,1719,21,81,581,230,141,59,1011
63175_Christianunion.txt,1950,28,69,683,241,193,63,1180
63176_ReformedPoliticalParty.txt,1972,27,73,714,245,147,62,1168
63179_FriedrichDrrenmatt.txt,1124,15,74,524,98,66,22,710
63181_GnterGrass.txt,1643,23,71,620,179,133,44,976
63183_JanPeterBalkenende.txt,858,15,57,339,94,71,21,525
63184_Crossroadsculture.txt,592,12,49,196,70,46,26,338
63185_NorbertWiener.txt,2420,20,121,880,331,146,86,1443
6318986_InDeathCharacters.txt,5225,101,51,1711,784,283,304,3082
63199_SpontaneousHumanCombustion.txt,4763,87,54,1498,782,374,232,2886
632022_GroundControl.txt,1189,21,56,425,178,93,42,738
632035_KorstarTrek.txt,746,12,62,264,116,32,26,438
63205_HoratioAlgerJr.txt,2592,25,103,1155,210,109,62,1536
632119_MeteorMobileCommunications.txt,1086,16,67,355,173,71,52,651
632120_ListOfRegimentsOfFoot.txt,1421,4,355,819,26,114,5,964
6321728_AmsterdamtheWireEpisode.txt,1718,26,66,707,258,58,32,1055
6321753_ShowbizDarts.txt,898,15,59,407,80,66,12,565
6322807_SpectersOfMarx.txt,744,10,74,258,80,58,29,425
6323880_PoznaCityHall.txt,588,14,42,229,79,30,7,345
6323886_AdnanHajjPhotographsControversy.txt,582,12,48,223,94,48,14,379
6324107_JohnEchols.txt,619,10,61,265,80,20,10,375
632753_LindseyNelson.txt,566,11,51,248,53,23,9,333
632761_ThredboNewSouthWales.txt,1169,15,77,497,155,82,25,759
6328968_Australian4thBrigade.txt,747,11,67,256,98,59,11,424
6328969_Isoko.txt,762,14,54,343,103,51,22,519
633211_ShaivaSiddhanta.txt,1349,19,71,558,161,97,32,848
633212_Tellinger.txt,935,17,55,353,119,68,14,554
6333892_HandlingQualities.txt,917,10,91,309,148,70,36,563
6334307_WilliamYolland.txt,681,8,85,260,96,41,21,418
6334545_FortHarkerkansas.txt,1051,16,65,422,129,57,14,622
6335411_YoungStorytellersFoundation.txt,1108,19,58,507,105,87,18,717
6335415_Armadillocon.txt,1010,34,29,822,25,9,3,859
6335420_BeaverCountryDaySchool.txt,829,14,59,356,78,69,20,523
6335613_TheShepherdOfTheHills.txt,1303,17,76,359,234,70,48,711
6336459_tefanKrmry.txt,577,19,30,238,49,54,17,358
6337332_MuranoBeads.txt,546,27,20,209,87,39,16,351
6337344_Xb43Jetmaster.txt,850,11,77,331,113,62,30,536
6337536_AdaptationsOfTheLordOfTheRings.txt,2184,28,78,825,257,140,64,1286
633850_StadeToulousain.txt,1074,19,56,340,127,74,39,580
633853_CollectiveBehavior.txt,1141,20,57,424,125,110,40,699
633917_GhostShip.txt,744,16,46,259,124,45,27,455
6341128_PrivatesJamesAllenKevinGarnett.txt,708,20,35,288,94,37,29,448
634222_FamilyNameAffixes.txt,1071,27,39,435,45,151,23,654
634257_Kaahumanu.txt,786,12,65,288,115,46,21,470
634259_1922InTheUnitedKingdom.txt,1292,12,107,657,97,61,27,842
634298_ArthurMacarthurJr.txt,901,15,60,345,129,49,19,542
634318_Eaglecomic.txt,2425,38,63,980,282,195,68,1525
634936_LisaWhelchel.txt,615,13,47,258,81,33,10,382
6349878_WirelessGrid.txt,1591,25,63,582,242,145,49,1018
6351159_TheOffsiteMeetingdilbertEpisode.txt,617,7,88,197,104,25,24,350
63522_CrohnsDisease.txt,3838,61,62,1407,565,406,134,2512
63526_CoeliacDisease.txt,5183,65,79,1799,808,541,190,3338
63527_ClaudeRains.txt,1145,19,60,561,71,34,12,678
63528_Inflorescence.txt,612,9,68,195,97,62,19,373
635295_PhilippineGeneralElection2004.txt,3489,58,60,1357,444,209,82,2092
635297_JohnLPhillips.txt,659,13,50,304,60,28,7,399
635307_GroupOfSovietForcesInGermany.txt,945,13,72,384,56,49,18,507
63531_UlcerativeColitis.txt,3363,69,48,1208,501,380,101,2190
63532_Lutefisk.txt,2073,40,51,662,330,192,124,1308
635340_StrategicHamletProgram.txt,1255,18,69,435,162,87,35,719
635348_MetropolitanBoroughOfWigan.txt,1149,35,32,474,123,65,38,700
63534_GreerGarson.txt,963,16,60,402,99,56,19,576
6353732_HondaNsr500.txt,681,7,97,238,88,51,22,399
635391_Dor.txt,662,14,47,268,71,41,10,390
6354159_SuttonPlaceHackney.txt,764,10,76,262,110,55,16,443
6355878_CultureDuringTheColdWar.txt,1771,40,44,716,188,148,39,1091
6356490_Sidirokastro.txt,799,23,34,313,91,58,10,472
6357802_MgmGrandAdventuresThemePark.txt,1178,28,42,473,136,92,31,732
6358640_1929HebronMassacre.txt,1637,26,62,549,249,66,32,896
635959_SacredHeartCatholicChurchdubuque.txt,1053,17,61,348,165,87,33,633
635962_RudolfSlnsk.txt,939,18,52,343,131,53,17,544
6360738_SyndicatNorthcrestVAmselem.txt,1342,13,103,433,240,94,60,827
6362660_BobCasullo.txt,591,5,118,236,71,40,15,362
636381_JoMoore.txt,750,13,57,251,121,48,25,445
636401_Scriberapper.txt,743,16,46,320,66,62,33,481
636406_CraigDavid.txt,1134,19,59,411,133,89,39,672
636428_Pachmarhi.txt,724,10,72,312,82,42,28,464
6364389_FoldhigherorderFunction.txt,1202,19,63,400,155,91,47,693
6364408_EHoffmannPrice.txt,988,20,49,413,102,57,33,605
6367183_Muhammadiyah.txt,734,27,27,314,78,53,25,470
6367592_DurationOfEnglishParliamentsBefore1660.txt,3698,61,60,1344,574,156,88,2162
6368027_JeyhunHajibeyov.txt,1029,17,60,335,155,59,41,590
6368049_14thUnitedStatesCongressStateDelegations.txt,2446,13,188,1088,176,219,16,1499
6369117_UsRoute1InVirginia.txt,600,7,85,256,53,34,20,363
6370193_NicolaiFechin.txt,654,15,43,210,98,29,21,358
637051_EdMirvish.txt,989,13,76,409,125,62,19,615
637102_PlantPhysiology.txt,904,13,69,380,111,80,31,602
637106_MetropolitanBoroughOfSolihull.txt,1532,17,90,663,166,105,31,965
6372958_SanAntonioAcademy.txt,728,14,52,327,70,46,15,458
6374853_FortHarkeralabama.txt,654,11,59,275,78,32,6,391
637496_UnitedStatesVWongKimArk.txt,1950,23,84,760,261,122,69,1212
637512_Nosebleed.txt,986,21,46,346,153,94,42,635
637533_Turangi.txt,1401,38,36,555,180,66,17,818
6375965_RobertPhillips.txt,596,12,49,266,59,35,14,374
6378694_GulfColoradoAndSantaFeRailway.txt,1974,26,75,732,258,101,54,1145
6378713_TomJonesopera.txt,761,15,50,419,60,34,14,527
638136_ErnsthugoJregrd.txt,920,13,70,391,76,86,22,575
638137_VasilyGrossman.txt,1350,22,61,515,177,81,46,819
638193_RomanianChurchUnitedWithRomeGreekcatholic.txt,1261,22,57,491,130,89,36,746
6382769_MinnesotaTwinsAlltimeRoster.txt,1282,28,45,1251,4,8,0,1263
6384855_HolyFamilyAcademyphilippines.txt,932,22,42,402,98,55,25,580
6385549_AnneFrankAndMe.txt,703,20,35,216,125,46,36,423
638579_CumberlandSchoolOfLaw.txt,1703,41,41,835,140,101,30,1106
6386394_GreenwoodTarotDeck.txt,840,19,44,312,82,47,23,464
6386395_RanallyCityRatingSystem.txt,563,10,56,224,82,45,15,366
638661_TheAuthority.txt,6738,94,71,2450,925,459,193,4027
6389351_FkAnykiai.txt,653,11,59,288,73,50,15,426
639274_ShiningForceSeries.txt,1140,11,103,510,122,75,49,756
6393544_PorgyAndBess2006.txt,552,5,110,355,42,16,15,428
6394695_SuesanKnorr.txt,728,9,80,239,129,43,25,436
639698_LeagueForSocialistActioncanada.txt,851,12,70,358,86,45,14,503
639718_BobbyThompson.txt,630,10,63,189,113,28,20,350
639735_Siberiancat.txt,838,18,46,273,108,102,45,528
639744_RedSchoendienst.txt,627,13,48,236,63,37,8,344
639750_EasternIllinoisUniversity.txt,712,12,59,387,55,37,16,495
639754_TurkishAngora.txt,572,9,63,188,80,64,24,356
639761_ReelfootLake.txt,743,8,92,243,107,55,29,434
639773_CriticalTheoryfrankfurtSchool.txt,742,11,67,309,51,87,18,465
6403208_PinPals.txt,622,12,51,244,93,25,26,388
640370_SuperSizeMe.txt,2578,45,57,924,345,160,97,1526
6404927_DavidDBurns.txt,852,14,60,421,68,50,20,559
6405779_JiHrdina.txt,592,9,65,188,80,31,14,313
6406847_PennTellersCruelTricksForDearFriends.txt,2062,27,76,626,366,103,83,1178
6406864_WoeIsMe.txt,565,11,51,196,97,21,20,334
640764_Barrel.txt,897,23,39,311,138,74,32,555
640766_Liberallabourcanada.txt,1603,28,57,577,177,138,41,933
640818_GeorgesSorel.txt,1459,11,132,675,127,84,25,911
640820_MorphologicalAnalysis.txt,2478,52,47,900,311,240,47,1498
640822_UnGeneralAssemblyResolution2758.txt,979,14,69,334,124,37,25,520
640836_PortRichmondStatenIsland.txt,765,10,76,288,98,58,22,466
640839_Kintar.txt,678,8,84,238,97,40,32,407
640841_RefuseniksovietUnion.txt,571,9,63,197,81,51,26,355
640856_Yrei.txt,1899,66,28,655,285,170,81,1191
640867_AlJarreau.txt,879,13,67,433,54,29,16,532
6408760_NkantuTheLivingMummy.txt,862,15,57,292,143,67,20,522
6411060_FugitiveFlowers.txt,630,13,48,262,71,24,22,379
6411545_WilliamRawls.txt,2005,18,111,712,341,98,67,1218
6411557_HowardbunnyColvin.txt,1457,21,69,501,262,74,35,872
6412617_SchmittenFribourg.txt,743,14,53,259,79,70,22,430
6413455_DonEnriqueTYuchengcoHall.txt,774,10,77,351,83,45,18,497
641449_ListOfRiversOfNewZealand.txt,2304,26,88,2243,12,4,4,2263
6414545_LusitanianOrthodoxChurch.txt,695,23,30,311,74,31,8,424
6415402_DaveWright.txt,674,8,84,271,77,34,19,401
641894_D12World.txt,535,8,66,231,36,22,8,297
641909_StormOfTheCentury.txt,859,13,66,287,134,42,27,490
641929_Lobengula.txt,875,11,79,294,118,68,25,505
641931_VassalsOfTheKingdomOfJerusalem.txt,2519,73,34,917,303,149,89,1458
641950_Shield.txt,2794,49,57,1083,352,291,80,1806
6420281_YearOfTheSixEmperors.txt,777,12,64,242,129,45,30,446
64252_Cadillac.txt,5224,47,111,2196,455,315,111,3077
642546_FastlanetvSeries.txt,587,14,41,292,74,32,7,405
64258_JacquesVilleneuve.txt,2832,37,76,968,421,209,97,1695
642601_ZangFuTheory.txt,1178,46,25,463,136,82,36,717
6426041_TheDavisSisterscountry.txt,772,8,96,261,124,67,38,490
64269_BristolAeroplaneCompany.txt,1568,34,46,670,170,106,36,982
64276_MaggieSimpson.txt,1961,28,70,726,261,126,93,1206
64277_LisaSimpson.txt,2447,27,90,859,371,190,119,1539
64278_MonaSimpsontheSimpsons.txt,716,10,71,255,120,31,17,423
64284_SnowballtheSimpsons.txt,1553,28,55,550,260,111,57,978
6428940_WilliamYalden.txt,558,9,62,180,91,36,24,331
6429086_NotreDameOfGreaterManila.txt,1123,52,21,619,66,58,19,762
6429112_AustralianDiplomaticMissions.txt,782,17,46,530,50,57,11,648
64293_AbrahamSimpson.txt,3332,51,65,1143,550,180,155,2028
643020_EolianProcesses.txt,1041,26,40,393,137,86,35,651
6432766_RobertDMcchesney.txt,591,33,17,317,28,40,3,388
6432952_LouisGottlieb.txt,1227,17,72,425,149,90,47,711
6439753_TakeItTheRasenganOfAnger.txt,645,8,80,219,112,28,23,382
6439791_VincentVanGoghsDisplayAtLesXx1890.txt,1062,14,75,404,132,69,39,644
6440445_ZigzagRunChasingBeingChasedAndMakingAMistake.txt,994,7,142,264,175,47,63,549
6440859_ProtectionProfile.txt,611,12,50,259,88,30,14,391
644108_FranoisLenormant.txt,591,7,84,223,80,38,10,351
644111_HughShearer.txt,659,19,34,293,63,31,14,401
644119_DominiqueVivant.txt,642,8,80,198,100,41,14,353
6441686_TheParanoidStyleInAmericanPolitics.txt,878,13,67,283,117,86,53,539
6441689_BreedersStakes.txt,724,9,80,283,25,29,2,339
6443247_IDonQuixote.txt,738,15,49,267,102,39,35,443
6448999_ListOfRegisteredPoliticalPartiesInSpainByGeographicLocation.txt,628,18,34,408,18,30,3,459
6450437_DakinBuilding.txt,1786,31,57,727,224,147,52,1150
645131_DungenessPowerStation.txt,823,14,58,293,127,49,18,487
645202_AgnesNixon.txt,1581,23,68,558,228,108,34,928
6452852_TwoTwisted.txt,1113,15,74,454,135,54,31,674
6453051_EngineTestStand.txt,544,9,60,303,58,46,15,422
6455331_TristanPark.txt,625,16,39,301,63,41,8,413
6456221_Doroslovo.txt,638,16,39,210,100,45,20,375
6456883_ElectronicBillPresentmentAndPayment.txt,576,10,57,258,65,37,14,374
6457046_AlSatterwhite.txt,845,18,46,478,65,46,5,594
6457048_Ardm.txt,692,7,98,268,97,44,20,429
6458135_Geriatric1927.txt,1452,30,48,453,218,93,55,819
645862_LiteratureOfThePhilippines.txt,1170,19,61,507,132,100,22,761
6460031_TauriCharactersInStargateSg1.txt,3226,108,29,1265,444,178,99,1986
6460886_NinthwaveRecords.txt,624,12,52,358,48,26,19,451
64608_GrandDuke.txt,1625,35,46,662,159,143,78,1042
6461088_1981InTheIrishRepublicanArmy.txt,1218,5,243,532,147,41,11,731
6461120_CaptainunitedStates.txt,606,9,67,252,59,45,22,378
64612_GingerRogers.txt,2563,41,62,1046,279,139,85,1549
64618_ListOfPoets.txt,5561,100,55,4033,45,211,11,4300
6461958_BeautyMarked.txt,1434,17,84,493,223,64,87,867
646200_Quinceaera.txt,1263,21,60,380,170,91,58,699
6462420_HistoryOfSynesthesiaResearch.txt,1042,14,74,339,148,103,40,630
646257_MachinePress.txt,586,11,53,194,98,51,17,360
646293_Nomeansno.txt,981,23,42,453,106,59,40,658
646311_ChristianMethodistEpiscopalChurch.txt,681,18,37,287,75,53,13,428
6464559_FinchleyCommon.txt,2332,23,101,829,302,138,73,1342
6465783_MonarchyInTheCookIslands.txt,1118,23,48,460,112,53,32,657
6466265_DavidOyiteojok.txt,1248,18,69,471,187,84,41,783
64673_BruceWillis.txt,1980,28,70,746,281,107,59,1193
64676_ConstantineXi.txt,795,15,53,310,101,27,24,462
64686_NormanTebbit.txt,2519,42,59,904,356,107,84,1451
6470718_PhilomObin.txt,1844,16,115,563,291,158,85,1097
647299_HmsAchatesh12.txt,904,23,39,403,135,31,22,591
647352_Sicels.txt,789,11,71,273,117,65,30,485
6475616_OttoPfeilizerfrank.txt,591,11,53,229,59,23,8,319
648102_Caulking.txt,681,12,56,232,119,42,24,417
648382_StJamesPark.txt,956,24,39,366,129,58,44,597
6484097_UnitedStatesWeatherOf2006.txt,3085,25,123,1163,371,286,118,1938
648452_Veerappan.txt,1873,25,74,770,269,79,48,1166
648550_SecondSightds9.txt,591,11,53,212,79,41,23,355
6487947_BulletCluster.txt,803,9,89,320,84,64,29,497
6488652_SolidGoldInConcert.txt,711,13,54,419,58,23,13,513
6489044_CriticismOfTheCouncilOnAmericanislamicRelations.txt,2470,39,63,942,369,125,72,1508
6489055_SandroGirgvlianiMurderCase.txt,4110,62,66,1511,660,195,134,2500
6489900_ZahirulIslamAbbasi.txt,734,10,73,316,107,49,16,488
6490983_NextMagazinesantaMonica.txt,1968,61,32,741,280,139,69,1229
6491862_EducationInPenang.txt,793,24,33,346,87,80,22,535
6492478_GuardianshipOfTheIslamicJurists.txt,2324,48,48,833,286,187,69,1375
6493337_Kfbbtv.txt,658,11,59,282,74,45,15,416
649532_FortMackinac.txt,2253,33,68,858,265,159,59,1341
6495665_WhoShotPhil.txt,1242,27,46,388,251,46,53,738
649581_ChinaRadioInternational.txt,642,21,30,337,56,30,12,435
649633_UraniumCitySaskatchewan.txt,643,16,40,287,70,35,9,401
649634_GreatBasinBristleconePine.txt,584,9,64,215,66,49,18,348
649639_HauteRoute.txt,680,30,22,332,51,52,13,448
6497395_FoxRiverStatePenitentiary.txt,1081,20,54,434,137,86,33,690
650285_Brachiosaurus.txt,1364,27,50,464,205,125,47,841
650294_HuntsPointBronx.txt,2589,35,73,1078,296,201,56,1631
650350_WappingDispute.txt,748,9,83,313,100,37,15,465
6503553_LopoldSurvage.txt,758,9,84,335,80,60,20,495
650618_DenmarkVesey.txt,741,15,49,315,90,48,27,480
6507845_BeforeThePoison.txt,576,11,52,263,52,31,8,354
6508226_ThreeYearsTwoMonthsElevenDays.txt,640,12,53,294,57,35,15,401
6508233_HumanRightsGroupsAndTheMiddleEast.txt,627,10,62,254,75,32,19,380
6509104_VaishnavJanTo.txt,330,13,25,157,41,16,9,223
6513163_ValenHsu.txt,1120,22,50,501,107,57,22,687
651372_EvaporativeCooler.txt,1738,34,51,629,246,205,69,1149
6513984_ArizonaVEvans.txt,928,14,66,300,149,73,39,561
6513985_MassInGeneralRelativity.txt,3377,80,42,1110,412,350,135,2007
6516593_ListOfRailwayStationsInParis.txt,743,16,46,372,78,45,17,512
651768_RobertRoyMacgregor.txt,689,11,62,277,107,31,19,434
651806_HerMajestysRevenueAndCustoms.txt,1258,17,74,583,106,67,17,773
6518905_JohnBaeder.txt,5826,456,12,4247,96,100,24,4467
6524694_TheHanks.txt,602,12,50,237,73,38,15,363
6524711_PuertoRicanShits.txt,1495,44,33,515,215,95,60,885
652573_CapePoint.txt,671,9,74,230,67,71,27,395
652574_CorneliusNepos.txt,620,12,51,265,73,26,16,380
6526561_AmeliaPeabodySeries.txt,1025,16,64,421,107,56,26,610
652812_TwelfthNightOrWhatYouWill.txt,2368,36,65,921,313,136,66,1436
652818_HectorCamachoVersusEdwinRosario.txt,600,11,54,218,98,31,20,367
6528468_ProfessionalGoHandicaps.txt,1070,26,41,341,152,86,43,622
652849_Governance.txt,1049,26,40,431,99,71,26,627
652850_DaveyJohnson.txt,847,11,77,330,88,53,21,492
652907_FrontMission3.txt,3665,62,59,1515,478,214,131,2338
6531057_Macmillan4x4UkChallenge.txt,721,13,55,242,101,33,20,396
6531493_ProteinInNutrition.txt,1359,23,59,495,204,131,41,871
6532326_GreatestKiss.txt,969,8,121,714,12,7,1,734
6532551_StLouisChildrensHospital.txt,624,13,48,284,62,59,11,416
65342_BattleOfBricesCrossroads.txt,1015,14,72,402,141,53,41,637
65344_SuddenInfantDeathSyndrome.txt,3077,46,66,1141,463,234,108,1946
653533_KayFrancis.txt,1316,24,54,466,179,99,45,789
65356_VesaBiosExtensions.txt,976,22,44,433,134,83,19,669
653598_ConiferCone.txt,1232,20,61,401,142,134,82,759
65359_Newquay.txt,788,20,39,327,100,61,19,507
65370_Gloucester.txt,2129,35,60,841,252,136,44,1273
65372_OneCountryTwoSystems.txt,1417,23,61,513,166,126,59,864
65373_LinguaFranca.txt,2475,39,63,934,267,253,114,1568
65374_KoineGreek.txt,2473,51,48,837,307,220,82,1446
65378_JiangQing.txt,1270,18,70,555,158,63,42,818
65379_TheDayOfTheTriffids.txt,1332,16,83,434,219,92,46,791
653913_DoubleStandard.txt,1231,18,68,336,210,162,69,777
653916_Coggeshall.txt,2376,34,69,778,375,143,68,1364
653926_Octoberalbum.txt,651,15,43,267,72,39,20,398
6542164_AlanNeedleman.txt,591,12,49,312,28,32,9,381
6546010_MaryMary.txt,4968,80,62,1641,966,183,151,2941
654617_Korenizatsiya.txt,1135,16,70,421,109,112,37,679
6546444_DougFalconerfootballPlayer.txt,689,11,62,271,78,43,15,407
6546652_PresidentProTemporeOfTheOklahomaSenate.txt,1216,16,76,460,145,59,34,698
6546654_OpenHousepeeweesPlayhouse.txt,669,10,66,224,111,45,40,420
6546848_PlayhouseInOuterSpace.txt,1482,16,92,465,227,106,86,884
654694_SecondNarrowsBridge.txt,904,14,64,367,124,46,24,561
654700_TheDoctors1963TvSeries.txt,881,16,55,347,99,52,31,529
6547911_TheCurseOfCastleMcduck.txt,1023,14,73,311,161,39,48,559
6547939_UssTheodoreEChandlerdd717.txt,4019,39,103,1628,432,202,83,2345
6548757_KillSadie.txt,677,11,61,271,76,69,28,444
6549829_SuspectingAfterglow.txt,931,12,77,351,142,74,38,605
6549838_Gulshandhaka.txt,752,18,41,401,51,44,16,512
654993_JenniferHorton.txt,804,9,89,282,148,36,33,499
655002_PhilosophyOfSpaceAndTime.txt,4169,75,55,1325,543,374,172,2414
655019_RichardAnuszkiewicz.txt,635,15,42,515,10,13,1,539
655020_HenriDutilleux.txt,1685,37,45,637,167,152,66,1022
655028_SamuelFrancisDuPont.txt,1973,22,89,796,252,98,51,1197
6550481_354thFighterWing.txt,1440,18,80,736,134,162,22,1054
6552915_GamersPairOfDice.txt,729,14,52,297,102,56,13,468
6555658_BossTuneage.txt,1695,13,130,1304,43,50,14,1411
6555_Carthage.txt,8406,118,71,3069,1108,646,271,5094
6558201_MicheleCavataio.txt,1123,14,80,469,165,40,26,700
6558_Cello.txt,4936,57,86,1705,705,476,226,3112
6560125_ElectronicInformationForLibraries.txt,946,24,39,401,90,119,17,627
656087_ItaloturkishWar.txt,1293,24,53,432,159,114,51,756
656090_Sargeras.txt,799,14,57,275,139,42,23,479
656096_Draenor.txt,995,20,49,442,115,65,32,654
656106_TomJohnstonusMusician.txt,633,12,52,286,69,35,16,406
656151_HombresG.txt,1521,18,84,658,170,85,40,953
6561638_MariusMaximus.txt,778,5,155,256,116,58,37,467
656165_BaileyborweinplouffeFormula.txt,696,27,25,203,98,64,28,393
656186_TalkOnCorners.txt,1802,20,90,817,180,108,72,1177
6561_Columba.txt,1149,17,67,442,145,54,45,686
65639_GeographyOfSouthAfrica.txt,2024,29,69,774,174,193,69,1210
65643_DemographicsOfSouthAfrica.txt,1585,47,33,589,186,153,17,945
6564406_SpecialHerbsVol4.txt,635,5,127,333,42,34,13,422
6564419_AllenGDebus.txt,829,5,165,353,71,44,10,478
656794_FrankJSelke.txt,727,9,80,295,91,34,18,438
65692_OperationalDefinition.txt,2274,38,59,790,318,194,110,1412
6569373_TheImageWorksFzLlc.txt,669,20,33,311,80,51,17,459
657176_Lateen.txt,769,11,69,237,102,80,33,452
657179_BlairAtholl.txt,950,11,86,348,113,83,21,565
657252_AlgomaSteel.txt,914,13,70,344,124,64,26,558
657262_Amiodarone.txt,1963,42,46,674,301,216,87,1278
657267_ReggieFilsaime.txt,1943,46,42,589,265,112,100,1066
6575113_JewelCarmen.txt,697,9,77,286,65,28,20,399
65755_Yeti.txt,2719,45,60,963,365,200,104,1632
65759_AlaqsaMosque.txt,4475,78,57,1556,635,265,119,2575
65760_Smartautomobile.txt,1148,23,49,436,171,96,41,744
6576953_Tenida.txt,678,15,45,316,70,59,19,464
6577218_Taynuilt.txt,749,10,74,273,86,48,22,429
657882_KhalidAbdulMuhammed.txt,813,18,45,313,104,49,24,490
6579985_ArchitectureOfSweden.txt,1639,26,63,657,168,126,40,991
6581215_MusicalStonesOfSkiddaw.txt,2100,27,77,696,296,154,63,1209
658268_TheDatingGame.txt,1527,23,66,563,190,108,56,917
6582749_JudgeHenryMentz.txt,612,13,47,282,58,36,4,380
6583830_LindaHoward.txt,649,13,49,237,67,20,9,333
6583842_TheGratefulPrince.txt,1083,17,63,286,191,54,41,572
6584235_Baharistanighaibi.txt,663,10,66,271,70,53,16,410
6584670_MollyWhuppie.txt,568,6,94,119,109,31,23,282
6587621_ColloquyAtPoissy.txt,762,4,190,238,96,60,22,416
6588738_ChineseSixCompanies.txt,583,8,72,264,50,59,15,388
658983_ZamzamWell.txt,822,19,43,296,133,42,31,502
6593410_TheQuotations.txt,593,9,65,217,76,38,28,359
659356_WilliamHHinton.txt,827,12,68,337,97,53,14,501
659359_IndustrialProcess.txt,1092,15,72,539,106,82,16,743
659410_TheSageGroup.txt,712,14,50,382,70,36,10,498
659413_EddieGrayfootballer.txt,897,13,69,318,130,58,33,539
6594458_ListOfTelevisionProgramsThatBreakTheFourthWall.txt,6860,100,68,2385,929,358,329,4001
6597289_SherlieMatthews.txt,836,15,55,388,84,62,13,547
6599175_IndioMariano.txt,885,12,73,301,128,66,29,524
660070_BostonLegal.txt,2973,32,92,1313,330,153,63,1859
660443_LithuaniansInBrazil.txt,616,9,68,231,73,51,25,380
660444_IbmRationalPurify.txt,722,12,60,268,101,55,37,461
660445_LomiSalmon.txt,483,4,120,165,94,48,18,325
660446_VanessaParadis.txt,666,12,55,274,83,32,25,414
6605995_ShanthakumaranSreesanth.txt,894,10,89,318,125,54,24,521
6605997_AcuteFattyLiverOfPregnancy.txt,1042,16,65,354,171,97,44,666
6609854_KecharisMonastery.txt,980,21,46,327,119,95,21,562
6611_ChicagoBears.txt,4868,67,72,1818,578,288,109,2793
6612_CincinnatiBengals.txt,11343,185,61,4321,1265,687,262,6535
6613_YangtzeRiver.txt,1788,29,61,745,172,139,60,1116
6614056_TheOverture.txt,934,18,51,366,122,64,30,582
6614913_AlphaDeltaSigma.txt,901,10,90,320,119,39,34,512
6614_ChronoTrigger.txt,5116,37,138,1858,761,335,183,3137
661543_MoanaluaHighSchool.txt,2113,29,72,929,257,156,57,1399
6615610_PerformanceEngineering.txt,1904,33,57,774,305,122,64,1265
6615660_ArthurPolonsky.txt,577,10,57,251,59,48,14,372
661640_MichaelWatts.txt,1123,9,124,612,61,48,12,733
6616683_IgFarbenBuilding.txt,2735,40,68,1074,328,160,72,1634
6618593_FirstSuiteInEflatForMilitaryBand.txt,736,27,27,345,61,71,17,494
6619808_Vitalqip.txt,590,19,31,259,77,44,24,404
662350_MedgarEversCollege.txt,1869,24,77,834,181,134,24,1173
662351_2008UefaEuropeanFootballChampionship.txt,717,20,35,344,69,30,15,458
662612_Nukees.txt,1098,11,99,395,160,70,42,667
662636_TupolevTu160.txt,1458,29,50,483,221,157,40,901
662681_HarrieSkinner.txt,1393,26,53,446,220,84,41,791
662707_Nrma.txt,1701,34,50,668,234,122,46,1070
662709_ImperialServiceClub.txt,1333,17,78,513,205,77,29,824
6628008_SportRanger.txt,1055,20,52,448,146,62,24,680
6629433_InsanityReignsSupreme.txt,572,15,38,217,71,43,21,352
6630105_YasminbratzCharacter.txt,587,13,45,378,21,13,4,416
6630151_TheRedSpectacles.txt,1456,48,30,706,135,99,29,969
6630953_ChampionsTourRecords.txt,1945,21,92,1203,33,123,7,1366
663389_JohnLandis.txt,831,12,69,363,94,45,23,525
6634008_JoelHedgpeth.txt,721,4,180,434,27,15,2,478
663495_NormanMaccaig.txt,627,5,125,191,85,58,21,355
663704_LyleAndErikMenendez.txt,738,9,82,325,98,35,8,466
6637094_SaengerTheatre.txt,643,14,45,251,85,33,20,389
6637795_EvgenySveshnikov.txt,642,13,49,221,93,44,29,387
663797_TangierGarrison.txt,1215,34,35,455,179,56,26,716
663801_HmsGuerriere1806.txt,1460,7,208,485,226,74,52,837
663857_VocationalSchool.txt,883,18,49,292,114,112,49,567
663886_ShaneFilan.txt,757,13,58,291,106,41,29,467
663888_Taygetus.txt,675,19,35,269,84,39,21,413
6639044_ApartheidAroundTheWorld.txt,1162,9,129,390,160,109,45,704
6640779_PeterDeSavary.txt,727,14,51,267,92,43,24,426
6642501_JohannWalter.txt,557,12,46,225,68,39,11,343
66426_WaterlooCityLine.txt,1594,25,63,546,224,101,47,918
66427_EvelKnievel.txt,4088,44,92,1421,667,225,119,2432
66432_Progesterone.txt,1468,29,50,542,221,146,56,965
6643597_TheWeeklyMaqam.txt,1114,18,61,413,164,69,48,694
66436_IraqDisarmamentCrisis.txt,5105,72,70,1927,758,284,181,3150
66437_SaintDenisBasilica.txt,990,15,66,345,120,58,29,552
66439_LauritzMelchior.txt,1081,18,60,464,95,78,26,663
66440_OurLadyOfGuadalupe.txt,4128,57,72,1671,504,232,92,2499
66441_JuanDiegoCuauhtlatoatzin.txt,784,10,78,268,122,37,27,454
66443_Kleptocracy.txt,613,14,43,236,57,67,25,385
664470_Mentos.txt,1038,16,64,392,149,92,48,681
664490_LawrenceTextileStrike.txt,1881,26,72,670,267,114,54,1105
6645462_WatorurouniKenshin.txt,819,14,58,296,101,48,38,483
66463_PoliticsOfAfghanistan.txt,2664,44,60,1141,313,155,55,1664
6646554_JacoCostaRica.txt,559,31,18,272,62,42,16,392
6647823_PunchDickins.txt,1681,20,84,653,204,129,36,1022
664877_BrianTalboys.txt,631,6,105,229,92,41,25,387
664905_Martinism.txt,1115,10,111,477,123,82,27,709
664949_VictorBuono.txt,810,12,67,329,87,48,16,480
664978_ChrisChelios.txt,1667,20,83,664,186,110,50,1010
6652669_Kuwae.txt,753,16,47,264,96,57,22,439
665557_ChildrenAndFamilyCourtAdvisoryAndSupportService.txt,689,15,45,286,95,29,12,422
665570_MariaSchicklgruber.txt,869,15,57,308,132,54,27,521
665630_SmugglingTunnel.txt,1239,28,44,474,194,57,20,745
6657204_LaasGaal.txt,611,19,32,235,91,44,21,391
6657224_EducationInJordan.txt,824,17,48,353,81,81,12,527
6658030_SikhRehatMaryada.txt,9815,320,30,3630,1358,558,259,5805
665961_OnsideKick.txt,1056,17,62,320,158,75,66,619
6661929_CarnalComics.txt,2684,24,111,1166,358,255,80,1859
6663779_TrumanHAldrich.txt,860,12,71,378,89,34,10,511
6663815_ListOfMunicipalitiesInBahiabaBrazil.txt,1105,4,276,608,38,13,1,660
6664235_ListOfMunicipalitiesInParabapbBrazil.txt,427,4,106,358,25,2,1,386
6665691_CharlesWhitworth1stEarlWhitworth.txt,2704,17,159,879,356,172,87,1494
6666995_ListOfCaliforniaInstituteOfTheArtsPeople.txt,3726,19,196,3126,11,56,2,3195
6667633_ChamplainValleyUnionHighSchool.txt,614,14,43,299,71,28,15,413
6668032_Simucad.txt,999,31,32,554,88,96,8,746
667037_IndianFilterCoffee.txt,936,17,55,340,125,74,45,584
667053_StationIdentification.txt,1907,36,52,672,285,136,111,1204
6670629_TramwayDeMarseille.txt,589,12,49,192,103,51,7,353
667139_Sealavender.txt,747,7,106,425,56,100,25,606
6671_CincinnatiReds.txt,9015,87,103,3492,1025,521,217,5255
6674449_FreyVFedorukEtAl.txt,589,9,65,188,107,28,35,358
6675113_ArnulfoTrejo.txt,656,11,59,334,50,37,8,429
6675_Conservatism.txt,4335,58,74,1462,536,493,173,2664
6676981_SamuelEPingree.txt,661,25,26,285,70,16,11,382
667748_KimberlyHart.txt,1697,10,169,587,249,106,69,1011
667788_RefractiveSurgery.txt,758,16,47,291,111,74,24,500
6678098_JCWilliamson.txt,2047,19,107,865,216,119,56,1256
667850_FinnishPeople.txt,3179,42,75,985,369,443,149,1946
667854_Lophophora.txt,728,21,34,338,85,48,28,499
668125_CaterpillarInc.txt,1640,45,36,726,191,129,30,1076
668141_OperationRainbow.txt,1591,29,54,583,295,83,39,1000
668147_Hellenization.txt,1124,21,53,422,135,85,34,676
668151_Wfmu.txt,1793,31,57,902,166,142,45,1255
66847_Fibroblast.txt,767,19,40,274,96,101,38,509
6684873_AnimalCrossingseries.txt,2350,34,69,824,348,166,73,1411
66850_BackstreetBoys.txt,3538,39,90,1286,456,242,79,2063
66852_HeavyMetalmagazine.txt,878,11,79,369,105,77,30,581
66857_InternationalWhalingCommission.txt,6098,66,92,2015,911,468,212,3606
6687657_SecondaryCharactersAndSettingsInTheAdventuresOfTintin.txt,971,16,60,393,118,68,33,612
6688348_DmitriBilenkin.txt,1216,20,60,614,70,52,13,749
6689608_SouthMountainmarylandAndPennsylvania.txt,666,10,66,350,27,42,10,429
669011_ThisLandIsYourLand.txt,1459,34,42,472,233,75,61,841
669016_CollaborativeDivorce.txt,879,9,97,284,132,89,36,541
6690229_Opgezwolle.txt,1057,35,30,611,78,59,16,764
6690666_SarahJacobson.txt,633,10,63,317,67,30,14,428
6690668_PukatawaganManitoba.txt,1992,25,79,758,284,143,52,1237
6691479_ListOfActorsWhoHavePlayedInTrilogies.txt,1606,14,114,1038,11,26,1,1076
6691505_CharlesMeredith.txt,608,11,55,218,71,31,20,340
669221_NiagaraFrontierTransportationAuthority.txt,1508,33,45,806,119,74,26,1025
669224_Thresholdband.txt,922,20,46,376,117,81,25,599
669238_Gelonus.txt,577,12,48,211,66,41,21,339
669241_UsArmyWarCollege.txt,670,12,55,326,45,68,12,451
6693237_EconomyOfStamfordConnecticut.txt,1175,7,167,546,85,73,13,717
6693408_EpicoeneOrTheSilentWoman.txt,943,12,78,395,116,55,27,593
6696377_DavidMartnez.txt,581,18,32,276,42,36,6,360
6696388_AlabamaInTheAmericanCivilWar.txt,782,15,52,319,117,39,24,499
6696437_MississippiInTheAmericanCivilWar.txt,1131,25,45,458,145,61,48,712
669966_Kusarigama.txt,710,12,59,251,93,45,33,422
670308_ListOfTeetotalers.txt,1929,10,192,1328,79,113,19,1539
670357_TheYesAlbum.txt,718,14,51,316,74,50,23,463
670407_HarryPotterAndTheOrderOfThePhoenixfilm.txt,1229,30,40,479,182,56,40,757
6704753_ClevelandCrimeFamily.txt,1404,21,66,566,160,69,29,824
6704965_SpencerOwen.txt,642,13,49,285,66,44,14,409
6708950_Reichhold.txt,1256,57,22,625,137,81,16,859
6710041_NormanJewson.txt,1557,23,67,543,202,123,50,918
6710883_IsraelLobbyInTheUnitedStates.txt,5636,80,70,2072,733,473,251,3529
6710957_Isbisa.txt,1174,14,83,357,227,57,44,685
6711580_DevilsGotANewDisguiseTheVeryBestOfAerosmith.txt,566,10,56,264,48,24,7,343
671167_ScrantonwilkesbarreYankees.txt,684,13,52,310,71,33,15,429
6711747_SubagioSastrowardoyo.txt,657,19,34,340,52,27,15,434
6711972_RobertROdn.txt,722,11,65,266,81,57,30,434
6712884_JapaneseEmploymentLaw.txt,831,27,30,298,120,63,25,506
6714405_MilitaryOrganization.txt,1074,23,46,384,143,127,42,696
671443_XuChu.txt,1536,28,54,583,217,71,73,944
6717182_CeramicGlaze.txt,732,11,66,224,130,69,33,456
6718258_OwningTheFuture.txt,754,17,44,478,41,36,6,561
6720455_MakeMeLaugh.txt,663,11,60,221,83,37,19,360
6720507_Bolaq.txt,1122,16,70,435,152,84,33,704
6721591_TheLostChartsOfColumbus.txt,999,11,90,307,188,41,52,588
672218_Isospin.txt,1037,20,51,334,134,86,54,608
6722408_CareerAchievementsOfMichaelJordan.txt,2425,17,142,807,100,167,4,1078
6722432_ListOfMinotaurReferencesInPopularCulture.txt,1823,15,121,778,200,105,41,1124
672515_BirminghamBarons.txt,1688,27,62,692,170,86,37,985
672532_ListOfPerthSuburbs.txt,864,44,19,664,46,11,5,726
672564_RibwortPlantain.txt,655,18,36,205,92,59,41,397
672593_SanAntonioMissions.txt,636,15,42,298,61,21,16,396
672599_CydHo.txt,729,15,48,312,56,58,12,438
672605_TaskForceToOvercomeRacismInTopeka.txt,986,11,89,370,135,81,24,610
6726275_TheTwelveBrothers.txt,604,9,67,163,115,29,20,327
6727330_UssSachem1861.txt,2149,18,119,794,341,97,66,1298
6728165_FredWaterman.txt,607,11,55,211,74,44,26,355
6730078_BolroInPopularCulture.txt,1361,7,194,547,175,83,28,833
6730097_2001WorldMensHandballChampionship.txt,718,48,14,338,8,7,0,353
6733110_RingMagazineUpsetsOfTheYear.txt,630,10,63,441,11,5,5,462
673350_OlapCube.txt,1071,17,63,352,160,83,58,653
6735008_WilliamSmithmurderer.txt,603,9,67,208,88,27,10,333
6736069_Pescaglia.txt,590,22,26,232,64,21,2,319
6736087_KitchenerWaterlooLittleTheatre.txt,897,11,81,330,124,74,24,552
673673_ListOfPeopleFromLosAngeles.txt,1434,26,55,1288,10,55,3,1356
673682_AngelHeart.txt,585,15,39,221,85,47,28,381
673690_AustralianHipHop.txt,844,14,60,382,90,74,28,574
673694_YoungGuns.txt,1079,15,71,422,158,49,27,656
6738858_UnitedStatesMarineCorpsRankInsignia.txt,686,13,52,255,90,63,43,451
6738860_UssHolderdd819.txt,627,13,48,260,71,22,9,362
6738881_DynamiteDux.txt,642,15,42,245,85,45,26,401
6742710_ListOfParliamentarySecretariesOfCanada.txt,4993,196,25,2880,4,143,2,3029
6742720_UmiRyuuzaki.txt,1482,18,82,434,268,82,95,879
674375_GermanicChristianity.txt,806,12,67,348,79,49,25,501
674386_PaulDianno.txt,2814,51,55,1133,378,146,103,1760
6745280_HdfcBank.txt,605,8,75,295,48,27,7,377
6745493_AfterColonyLocations.txt,3358,34,98,1302,496,206,95,2099
6746543_AbbasguluBakikhanov.txt,952,14,68,368,110,66,22,566
6746576_LindaPerry.txt,2032,32,63,907,215,136,50,1308
674750_KalamundaWesternAustralia.txt,587,14,41,252,60,44,17,373
674758_MikeCuellar.txt,880,10,88,298,92,46,13,449
6747636_BeYeMenOfValor.txt,1318,10,131,320,198,106,79,703
674779_EdwardCodrington.txt,1052,14,75,338,132,56,23,549
6749136_WirelessCommunicationsAssociationInternational.txt,1182,18,65,542,127,91,16,776
6749562_IraDecordovaRowe.txt,1368,8,171,697,112,59,16,884
6750389_TheBalkanPrincess.txt,866,7,123,303,92,52,26,473
67503_ZuiderzeeWorks.txt,4927,46,107,1380,771,432,232,2815
67511_MammothCaveNationalPark.txt,5600,79,70,2313,674,378,135,3500
67516_FourthInternational.txt,5620,72,78,1984,761,404,176,3325
67519_LionelJospin.txt,1342,22,61,505,148,100,44,797
67521_RedRiverGorge.txt,1127,30,37,533,125,72,45,775
6752269_GuyMedal.txt,633,6,105,272,9,50,4,335
6752352_TheTonyKornheiserShow.txt,3612,63,57,1575,447,173,91,2286
67527_ArmedForcesOfArmenia.txt,1649,25,65,600,194,154,47,995
67530_MusicOfAustralia.txt,3456,50,69,1617,318,356,97,2388
6753384_GeraldMccarthy.txt,1091,13,83,368,142,93,44,647
67533_EconomyOfAustralia.txt,1884,47,40,733,228,194,53,1208
67537_ParalympicGames.txt,773,21,36,350,92,59,14,515
67538_AustralianDefenceForce.txt,5975,94,63,2581,667,454,114,3816
67539_ForeignRelationsOfAustralia.txt,1167,21,55,501,122,93,22,738
6754242_Externism.txt,686,13,52,203,108,42,39,392
67542_GeographyOfAustria.txt,3077,46,66,1205,292,301,110,1908
67545_EconomyOfAustria.txt,1111,26,42,437,119,125,33,714
675478_MinnesotaTransportationMuseum.txt,648,10,64,223,112,36,24,395
67551_GeographyOfTheBahamas.txt,792,12,66,339,79,81,28,527
67554_InvasiveSpecies.txt,8093,66,122,3083,995,931,281,5290
6757170_MilkAndHoneymusical.txt,1476,21,70,638,151,56,43,888
6757242_WiltshireVictoriaCountyHistory.txt,1312,20,65,795,100,55,9,959
6757248_Apbband.txt,1310,15,87,557,141,91,35,824
6757876_HankyPankysong.txt,610,12,50,196,94,47,26,363
675831_PutumayoWorldMusic.txt,1588,14,113,710,105,89,16,920
6759093_ThomasJArnold.txt,1594,13,122,499,225,121,76,921
676478_NelsonatkinsMuseumOfArt.txt,835,23,36,392,72,61,20,545
676479_WickedLester.txt,1276,16,79,512,175,74,46,807
6764911_RobertDEnglish.txt,686,8,85,319,45,37,9,410
6767673_DouglasDoddsparker.txt,982,13,75,347,112,49,17,525
676862_NathanielFolsom.txt,717,13,55,276,84,44,14,418
676940_AncientHawaii.txt,2254,48,46,798,351,190,88,1427
676959_DraytonParkRailwayStation.txt,696,13,53,307,92,21,10,430
6770235_ThomasStephensKonkkniKendr.txt,978,29,33,436,112,55,29,632
6771713_TonyRicefootball.txt,897,23,39,365,96,56,15,532
6772545_FederatedStatesOfMicronesiaFootballAssociation.txt,856,8,107,310,111,43,34,498
6774674_JewishViewsOnContraception.txt,616,7,88,186,98,71,37,392
6775568_ListOfWorldWarIiBritishNavalRadar.txt,1058,53,19,472,143,87,24,726
6777485_ToddPKennett.txt,649,11,59,270,73,31,10,384
6777489_MitchelllamaHousingProgram.txt,891,16,55,324,129,70,23,546
6779404_TomSeymour.txt,889,12,74,293,125,69,47,534
677950_CanadianGunRegistry.txt,2392,31,77,845,416,153,88,1502
677955_TroyUniversity.txt,818,15,54,392,89,29,25,535
6780005_TelekomSrpske.txt,652,18,36,300,68,39,15,422
678005_FootballAssociationOfNorway.txt,643,16,40,313,19,14,4,350
6781932_OddArneWestad.txt,579,12,48,332,30,25,6,393
6785095_KVAnand.txt,677,12,56,318,77,45,8,448
6785141_MarooneduntamedWorld.txt,826,25,33,355,130,34,28,547
6786237_ChamberOfDarkness.txt,701,12,58,352,42,45,9,448
678792_SwingBowling.txt,1207,24,50,410,161,77,53,701
6788164_AppealGroup.txt,1003,18,55,350,139,65,28,582
6790034_TwelveMonths1980Film.txt,2371,25,94,575,446,95,174,1290
6790911_KeroroGunsoTheSuperMovie.txt,1612,10,161,560,288,58,47,953
679132_UssWilkesbarrecl103.txt,2938,44,66,1119,328,201,66,1714
6791971_ExamplesOfMetareferencesInFiction.txt,9175,136,67,3210,1277,534,359,5380
6791979_JennerCaliforniaDoublemurderOf2004.txt,860,16,53,347,122,39,23,531
6792812_ChibaChiba.txt,666,19,35,305,61,27,17,410
6793019_VladimirVarankin.txt,1167,20,58,445,114,82,39,680
6794535_LeendertHasenbosch.txt,704,15,46,234,89,43,33,399
6796871_LawsOfDuplicateContractBridge.txt,1438,23,62,494,208,104,53,859
6797735_TropicalStormDoria1971.txt,1749,20,87,700,185,122,23,1030
6799294_MythcomputerGame3rdPartyProjectsAndPersonalities.txt,2498,19,131,1037,291,227,105,1660
6800827_OutOfOdor.txt,1015,20,50,371,152,51,53,627
680219_MartynasMavydas.txt,755,13,58,304,73,59,16,452
680261_CompactElement.txt,907,20,45,328,126,78,40,572
680264_UrawaReds.txt,559,17,32,279,42,35,10,366
6802717_MiniHockey.txt,1358,20,67,435,197,133,66,831
680272_FromABuick8.txt,1064,12,88,343,161,49,37,590
6803094_ListOfLeChevalierDeonEpisodes.txt,600,6,100,270,78,23,6,377
680339_NorthernIrelandPeaceProcess.txt,5248,125,41,1952,714,296,130,3092
680345_SharpX68000.txt,788,18,43,303,104,85,29,521
6806516_SingaporeBiennale.txt,637,13,49,328,68,40,9,445
6807017_TsBellona.txt,732,32,22,386,64,39,22,511
680840_SelaWard.txt,936,19,49,389,108,49,32,578
6810363_ClassicalWienerSpace.txt,549,35,15,179,62,57,18,316
6810403_DbmDeBellisMultitudinis.txt,677,10,67,250,79,48,39,416
6811653_TomislavMari.txt,902,7,128,284,93,58,35,470
6813399_ThamesDittonIsland.txt,1018,17,59,334,139,59,45,577
6813765_MermaidManAndBarnacleBoy.txt,3152,44,71,1337,420,159,91,2007
6814211_TheDrill.txt,1347,17,79,464,196,67,63,790
6814232_AnsiAscX9.txt,1006,16,62,464,101,85,16,666
681442_CommanderVenus.txt,702,16,43,288,95,37,29,449
6816602_BustAGroove2.txt,1471,18,81,660,173,86,41,960
6820176_HillaryRodhamClintonPresidentialCampaign2008.txt,747,13,57,238,100,69,27,434
6820218_RaleighKirbyGodsey.txt,947,15,63,449,74,61,11,595
6821423_Idiga.txt,617,13,47,284,74,37,23,418
6821427_BathroomSinging.txt,636,11,57,231,86,28,26,371
682431_ZeroHourenterpriseEpisode.txt,1489,27,55,486,244,77,53,860
682473_MarkBrunell.txt,670,19,35,267,77,38,15,397
682476_AhmedKhalfanGhailani.txt,627,8,78,262,94,24,16,396
682527_TobyKeith.txt,1778,32,55,752,222,93,50,1117
682533_TheAdventureSeries.txt,810,20,40,285,106,49,23,463
6825351_CapitalRadiopirate.txt,699,16,43,216,127,56,37,436
6825961_RobertHubert.txt,912,19,48,263,150,50,45,508
6827911_2006IsraellebanonConflictPhotographsControversies.txt,1391,20,69,491,234,79,34,838
6828116_ListOfLocalChildrensTelevisionSeriesunitedStates.txt,3166,115,27,2714,46,64,20,2844
6829839_TheDepositoryTrustCompany.txt,856,19,45,333,108,71,27,539
6829851_PolkadotPuss.txt,702,8,87,260,112,34,32,438
683026_Azithromycin.txt,860,16,53,313,119,96,27,555
683030_CanadaDry.txt,585,15,39,288,68,28,19,403
683092_CrueltyToAnimals.txt,1526,29,52,640,198,135,46,1019
6831007_CivilianComplaintReviewBoard.txt,624,12,52,280,68,47,16,411
6832753_BellebelleOuLeChevalierFortun.txt,825,11,75,198,166,38,32,434
6833633_ManipulatedNashEquilibrium.txt,695,11,63,281,78,45,20,424
6834662_TrexlerScoutReservation.txt,753,21,35,387,91,34,15,527
683511_HannsmartinSchleyer.txt,875,14,62,340,106,48,17,511
683531_HistoryBites.txt,983,14,70,499,105,68,27,699
6835553_YuanYe.txt,1045,9,116,427,136,51,44,658
6836820_RafKingsCliffe.txt,898,30,29,410,86,66,18,580
6839374_DanaeClassCruiser.txt,1078,10,107,446,156,41,20,663
6841307_ListOfOttawagatineauCinemas.txt,802,12,66,338,74,52,16,480
6842369_ProofTest.txt,886,12,73,303,146,78,34,561
6842392_UniformPolytope.txt,1772,57,31,739,182,147,44,1112
6842412_TheEconomyDrive.txt,722,11,65,255,119,45,22,441
6844507_TollanCharactersInStargate.txt,1147,22,52,334,211,84,49,678
684608_RobertHolborne.txt,1383,24,57,424,227,60,49,760
684626_OperationSpanner.txt,591,11,53,229,74,36,17,356
684628_ParentalAlienation.txt,1361,14,97,501,201,93,48,843
684707_FengYoulan.txt,853,14,60,331,94,69,27,521
6847259_FrancisBFoley.txt,627,9,69,235,83,42,14,374
6848086_MissWorld2002.txt,743,239,3,551,27,21,4,603
6848327_ElizabethharriotWilson.txt,4110,60,68,1358,675,270,175,2478
6850005_Downsyde.txt,690,13,53,375,49,37,9,470
6850013_HistoireDeLoeil.txt,910,16,56,349,100,85,23,557
6851097_RussopolishWar16541667.txt,1112,21,52,426,132,68,21,647
685186_GermanyMustPerish.txt,949,9,105,411,105,54,29,599
6852012_JesusCamp.txt,1437,28,51,613,176,74,37,900
685692_Siljanlake.txt,674,14,48,233,101,72,18,424
685694_JoanOfArcband.txt,1125,26,43,536,105,98,37,776
685744_UncleTomCobley.txt,1013,16,63,517,86,36,22,661
685746_Laterality.txt,701,16,43,226,118,59,47,450
685747_ManchestertownNewYork.txt,722,15,48,282,89,35,7,413
6858171_FlorenceOdonoghue.txt,654,13,50,232,89,48,12,381
6858775_SongsForChristmas.txt,794,13,61,349,71,60,18,498
6858835_TheAthenianMurders.txt,782,12,65,286,113,45,30,474
68601_AgrippaI.txt,766,12,63,282,100,25,21,428
6860545_JamesBoylebroadcasting.txt,647,12,53,267,96,41,19,423
6860550_OriginalWar.txt,2940,27,108,882,481,215,128,1706
6860552_Flipped.txt,1498,42,35,365,290,69,110,834
6860726_JackTheRipper.txt,4413,61,72,1528,691,277,171,2667
6861556_2006TennesseeVolunteersFootballTeam.txt,2607,50,52,1122,290,142,39,1593
6861628_VictoriaUniversityOfWellingtonDebatingSociety.txt,1934,33,58,1006,108,167,25,1306
6862478_NewYorkGilbertAndSullivanPlayers.txt,1595,15,106,643,164,109,43,959
68627_Ajalon.txt,623,7,89,195,72,28,30,325
68636_Alms.txt,1031,29,35,357,144,95,30,626
68640_Altar.txt,4354,69,63,1323,657,289,168,2437
6865393_LeopoldMitrofanov.txt,663,4,165,252,87,41,22,402
6865401_RichardTognetti.txt,589,11,53,224,76,39,20,359
6869273_TheotokosOfStTheodore.txt,1337,18,74,428,207,82,32,749
6875218_LeanneDobinson.txt,613,10,61,215,89,46,14,364
6876967_ListOfPennsylvaniaCivilWarRegiments.txt,608,10,60,311,11,170,1,493
6876981_GuestHousedrama.txt,976,16,61,309,156,67,48,580
6877368_ArmenianYouthFederation.txt,1858,40,46,766,221,159,33,1179
6880370_PhilosophyOfLanguage.txt,5679,73,77,1867,815,500,181,3363
6880805_HoliestSitesInIslam.txt,2115,50,42,817,265,156,62,1300
6884147_TransdevLondon.txt,2123,63,33,896,268,99,54,1317
6884208_ToriiSchool.txt,1061,15,70,365,121,101,49,636
6884869_RuhaniSatsang.txt,6033,107,56,1828,803,410,265,3306
6886736_Mozella.txt,845,12,70,318,121,58,17,514
6887081_HalfEagle.txt,1017,12,84,350,141,64,27,582
6887662_GoldAntitrustActionCommittee.txt,796,13,61,348,102,37,30,517
6890612_MineralExploration.txt,1683,32,52,583,268,166,64,1081
6894376_SearchingForDragons.txt,665,8,83,200,116,39,27,382
6894378_BhagatRamanand.txt,672,12,56,225,110,37,22,394
6894387_BhagatRavidas.txt,914,7,130,305,156,37,31,529
6894483_BhagatSain.txt,631,18,35,226,93,30,27,376
68952_TribeOfJudah.txt,827,14,59,322,73,38,24,457
68953_ForeignRelationsOfBelgium.txt,858,10,85,333,77,88,21,519
689611_WhatDreamsMayComefilm.txt,1624,26,62,528,262,95,64,949
689617_Metahuman.txt,1680,30,56,612,245,134,62,1053
68963_DemographicsOfBelize.txt,700,27,25,275,60,94,12,441
68964_PoliticsOfBelize.txt,1452,17,85,706,127,73,28,934
6899362_JasperJacks.txt,2977,20,148,897,625,106,136,1764
6899545_SecondaryCalculusAndCohomologicalPhysics.txt,771,27,28,352,59,104,14,529
6899553_DynamicGameBalancing.txt,1127,16,70,445,154,93,37,729
6900632_SantaAnaFireDepartment.txt,1080,22,49,391,173,61,14,639
690150_Dantooine.txt,1062,22,48,377,176,62,48,663
690168_ClickItOrTicket.txt,902,17,53,366,121,51,27,565
69017_MilitaryOfBolivia.txt,595,9,66,212,18,25,2,257
69024_BaffinIsland.txt,1506,31,48,540,177,120,55,892
6903188_MakingAnEntrance.txt,537,11,48,176,72,40,23,311
6904083_CultureOfMartinique.txt,682,13,52,276,76,79,23,454
6907014_LesPromenadesDeLoutaouais.txt,1020,24,42,384,113,95,40,632
690817_RyanAtwood.txt,2207,18,122,679,388,101,104,1272
6911194_ListOfCommercialGamesReleasedAsFreeware.txt,1032,14,73,489,83,60,20,652
691213_StStephensCollegeHongKong.txt,962,24,40,435,104,70,20,629
691217_HmsNelson1925.txt,797,13,61,300,104,27,14,445
6912716_BarryEngland.txt,607,12,50,220,80,36,21,357
6912733_IsaacSStruble.txt,926,12,77,377,89,65,14,545
6914005_RoyalCastlePozna.txt,1388,14,99,569,153,70,31,823
6916554_2006FivbMensWorldChampionship.txt,843,66,12,308,86,67,6,467
6917002_ListOfFoxTelevisionAffiliatestable.txt,702,9,78,209,63,144,5,421
6917004_JuanJosPrezHernndez.txt,621,14,44,261,69,40,15,385
691838_UnruhEffect.txt,630,14,45,236,86,46,23,391
6918478_CrawfordExpedition.txt,6290,62,101,2397,889,355,163,3804
6918492_LiveInNycAugust182001.txt,633,10,63,229,99,31,17,376
6919818_Celendn.txt,672,8,84,228,71,52,16,367
6920405_TarakiSivaram.txt,1119,19,58,471,133,78,33,715
6920412_PdcUkOpenDarts.txt,797,16,49,396,69,47,5,517
6920895_PdcWorldDartsChampionship.txt,1264,16,79,556,117,83,31,787
692262_EconomicSystem.txt,632,20,31,272,61,95,25,453
692334_AtholFugard.txt,1366,21,65,645,138,48,22,853
692345_FictionalCurrency.txt,1601,8,200,781,117,96,62,1056
692352_Sleepwalkercomics.txt,1110,21,52,400,161,78,39,678
6924133_UltraverseTimeline.txt,804,2,402,439,99,22,3,563
6924135_RutgersUniversityStudentOrganizations.txt,1124,19,59,677,77,69,14,837
6924138_ListOfAsteroids136401136500.txt,1387,1,1387,381,0,4,0,385
6925420_SportsInVancouver.txt,595,17,35,241,77,34,21,373
6925439_FranoisDeCallires.txt,781,10,78,294,83,48,12,437
6927366_FridayNightSaturdayMorning.txt,2633,97,27,1377,260,88,71,1796
6928086_PatrickHadley.txt,1124,22,51,384,158,71,56,669
6930298_2006BaltimoreRavensSeason.txt,3588,49,73,1586,391,210,59,2246
6930381_2006TampaBayBuccaneersSeason.txt,2736,37,73,1157,289,211,54,1711
6930834_MohawkAirlinesFlight405.txt,942,15,62,340,135,64,33,572
6930848_Lodhran.txt,594,14,42,291,45,36,3,375
6933302_SoundFromUltrasound.txt,820,20,41,307,119,67,31,524
6934150_AirworkFlight23.txt,590,9,65,215,104,23,15,357
693423_AnswerMe.txt,681,9,75,463,43,15,4,525
693427_BobbyRahal.txt,731,16,45,306,84,44,22,456
693432_AirspeedHorsa.txt,599,13,46,234,81,36,15,366
693449_GlobalizationAndItsDiscontents.txt,2263,8,282,699,386,174,123,1382
6936068_2006IndianapolisColtsSeason.txt,9904,286,34,4593,758,515,150,6016
6936070_2006NewYorkGiantsSeason.txt,7699,108,71,3014,914,526,210,4664
694021_NortonDoncaster.txt,1138,15,75,375,181,79,36,671
694026_Bingcompany.txt,732,10,73,258,109,56,25,448
694064_BordGis.txt,991,20,49,426,122,66,33,647
6943790_ManfredSiebald.txt,1230,12,102,616,103,64,22,805
6943798_RomanCatholicBishopricOfOdense.txt,875,5,175,326,98,56,26,506
694414_RedBarongame.txt,850,20,42,316,115,49,33,513
694440_RyanMcneil.txt,633,6,105,231,124,24,18,397
694510_Komotv.txt,2286,42,54,1003,248,110,55,1416
694514_Zvezdaiss.txt,811,16,50,305,124,58,19,506
6949552_VioletMarkham.txt,615,7,87,208,71,35,13,327
6951108_WilliamHopeHodgsonsShortStories.txt,5780,83,69,1889,929,396,218,3432
6951301_CaoimheButterly.txt,1598,14,114,529,281,65,52,927
6951631_KeniStevens.txt,992,19,52,395,126,53,45,619
695215_HorizonProblem.txt,839,12,69,228,120,79,62,489
6954479_No247SquadronRaf.txt,793,9,88,322,99,38,20,479
695515_AkiBerg.txt,635,9,70,234,78,35,12,359
695526_HenryWatkin.txt,1842,15,122,770,192,133,42,1137
6955527_Konsolscript.txt,913,35,26,363,143,58,25,589
695578_ArgenteumAstrum.txt,1943,31,62,691,222,122,48,1083
6956352_AirPollutionDispersionTerminology.txt,2178,50,43,864,236,219,82,1401
6957889_SiegeOfKastania.txt,759,15,50,241,123,27,18,409
6958779_CapoeiraInPopularCulture.txt,1494,31,48,636,184,112,43,975
6964057_BattleOfTheArgentaGap.txt,675,15,45,242,82,58,14,396
696758_ThorpePark.txt,4727,81,58,1720,729,323,167,2939
69675_Porirua.txt,642,12,53,282,68,53,16,419
6967884_UnderTheIronSeaTour.txt,618,12,51,316,55,22,23,416
6967890_TimelineOfVirtualizationDevelopment.txt,2648,20,132,1015,370,202,129,1716
6968883_WhutItDewVol1.txt,615,3,205,403,28,9,7,447
69691_EsaiMorales.txt,999,8,124,386,122,47,28,583
69692_Nehushtan.txt,1012,15,67,339,152,44,34,569
69695_NechoIi.txt,882,10,88,324,126,39,24,513
69701_ShockingBlue.txt,839,15,55,435,50,48,18,551
69704_TurkishVan.txt,1230,18,68,416,187,101,58,762
69706_ListOfArchbishopsOfTours.txt,579,3,193,249,2,18,1,270
69708_CelticFc.txt,3117,72,43,1268,261,227,73,1829
69711_Focusband.txt,1648,34,48,730,156,123,48,1057
69713_RangersFc.txt,2539,97,26,1177,251,139,59,1626
69715_MountOfOlives.txt,868,13,66,383,80,50,20,533
69718_HerbertKitchener1stEarlKitchener.txt,3263,44,74,1267,443,187,99,1996
69720_GastrointestinalTract.txt,1391,23,60,526,182,136,44,888
6972776_WinmauWorldMasters.txt,613,15,40,317,50,21,8,396
697330_JohnnyGiles.txt,1015,17,59,347,119,71,37,574
697334_NormanHunter.txt,1690,19,88,552,230,133,74,989
69734_Mordecai.txt,657,15,43,246,106,28,11,391
697395_WizardsFirstRule.txt,988,18,54,344,139,75,32,590
6975795_RobertChapman.txt,736,9,81,204,91,49,40,384
69769_Bedfordshire.txt,759,29,26,386,77,41,7,511
69770_PortablePixmap.txt,562,16,35,206,42,43,18,309
69772_Bedford.txt,1503,29,51,692,152,121,38,1003
6977338_JeromeBRobertson.txt,892,14,63,344,113,43,21,521
69773_LivetsOrd.txt,725,14,51,301,93,54,20,468
697755_AnthonySpilotro.txt,2848,42,67,1242,420,119,64,1845
6978547_DawsonCollegeShooting.txt,3690,48,76,1450,529,214,95,2288
697872_BillyBathgate.txt,3103,38,81,935,505,166,163,1769
697875_Casperfilm.txt,4720,61,77,1411,790,246,258,2705
6980460_ListOfAndromedaStarSystems.txt,1657,43,38,604,266,99,74,1043
6980633_PhilosophicalExplanations.txt,4884,34,143,1473,693,505,240,2911
6981167_AnimalFarmInPopularCulture.txt,940,6,156,400,100,70,34,604
698436_YouAmI.txt,1231,24,51,457,174,94,44,769
698493_AqiFzono.txt,1531,20,76,664,183,124,32,1003
6986937_SchweitzerMountain.txt,716,11,65,299,92,43,9,443
6987299_YallaYaNasrallah.txt,549,50,10,167,73,31,35,306
698848_BattleOfKingsMountain.txt,1006,15,67,443,117,41,18,619
698937_DickCeleste.txt,559,14,39,236,71,26,18,351
698941_Plasticcom.txt,1096,10,109,356,163,96,37,652
6992172_ModernFurniture.txt,1126,18,62,373,136,115,46,670
6992798_PrivateOpera.txt,622,9,69,315,43,27,12,397
6993083_Luftwaffeband.txt,948,14,67,482,77,51,22,632
6994929_PeterAndJane.txt,690,9,76,228,92,44,38,402
699501_TimCollinssoldier.txt,1321,27,48,405,207,63,41,716
6996933_MissyHiggins.txt,910,22,41,447,74,46,6,573
6997597_AuroraProject.txt,600,8,75,190,120,19,25,354
6999867_GuitarSolosalbum.txt,602,13,46,237,84,28,18,367
7000348_LakeIloNationalWildlifeRefuge.txt,1125,19,59,415,152,93,35,695
7003349_JosDePaivaNetto.txt,900,10,90,391,70,61,14,536
7003716_DiamondTool.txt,804,19,42,289,139,78,30,536
7005651_ListOfDaveAndMorleyStories.txt,823,14,58,593,29,13,15,650
7006460_LostEden.txt,941,15,62,304,134,58,39,535
7006486_1978InTheUnitedKingdom.txt,565,6,94,293,32,21,2,348
700677_Zazaki.txt,910,20,45,464,75,53,17,609
7009049_AustralianCashmereGoat.txt,705,9,78,254,89,56,30,429
70098_DataLogging.txt,599,13,46,212,114,47,20,393
700_ArthurSchopenhauer.txt,4718,62,76,1599,622,347,219,2787
70107_AthensOhio.txt,2905,52,55,1180,363,231,85,1859
701124_Bodysnatching.txt,822,14,58,289,105,79,32,505
7011399_YoshiakiYatsu.txt,838,14,59,382,97,42,25,546
7011402_CampCoker.txt,3476,36,96,1313,535,209,78,2135
70117_Floodplain.txt,1347,20,67,470,178,128,63,839
7013058_2004NewYorkJetsSeason.txt,598,44,13,392,18,10,7,427
7013968_VadimZvjaginsev.txt,813,16,50,323,68,49,25,465
7015276_Openxava.txt,608,12,50,275,72,40,18,405
701615_SuryaKiran.txt,596,15,39,265,58,22,17,362
7016721_ConflictResolutionResearch.txt,2145,40,53,801,305,186,76,1368
7019127_SimmonsCollegemassachusetts.txt,673,29,23,329,67,38,20,454
701_Angola.txt,2372,48,49,985,255,169,54,1463
7020134_WilliamDamasusLindanus.txt,590,4,147,192,69,25,18,304
7020138_HokkaidoPrefecturalBoardOfEducation.txt,1636,99,16,1403,4,6,1,1414
702117_Spiderman3.txt,2603,30,86,1019,336,200,63,1618
7021710_MarshallLawrence.txt,866,32,27,322,109,70,20,521
7022053_TheThirteenthSonOfTheKingOfErin.txt,682,11,62,172,121,41,19,353
702214_EvoSearchForEden.txt,972,16,60,331,138,82,39,590
7022902_GuyCihi.txt,579,10,57,201,98,40,24,363
7025896_LandOfLakesChoirboys.txt,719,15,47,275,119,53,12,459
7025924_ModelsOfDnaEvolution.txt,724,29,24,263,78,60,21,422
7025945_ListOfMiddleearthOrcs.txt,1865,50,37,648,265,95,58,1066
7026749_ListOfDragonQuestViiiCharacters.txt,6081,98,62,1961,997,314,212,3484
7026767_RichardHindCambage.txt,636,8,79,228,72,29,10,339
7029496_A1GrandPrixCars.txt,614,8,76,240,86,43,20,389
7032315_HurricaneHelene2006.txt,972,16,60,295,124,113,44,576
703233_Maguscomics.txt,894,14,63,274,150,87,36,547
7033524_IntellectualEntrepreneurship.txt,1156,21,55,504,122,101,19,746
7035443_CalleighDuquesne.txt,739,17,43,259,98,38,40,435
7037393_CharlesLogan24Character.txt,3496,47,74,1227,607,165,139,2138
7037471_NewBrunswickHighSchool.txt,751,16,46,334,93,62,12,501
7038008_Letychiv.txt,1150,14,82,444,140,76,23,683
703932_HenryGrow.txt,693,10,69,273,90,34,16,413
7039345_408CheyTac.txt,575,7,82,219,70,43,17,349
703_GeographyOfAngola.txt,2425,48,50,1020,205,234,65,1524
7040883_UssGageapa168.txt,633,12,52,274,82,27,7,390
7042786_TheHornOfMortalDanger.txt,745,11,67,236,104,49,25,414
7042804_TakstephenKing.txt,1600,25,64,514,211,121,95,941
704317_Tilehurst.txt,587,21,27,254,49,39,13,355
704359_MethodsOfContourIntegration.txt,1982,131,15,512,248,193,80,1033
704379_JamesPavitt.txt,645,17,37,340,46,13,10,409
704381_CoolDevices.txt,1740,22,79,612,258,99,44,1013
7044715_HistoricalCoveragesOfAbscbn.txt,1828,37,49,743,170,195,48,1156
7046272_DutchWomensCricketTeam.txt,620,24,25,215,68,66,15,364
7048566_MobileSuitGundamTheOrigin.txt,810,9,90,318,70,57,32,477
7049188_LegoStarWars.txt,839,13,64,359,104,66,27,556
704958_WilsonPhillips.txt,1414,25,56,475,229,73,56,833
704_DemographicsOfAngola.txt,806,22,36,309,68,109,19,505
7050464_SexDisqualificationremovalAct1919.txt,663,12,55,205,103,31,22,361
7051096_KristaStarr.txt,1775,13,136,546,331,61,51,989
7051491_Poltergeist1982Film.txt,1360,25,54,512,197,73,55,837
7052178_HistoryOfHadith.txt,1439,35,41,454,245,95,48,842
7052588_WilhelmDukeOfSaxeweimar.txt,575,12,47,229,50,29,11,319
7053061_MicheleBardsleyauthor.txt,878,44,19,618,32,23,7,680
705401_TankMan.txt,1204,18,66,475,147,68,39,729
705487_DorothyFay.txt,688,16,43,328,69,22,12,431
705489_SamuelRomilly.txt,884,12,73,285,113,48,24,470
705501_PierAngeli.txt,579,8,72,213,78,28,13,332
7055037_Virus1980Film.txt,889,12,74,341,126,72,25,564
7056868_FoundationsOfChristianity.txt,596,11,54,177,79,44,35,335
7056911_DivesInMisericordia.txt,843,11,76,287,94,66,38,485
7056912_ClootieWell.txt,624,11,56,259,64,27,27,377
705_PoliticsOfAngola.txt,625,11,56,279,72,51,18,420
7061856_CarloLottieri.txt,731,31,23,438,35,25,2,500
7065592_PipeFitting.txt,1002,21,47,368,167,101,44,680
706566_DuncanSheik.txt,774,16,48,357,74,55,18,504
706580_She.txt,2873,40,71,1095,351,225,129,1800
706590_DalecarlianHorse.txt,1021,16,63,313,174,87,41,615
7066892_TechniquesForCreatingAUserCenteredDesign.txt,1306,16,81,438,180,129,38,785
7067596_Smoothvega.txt,738,18,41,240,114,69,30,453
7069426_HoysaleswaraTemple.txt,1262,13,97,460,154,96,23,733
706_EconomyOfAngola.txt,1009,9,112,396,124,74,33,627
7070568_AdolfoMllerury.txt,596,3,198,274,38,16,13,341
7070917_ChandrashekharPrasad.txt,681,15,45,258,80,53,17,408
707114_OmarVizquel.txt,1208,11,109,421,152,78,49,700
7071407_RussianTraditionsAndSuperstitions.txt,2484,68,36,582,478,187,188,1435
7072487_JamesBurnsshipowner.txt,774,13,59,305,95,32,24,456
7073286_ChristChurchSchool.txt,907,19,47,330,116,79,28,553
7074380_2006AflGrandFinal.txt,897,22,40,385,95,71,18,569
7074418_ErzhuZhao.txt,1372,11,124,542,200,57,58,857
7074419_BahianCarnaval.txt,684,9,76,248,87,85,15,435
707628_CharlesRobertJenkins.txt,954,14,68,380,143,42,24,589
70764_FlagOfFrance.txt,933,21,44,281,129,90,28,528
707667_GritoDeLares.txt,1422,18,79,556,180,87,46,869
70775_TranscanadaHighway.txt,2185,41,53,928,220,131,63,1342
70780_UsRoute101.txt,2852,37,77,1234,272,128,87,1721
7078169_Building800austinHall.txt,3400,35,97,1478,416,179,81,2154
7078412_AssociaoGaitadefole.txt,603,15,40,234,65,41,21,361
70786_PoeticEdda.txt,2688,37,72,1319,229,203,65,1816
7080086_TheRomanCatholicChurchAndColonialism.txt,578,12,48,192,74,54,21,341
7080091_CheapPopForTheElite.txt,734,12,61,271,62,61,24,418
7081430_UssNewdd818.txt,934,17,54,393,98,40,11,542
708203_BilkentUniversity.txt,2111,39,54,1096,154,152,37,1439
708207_NotProven.txt,942,19,49,275,156,65,70,566
7083395_KansasLicensePlateCountyCodes.txt,722,9,80,461,55,22,21,559
70842_IdiAmin.txt,3519,43,81,1430,486,182,94,2192
70843_HafezAlassad.txt,2822,27,104,1039,356,259,105,1759
70844_FranoisDuvalier.txt,808,14,57,273,124,47,24,468
70847_XrayPhotoelectronSpectroscopy.txt,2472,48,51,1107,232,206,50,1595
70848_JohnKinzie.txt,610,10,61,222,116,22,9,369
70849_WilliamWhitelaw1stViscountWhitelaw.txt,795,13,61,288,105,39,21,453
70850_SmithOfWoottonMajor.txt,602,12,50,190,79,40,24,333
70854_BillyWrightloyalist.txt,1430,20,71,531,216,55,47,849
70855_Stadtholder.txt,1559,25,62,672,124,94,36,926
7085871_PaulCallan.txt,727,14,51,252,101,59,27,439
70866_BombyxMori.txt,970,19,51,362,145,68,28,603
708679_RicottaCheese.txt,666,15,44,213,104,72,36,425
7087162_ContrabassBugle.txt,791,10,79,250,112,67,40,469
708720_GovernorOfPuertoRico.txt,800,16,50,336,80,28,15,459
708722_TheChoirboysbook.txt,1670,23,72,580,209,134,70,993
70873_NathuramGodse.txt,809,22,36,340,119,33,31,523
7088871_SydneyUniversityStudentsAfc.txt,609,11,55,220,53,50,14,337
7089085_PhysicalInformationSecurity.txt,606,10,60,189,103,61,39,392
708_TransportInAngola.txt,541,27,20,211,54,38,11,314
7090784_ShintyInTheUnitedStates.txt,908,29,31,422,109,46,16,593
7090788_Viswadarsanam.txt,1099,18,61,389,140,87,21,637
7091922_CambuslangClergy.txt,1051,11,95,477,96,39,39,651
7092724_RaceRelationsOfCincinnatiOhio.txt,954,10,95,352,144,55,39,590
709404_PatrickFitzgerald.txt,1255,24,52,512,173,62,32,779
709409_ArdeatineMassacre.txt,638,10,63,201,111,30,22,364
7094867_FriedrichKellnerDiary.txt,3067,35,87,1001,433,194,134,1762
709856_ListOfZipCodesInTennessee.txt,3005,15,200,1215,1,8,1,1225
7102258_PointArenaLight.txt,848,11,77,332,112,68,15,527
7103647_UssCarpenterdd825.txt,4041,55,73,1789,455,241,59,2544
710504_HansHendrikVanPaesschen.txt,426,7,60,186,38,24,17,265
710521_MarcusBrigstocke.txt,736,17,43,297,91,56,27,471
7106109_Petrosomatoglyph.txt,5751,48,119,2251,735,324,123,3433
7106585_Worldadjective.txt,834,26,32,279,128,81,30,518
7106595_Eurochannel.txt,1094,25,43,506,93,93,21,713
7107237_BorgheseCollection.txt,697,12,58,282,68,46,22,418
710908_Psunix.txt,602,28,21,214,82,40,12,348
71131_Quarkxpress.txt,1052,22,47,442,125,88,28,683
71138_WavefunctionCollapse.txt,917,18,50,296,119,88,46,549
7114751_Impshera.txt,742,4,185,205,123,62,43,433
7115743_RichardArnst.txt,1120,15,74,395,171,49,37,652
711606_DonLarsen.txt,1794,25,71,689,244,102,53,1088
7116160_NigelMcguinness.txt,1223,23,53,512,163,48,27,750
7116655_ComplianceRequirements.txt,3829,43,89,1426,506,338,106,2376
7116671_OmbA133ComplianceSupplement.txt,890,18,49,409,91,69,16,585
7116859_VijayanagaraArchitecture.txt,1596,20,79,690,218,113,36,1057
7118603_SggsOnWomen.txt,824,15,54,300,107,46,29,482
7118775_Bayardohorse.txt,1242,16,77,503,142,66,42,753
711932_LipoidCongenitalAdrenalHyperplasia.txt,1522,24,63,501,227,220,73,1021
7119577_YosefWeitz.txt,2190,16,136,655,329,171,105,1260
711_AlbertSidneyJohnston.txt,1436,16,89,549,180,69,20,818
712033_GovernmentOfBirmingham.txt,1044,25,41,449,129,56,31,665
712041_PeterAndr.txt,631,12,52,253,79,38,22,392
7120521_RoyalJerseyAgriculturalAndHorticulturalSociety.txt,1836,43,42,665,249,112,42,1068
712081_UrbanizationInAfrica.txt,2748,40,68,979,346,218,103,1646
712096_MthElectricTrains.txt,872,13,67,360,120,57,22,559
7124543_RafMendlesham.txt,653,17,38,287,74,41,11,413
7125391_EdwardAbrahamByrne.txt,1129,24,47,438,109,68,25,640
712634_VanuaLevu.txt,702,15,46,255,78,58,25,416
7126458_BernardJungmann.txt,601,2,300,231,58,50,12,351
7129208_NotableNationalBasketballAssociationGamesTelevisedByNbc.txt,2498,15,166,1074,254,138,56,1522
712_ArcticOcean.txt,1826,33,55,790,184,135,67,1176
713173_WhitewaterRacing.txt,895,12,74,324,129,76,34,563
713194_AmazonasRegion.txt,5753,165,34,1932,738,469,159,3298
713198_ThiefcomputerGameSeries.txt,3632,58,62,1340,490,298,155,2283
7132138_HockeyAtThe1999PanAmericanGames.txt,1233,107,11,888,26,19,0,933
7136934_NoReasonhouseEpisode.txt,807,21,38,297,123,42,19,481
713830_ListOfSpanishBirdsNonpasserines.txt,2272,43,52,1459,50,127,16,1652
713833_MachiasSealIsland.txt,1755,29,60,706,218,106,45,1075
713_Android.txt,2839,31,91,996,420,274,138,1828
7140940_WhoKilledAtlantasChildren.txt,651,6,108,252,99,27,15,393
7140951_NewRichmondHighSchool.txt,608,20,30,314,58,40,16,428
7140979_TheBumblebeeFliesAnyway.txt,665,19,35,259,103,25,14,401
714175_MathieuBiron.txt,232,7,33,102,7,5,2,116
7141764_DinoItalianLoveSongs.txt,629,7,89,386,18,24,3,431
7141815_WilliamJacksonsecretary.txt,749,13,57,327,80,26,12,445
714218_TheNotebook.txt,1261,12,105,434,209,54,60,757
714266_BorderTerrier.txt,1713,30,57,591,243,155,91,1080
714268_PyloricStenosis.txt,724,17,42,226,99,104,31,460
714275_Oyaji.txt,794,14,56,440,66,64,35,605
714286_Travnik.txt,1425,26,54,518,161,111,53,843
7143874_SouthCarolinaGubernatorialElection1890.txt,964,16,60,341,138,60,22,561
7145803_TheBishopsHeir.txt,1187,13,91,526,144,69,28,767
7146713_RepublicOfGumuljina.txt,756,23,32,493,46,30,7,576
7147749_BritishGasPlc.txt,851,28,30,401,78,57,14,550
7148561_TheDebaters.txt,608,8,76,335,41,31,10,417
714928_GreenlandDog.txt,694,9,77,202,113,64,32,411
7149645_TrinnySusannahUndress.txt,1151,22,52,362,212,70,51,695
7150599_152mmGunM191034.txt,527,11,47,181,65,31,23,300
7150602_AlfaRomeoBat.txt,705,8,88,220,87,64,22,393
7151570_MotherNaturesSononlyFoolsAndHorses.txt,757,16,47,276,115,40,21,452
7152443_ListOfContemporaryEpistolaryNovels.txt,788,17,46,366,64,64,13,507
715265_ConfederationOfAfricanFootball.txt,890,16,55,453,10,21,3,487
715268_NorthernBelle.txt,1336,28,47,489,193,62,48,792
715277_Metamorpho.txt,632,10,63,234,94,39,15,382
715308_WhirlpoolGalaxy.txt,1113,27,41,379,129,116,58,682
7156291_ChildrenAndArt.txt,689,13,53,283,112,18,26,439
7157370_ItalianOrderOfBattleSecondItaloabyssinianWar.txt,707,6,117,477,9,54,4,544
7159290_AstroFlight.txt,778,8,97,315,90,57,11,473
7159295_KlausmichaelMallmann.txt,916,5,183,513,44,40,3,600
7161240_MargaretUrlich.txt,1292,67,19,544,142,83,42,811
7163160_DirectiveOnTheResaleRightForTheBenefitOfTheAuthorOfAnOriginalWorkOfArt.txt,597,9,66,209,50,48,18,325
716399_NuVirgos.txt,1905,24,79,888,209,134,56,1287
7165925_RobertRogers28rulesOfRanging.txt,1004,39,25,280,164,65,35,544
7166283_EvanXHyde.txt,884,12,73,392,86,41,21,540
7169508_MuhammadMansurAli.txt,875,9,97,372,119,52,13,556
7170129_BearcatStadium.txt,614,10,61,238,91,30,16,375
7170499_GeorgeEnt.txt,1138,22,51,480,131,48,27,686
7171044_ListOfFoxtrotFamilyMembers.txt,4703,30,156,1396,817,287,296,2796
717439_SubreplacementFertility.txt,1377,24,57,479,177,162,86,904
717455_SkinnerVOklahoma.txt,862,12,71,295,113,70,45,523
717461_BrynTerfel.txt,676,16,42,294,68,38,14,414
717485_LiTie.txt,611,18,33,234,68,37,19,358
7175435_PhonologicalHistoryOfEnglishDiphthongs.txt,1430,37,38,480,176,144,72,872
7177859_ScythesInPopularCulture.txt,942,33,28,388,101,57,25,571
717_Alberta.txt,5777,97,59,2252,650,548,185,3635
7180130_WilliamKwaiSunChow.txt,794,16,49,292,112,64,35,503
7180862_HaloWars.txt,758,12,63,307,111,41,26,485
7182059_Bloodbucket.txt,968,13,74,349,141,52,42,584
718545_Gracecomics.txt,580,11,52,165,104,41,35,345
718548_TrainmasterCommandControl.txt,629,11,57,273,86,62,13,434
7185684_1985InNascar.txt,1621,126,12,1206,100,2,1,1309
718576_Puyo.txt,1023,16,63,331,132,89,27,579
718587_ListOfCreditUnions.txt,3129,18,173,2550,34,34,4,2622
718629_TheRealGhostbusters.txt,2245,31,72,971,277,120,66,1434
7187855_HarveyOrenBanks.txt,685,10,68,298,77,33,14,422
7188932_PictsInFantasy.txt,784,14,56,259,105,63,34,461
718_ArcticCircle.txt,552,11,50,206,48,48,21,323
7190451_WhereLoveHasGonefilm.txt,578,9,64,241,94,17,5,357
71915_CommandLineInterpreter.txt,540,12,45,230,54,46,21,351
71916_ListOfOperatingSystems.txt,3815,53,71,2132,318,242,92,2784
7192700_SunanGunungjati.txt,793,21,37,303,106,41,29,479
7192788_JosephWheelerHighSchool.txt,614,12,51,322,60,43,13,438
71930_Segovia.txt,746,18,41,303,83,53,20,459
71932_AndrsSegovia.txt,1157,19,60,422,152,85,38,697
71933_Plutodisney.txt,760,12,63,345,84,31,31,491
719340_TheTwilightZoneTowerOfTerror.txt,1976,32,61,769,233,123,61,1186
71935_SchoolAndUniversityInLiterature.txt,1018,4,254,799,17,27,2,845
71949_TokPisin.txt,1434,40,35,538,196,131,69,934
7196553_DravidianMartialArts.txt,493,13,37,224,47,37,5,313
719667_Invasionsliders.txt,1014,9,112,328,161,57,40,586
719677_SomaliRegion.txt,638,13,49,262,69,39,13,383
719719_TheSourcemagazine.txt,2784,28,99,1060,424,160,84,1728
7197623_BobBurtonJr.txt,785,13,60,333,70,39,22,464
7197628_Bqm147Dragon.txt,759,13,58,269,123,51,33,476
7198447_DigimonRpg.txt,732,17,43,251,122,52,27,452
7199202_2007LeMansSeriesSeason.txt,566,6,94,235,84,32,7,358
719_AssaultRifle.txt,4189,47,89,1484,535,457,172,2648
7201124_TheSaintsAreComing.txt,815,12,67,307,110,57,15,489
7203009_CharlesHenryCarter.txt,550,10,55,217,68,29,9,323
7203045_TheAmazingRaceAsia1.txt,3809,60,63,1600,494,166,84,2344
720425_MonarchyInNewZealand.txt,4679,97,48,1961,457,267,165,2850
7205948_SerbiaInTheJuniorEurovisionSongContest.txt,316,28,11,159,24,13,2,198
720739_JohnSo.txt,1296,23,56,505,174,81,29,789
720758_FasterPussycat.txt,1322,25,52,620,158,88,28,894
7207683_NflCheerleaderPlayoffs.txt,1025,18,56,457,115,69,18,659
720783_WilliamTrevor.txt,1089,13,83,488,95,67,21,671
720805_RobertoBolao.txt,1003,10,100,376,108,92,27,603
7208117_CarBabes.txt,925,27,34,337,136,51,28,552
7208720_RafHalesworth.txt,1085,35,31,460,127,82,23,692
7210644_CharlesTennant.txt,806,10,80,341,91,60,15,507
7211140_WorldNeighbors.txt,1055,34,31,453,143,90,27,713
7211547_VolkswagenPoloMkIii.txt,1690,28,60,639,229,121,55,1044
7211969_SimpleChurch.txt,1930,29,66,704,258,212,90,1264
7214031_TrinitypawlingSchool.txt,1317,27,48,462,181,136,28,807
7214036_DraconianMeasures.txt,1269,14,90,413,214,60,51,738
7214055_Dipalpur.txt,1228,13,94,428,199,86,41,754
7214517_TefftMiddleSchool.txt,626,11,56,290,72,54,15,431
7214586_AngolMois.txt,608,5,121,226,82,34,18,360
7218424_FarewellAldebaran.txt,630,14,45,274,60,39,21,394
721862_UnionOfTheCrowns.txt,2835,33,85,913,377,240,134,1664
721_Animal.txt,2068,40,51,681,305,232,102,1320
7221198_DisneyChannelsHauntoberFest2006.txt,1047,19,55,452,90,34,29,605
72227_Plywood.txt,646,17,38,261,110,48,21,440
7223128_Leboku.txt,626,10,62,249,78,34,16,377
7223603_TheOneNetwork.txt,1047,19,55,454,113,83,31,681
7224529_IainBallamy.txt,875,48,18,544,31,18,3,596
7226221_WorldLargestCities.txt,1534,30,51,272,2,28,0,302
722903_AliceBunkerStockham.txt,636,14,45,216,87,64,27,394
722906_Inclusio.txt,591,7,84,160,83,45,19,307
722949_Formationfootball.txt,3000,66,45,1007,397,197,127,1728
722993_PostmodernLiterature.txt,1044,17,61,415,97,105,27,644
7230463_VacaValleyRailroad.txt,817,12,68,378,96,26,7,507
7233280_SemanticInteroperability.txt,868,10,86,245,145,89,33,512
72336_BarbraStreisand.txt,2914,57,51,1237,343,184,68,1832
72337_MichaelViiiPalaiologos.txt,1055,18,58,461,116,40,23,640
72339_Blackberry.txt,1022,19,53,378,146,99,42,665
72340_MetroManila.txt,4546,66,68,2093,470,327,117,3007
72346_Kohen.txt,4899,72,68,1691,698,361,180,2930
72348_ColumbiaCountyFlorida.txt,582,15,38,236,55,38,2,331
723614_RichardCorbett.txt,866,20,43,340,97,61,18,516
723621_CountJohannHartwigErnstVonBernstorff.txt,1270,13,97,424,154,83,59,720
7237054_PipilLanguage.txt,1671,34,49,662,183,181,89,1115
7237152_PipilLanguagetypologicalOverview.txt,1071,28,38,378,128,126,47,679
723992_RedbackSpider.txt,1079,28,38,353,173,122,52,700
723993_GreatObservatoriesProgram.txt,1795,21,85,630,268,216,92,1206
723999_PhilipBradbourn.txt,2356,69,34,921,275,161,65,1422
724091_GravitationalBeamEmitter.txt,615,15,41,194,101,36,34,365
7241996_IslamInGeorgiacountry.txt,1704,26,65,609,198,122,53,982
7242819_ListOfSecondaryCharactersFromTheVentureBros.txt,3124,25,124,1256,407,185,98,1946
7242849_CoinsOfTheHawaiianDollar.txt,1361,25,54,593,120,83,17,813
7243928_CyclopsLaser.txt,676,11,61,224,88,78,39,429
724704_BriannaDiggers.txt,2367,24,98,707,364,164,144,1379
724705_PeterMcwilliams.txt,1652,20,82,664,224,98,60,1046
7249236_SerbsOfTheRepublicOfMacedonia.txt,1161,15,77,456,113,113,32,714
725082_Diverticulosis.txt,672,10,67,249,102,59,23,433
725091_TexasInstrumentsTms9918.txt,1586,25,63,514,217,124,79,934
7251168_JoaquinPasos.txt,621,7,88,220,56,59,17,352
725182_Official.txt,960,15,64,311,104,104,32,551
7257148_JohnRichardsLapenotire.txt,933,10,93,304,120,58,32,514
725770_JustinSmithMorrill.txt,589,11,53,210,50,44,18,322
7258437_TaltosstevenBrustNovel.txt,1153,13,88,438,143,70,37,688
7259078_KilleradamskiSong.txt,595,20,29,316,37,33,10,396
7259975_UabBlazers.txt,1132,15,75,499,130,67,34,730
7260371_2006SchoolShootingOutbreak.txt,696,9,77,268,114,30,13,425
726176_SantaFeOpera.txt,1785,26,68,683,220,141,41,1085
726183_Area7novel.txt,5705,49,116,2172,821,321,111,3425
7266985_TheQuestForSaintCamber.txt,1600,14,114,687,183,80,45,995
7268529_ThatHouseWeLivedIn.txt,796,12,66,437,46,45,14,542
726884_Nightlifealbum.txt,931,16,58,395,88,41,32,556
7269900_FoodSafetyNetwork.txt,744,28,26,347,81,62,10,500
7271431_BikerBuildoff.txt,923,20,46,443,61,40,15,559
7271612_DaniGarza.txt,1053,14,75,501,97,55,19,672
727341_InnerCircleRailwayLineMelbourne.txt,934,15,62,375,106,49,42,572
727370_Nocturama.txt,573,5,114,432,7,5,1,445
727371_JohnAlexanderDowie.txt,788,16,49,297,80,32,23,432
7277601_NintendoDsAccessories.txt,2007,47,42,799,287,121,68,1275
727910_KennyChesney.txt,802,21,38,350,69,37,23,479
7280623_TheAmazingAdventuresOfKavalierAndClayfilm.txt,679,9,75,236,92,29,30,387
7280627_FrancisRichter.txt,803,16,50,306,87,46,10,449
7283_Controversy.txt,947,18,52,522,89,80,26,717
7284095_RogerDKornberg.txt,1128,16,70,467,137,81,25,710
728434_ZamorachinchipeProvince.txt,770,18,42,285,104,48,13,450
7285297_MasjidAbdulGaffoor.txt,1083,29,37,389,157,94,22,662
7286038_KrishnaMohanBanerjee.txt,772,15,51,290,100,40,18,448
7286379_ShinigamiEyes.txt,723,7,103,212,140,43,27,422
7286410_K1WorldGrandPrix1996.txt,491,23,21,269,35,29,2,335
7288221_SasuketelevisionSeries.txt,1194,28,42,489,113,89,36,727
7289166_DieterBurdenski.txt,759,11,69,296,83,45,15,439
7293242_MyLadyMolly.txt,922,5,184,345,71,38,19,473
7293_Commodore64.txt,4178,60,69,1590,505,309,138,2542
729443_JuanVelascoAlvarado.txt,993,17,58,325,145,96,32,598
7294_Cartography.txt,2601,39,66,996,333,232,93,1654
729591_ListOfFrenchBirdsNonpasserines.txt,2097,40,52,1318,44,175,4,1541
729601_Simmern.txt,901,17,53,328,104,97,22,551
7296259_HoChiMinhCityUniversityOfTechnology.txt,608,13,46,269,75,24,8,376
7299004_KevinBramble.txt,599,7,85,228,83,35,22,368
7299_Colonialism.txt,1945,30,64,756,223,189,65,1233
7300937_IsaacBenMosesArama.txt,1034,9,114,354,111,83,45,593
7300967_AutomaticallyTunedLinearAlgebraSoftware.txt,1069,35,30,420,132,84,43,679
73010_HardcorePunk.txt,4342,62,70,1784,480,459,174,2897
730131_The7thSaga.txt,1363,18,75,447,199,110,58,814
7301399_QueenCallista.txt,608,5,121,196,93,30,24,343
7301404_LabradorNatureReserve.txt,932,21,44,302,145,66,37,550
7301_Casablanca.txt,2136,56,38,869,245,176,51,1341
7302038_PolishswedishWar16001611.txt,1694,17,99,560,248,117,91,1016
730205_MarvinTRunyon.txt,753,18,41,282,116,55,29,482
7302065_PolishswedishWar16251629.txt,1306,14,93,494,189,71,33,787
73021_Cumbria.txt,1298,35,37,680,102,75,24,881
7302871_JulianMoti.txt,739,11,67,281,105,59,13,458
73034_NataliaPrincessBrassova.txt,611,9,67,228,78,34,23,363
7303_Cross.txt,747,20,37,272,89,64,37,462
7304797_RafFramlingham.txt,821,27,30,371,92,55,7,525
7304_Complexchemistry.txt,2566,34,75,933,342,297,87,1659
7305_Coleco.txt,778,21,37,329,89,43,25,486
7306_Colecovision.txt,1350,26,51,548,162,104,46,860
7308_ChristianCross.txt,3314,36,92,1259,403,214,92,1968
7309043_MoistureAnalysis.txt,1488,30,49,530,217,132,62,941
7310732_TaffyWasAWelshman.txt,631,28,22,227,116,15,23,381
7310741_AdilbekDzhaksybekov.txt,809,12,67,343,102,48,4,497
7310761_GeorgeFrederickMckay.txt,1637,14,116,844,124,113,26,1107
7310973_IssueOfEdwardIiiOfEngland.txt,1117,22,50,455,133,59,24,671
7310_ConventionalWarfare.txt,856,14,61,275,134,91,50,550
7315443_Carnivoresseries.txt,3071,77,39,1121,425,210,135,1891
7316550_ShipsOfTheIndianNavy.txt,1174,67,17,746,15,7,1,769
731670_MazdaLuce.txt,778,29,26,295,71,48,14,428
7316_AlternativeBiochemistry.txt,3527,65,54,1205,483,402,176,2266
731773_StockPhotography.txt,1257,21,59,454,196,101,44,795
731778_FletcherPratt.txt,839,21,39,420,43,20,8,491
731779_MovieProjector.txt,5728,78,73,1918,809,476,245,3448
7324611_JohnOfGorze.txt,643,15,42,272,80,29,14,395
7325242_FranciscoGilDeTaboada.txt,1001,19,52,347,131,55,18,551
7327000_Abnaxus.txt,580,17,34,161,97,27,28,313
7327173_LilScrappy.txt,706,13,54,339,73,43,12,467
7327447_NorthwestDistrictlcms.txt,2602,34,76,2023,34,84,5,2146
732763_LumpOfLabourFallacy.txt,792,13,60,257,128,57,30,472
732771_UssVincennescl64.txt,3631,51,71,1444,448,225,100,2217
732780_TonyHawksUnderground.txt,2046,23,88,965,169,119,40,1293
732786_AllanClarkefootballer.txt,1108,13,85,364,153,75,41,633
7327988_Primordialsexalted.txt,721,7,103,270,89,31,26,416
732860_IamblichusOfChalcis.txt,1812,23,78,565,251,170,74,1060
732868_SusanBAnthonyDollar.txt,769,18,42,281,114,54,24,473
7330026_PrecipicebattlestarGalactica.txt,915,15,61,327,147,34,42,550
73311_FalmouthCornwall.txt,1284,25,51,567,130,87,33,817
73316_TacomaNarrowsBridge.txt,2260,39,57,860,322,133,56,1371
7332942_CeciliaStegChil.txt,800,13,61,293,79,40,22,434
7333754_DefenseOfHarbin.txt,807,11,73,323,124,42,12,501
7333765_Douglasmotorcycles.txt,755,12,62,309,80,38,16,443
733451_OccidentalPetroleum.txt,744,17,43,301,87,49,15,452
7334869_ExodusbattlestarGalactica.txt,1575,30,52,586,255,54,49,944
73369_Montpellier.txt,1961,36,54,809,183,104,28,1124
73370_LastOfTheSummerWine.txt,1664,33,50,583,214,149,65,1011
73373_Malvasia.txt,782,9,86,295,110,50,51,506
73375_BrideOfFrankenstein.txt,1135,17,66,437,156,69,53,715
7337626_CouncilOfWomenWorldLeaders.txt,866,67,12,577,27,35,7,646
733901_WithHonors.txt,785,15,52,261,118,43,27,449
733950_JohnnyCage.txt,3321,40,83,1299,474,188,105,2066
7342499_HillsboroughBarracks.txt,973,22,44,398,113,53,21,585
7342571_SelectiveCalling.txt,3316,56,59,1168,538,289,100,2095
73426_Irisplant.txt,2220,30,74,1183,252,154,61,1650
73428_DoTheRightThing.txt,2382,39,61,1019,314,135,62,1530
7343414_TheTrixwinxClub.txt,1058,15,70,393,149,81,30,653
7343853_HowDirtyGirlsGetCleantheRehabDemos.txt,2370,32,74,858,327,152,113,1450
73438_DoubleIndemnity.txt,1280,25,51,501,180,77,41,799
7344400_DanielBest.txt,796,2,398,250,140,44,29,463
734541_BourkeStreetMelbourne.txt,811,23,35,364,88,61,20,533
734567_BarberInstituteOfFineArts.txt,574,11,52,252,64,31,8,355
734667_IconicMemory.txt,966,20,48,338,124,103,36,601
734679_Uhlan.txt,1645,28,58,600,219,146,51,1016
7349568_BenedettaTagliabue.txt,591,10,59,263,57,24,11,355
734963_1492ConquestOfParadisealbum.txt,571,15,38,225,68,34,12,339
734995_EpicCycle.txt,1490,28,53,536,178,122,51,887
7350181_JeffryHouse.txt,660,8,82,365,60,31,10,466
7352127_CaledonianMacbrayneFleet.txt,996,7,142,440,94,43,28,605
7357014_ArjunVishnuvardhan.txt,664,22,30,311,55,45,6,417
7358931_SimonEfemey.txt,618,5,123,412,17,12,2,443
736040_ListOfCentralBanks.txt,1066,5,213,781,10,32,5,828
736057_MarshallHallphysiologist.txt,654,9,72,219,80,48,8,355
736139_ThirdTaiwanStraitCrisis.txt,1197,18,66,477,151,82,25,735
7363727_Whoniverse.txt,1506,15,100,563,202,119,69,953
7364118_U218Singles.txt,739,15,49,357,56,32,30,475
7365656_GeorgeCondo.txt,3153,71,44,2256,53,68,10,2387
7367566_Collectspace.txt,814,18,45,371,108,53,17,549
736_AlbertEinstein.txt,9482,139,68,3211,1277,766,344,5598
737120_TombKings.txt,1735,27,64,573,258,126,57,1014
737123_KnightLore.txt,1041,25,41,398,142,69,52,661
737130_FrancisCardinalGeorge.txt,1743,29,60,702,223,79,62,1066
737147_HeyYouPikachu.txt,643,8,80,204,122,43,24,393
737150_CapLopez.txt,592,8,74,178,95,50,28,351
737184_87Sylvia.txt,773,11,70,275,91,58,29,453
737234_Mobsters.txt,948,4,237,492,85,44,22,643
737240_InFlames.txt,1782,37,48,772,196,113,52,1133
7373420_SportInBelize.txt,775,18,43,322,114,52,32,520
7377269_RonFullerwrestler.txt,894,10,89,349,145,27,30,551
737884_CombatGroupsOfTheWorkingClass.txt,1024,23,44,385,133,68,27,613
7379163_DavidWatkinhistorian.txt,776,12,64,388,60,48,19,515
737928_AccuracyInternationalArcticWarfare.txt,992,28,35,392,126,89,35,642
737_Afghanistan.txt,7076,114,62,2797,835,587,212,4431
7381123_MedzhibozhhasidicDynasty.txt,735,15,49,337,82,32,20,471
7385351_Metzengerstein.txt,615,12,51,225,77,50,17,369
7385416_TheTangent.txt,875,18,48,351,120,58,29,558
7386966_BrisbaneBroncosHistory.txt,1368,19,72,519,169,89,40,817
738_Albania.txt,3133,39,80,1207,437,259,96,1999
7391110_AmericansInHongKong.txt,595,7,85,232,66,55,24,377
7392616_SirrAlkhatimAlkhalifa.txt,974,14,69,383,124,72,18,597
7392741_GothamsUltimateCriminalMastermind.txt,2590,34,76,913,411,197,125,1646
7393588_71stRegimentOfFoot.txt,921,15,61,313,108,53,8,482
739369_NauvooLegion.txt,935,15,62,377,112,45,31,565
739372_DialHForHero.txt,1249,17,73,410,179,100,43,732
739400_Hrth.txt,1014,36,28,344,124,116,27,611
739416_Crimsonland.txt,1803,45,40,599,262,118,75,1054
739423_RiyadPasha.txt,740,11,67,208,114,61,34,417
7399414_IsaacBenSamuel.txt,684,10,68,280,78,36,20,414
740039_FefeDobson.txt,1145,24,47,434,179,79,38,730
740107_SasukeUchiha.txt,4045,40,101,1272,675,207,232,2386
7401780_BassEffects.txt,707,20,35,266,95,72,31,464
7402334_Wccs.txt,916,20,45,373,104,57,29,563
740463_SkinGrafting.txt,773,13,59,261,122,69,32,484
740492_ListOfPeoplePardonedByBillClinton.txt,931,6,155,726,39,17,9,791
7405193_NancyDickerson.txt,586,13,45,243,68,29,7,347
7405290_JosephIbnShemtov.txt,1491,23,64,587,165,92,42,886
7406167_CharlesTMcdowell.txt,917,13,70,421,87,48,12,568
7406637_Randlord.txt,602,15,40,308,43,31,10,392
7407108_StBrigidsroscommon.txt,739,23,32,383,58,33,3,477
7407226_SouthSydneyRabbitohsPlayers.txt,880,45,19,554,17,12,1,584
7409149_RothesayCastle.txt,1079,16,67,383,140,82,24,629
7409150_PraefectusUrbi.txt,743,9,82,258,104,39,26,427
74093_YumBrands.txt,633,13,48,330,63,22,13,428
74094_JohnDouglas9thMarquessOfQueensberry.txt,784,11,71,268,124,36,25,453
7409522_BagdadTamaulipusMexico.txt,1648,34,48,623,210,101,60,994
74097_JamesMcneillWhistler.txt,1190,23,51,475,148,70,41,734
74098_HockeyHallOfFame.txt,1977,23,85,926,216,116,42,1300
740_Allah.txt,1694,30,56,618,220,121,63,1022
741132_ChildrenOfAlbionPoetryOfTheUndergroundInBritain.txt,578,13,44,230,65,39,15,349
7412013_TheThumbs.txt,557,7,79,352,29,19,8,408
7412991_MassInEFlatMajor.txt,708,11,64,272,89,64,20,445
741599_PaysDeCaux.txt,1941,28,69,665,251,136,58,1110
741881_HiibelVSixthJudicialDistrictCourtOfNevada.txt,617,14,44,212,116,29,26,383
741887_AltaiRepublic.txt,1555,35,44,600,159,158,57,974
741895_NicholasPavlovichIgnatiev.txt,796,10,79,288,96,50,26,460
741897_JosephAnthonyFerrario.txt,663,15,44,273,68,38,13,392
741966_SuppressionOfTheJesuits.txt,2142,24,89,713,295,113,55,1176
741970_MojaveSpaceport.txt,1241,17,73,618,124,62,18,822
741975_SouthernHighlandsNewSouthWales.txt,582,8,72,229,71,46,20,366
741_Antarctica.txt,4725,71,66,1858,567,399,139,2963
7422757_Beneficiarytrust.txt,695,19,36,219,90,59,30,398
7422773_IranianEtiquette.txt,858,11,78,259,149,79,58,545
742286_UlicQeldroma.txt,3100,35,88,1091,520,142,101,1854
742353_ElephantGun.txt,837,10,83,273,108,80,34,495
742356_GreaterSwissMountainDog.txt,744,10,74,247,100,65,30,442
7424684_AmiyaKumarBagchi.txt,930,20,46,493,54,43,4,594
7424788_Stegmutt.txt,655,7,93,220,93,48,41,402
7426297_RuleInHoweVEarlOfDartmouth.txt,1074,21,51,329,161,70,38,598
7427686_NorthEastSticksTogether.txt,1135,28,40,783,49,32,7,871
742964_ListOfReligiousPopulations.txt,1005,42,23,468,36,50,24,578
743006_MasahikoKimura.txt,774,17,45,297,103,61,35,496
743007_ThermalPrinter.txt,634,15,42,245,85,80,30,440
743067_Scrip.txt,859,13,66,320,138,44,49,551
7432066_StarWarsTradingCards.txt,969,9,107,522,38,30,9,599
743449_5566band.txt,1426,26,54,527,201,113,65,906
7437368_SwedishgeatishWars.txt,755,15,50,288,112,54,24,478
7439782_TamilEelam.txt,563,8,70,252,55,30,17,354
744052_IrishConfederateWars.txt,3131,40,78,1191,434,175,90,1890
7441108_JohannRattenhuber.txt,590,10,59,193,91,28,18,330
7441112_CanadianVickersVedette.txt,681,10,68,284,77,59,12,432
7441117_LauraSpenceAffair.txt,912,12,76,286,158,58,42,544
7449380_EwingVCalifornia.txt,1512,19,79,546,202,106,60,914
745142_ArchbishopMolloyHighSchool.txt,1885,29,65,811,209,130,45,1195
745162_Eusbio.txt,991,19,52,420,87,78,17,602
745163_DualPower.txt,1827,15,121,622,224,161,60,1067
745184_FastOfGedalia.txt,643,11,58,220,104,28,11,363
7452748_TimelineOfCarbonNanotubes.txt,713,16,44,317,96,63,14,490
7454291_GraceLutheranCollege.txt,1042,20,52,378,156,81,36,651
7455693_BillyWardAndTheDominoes.txt,681,8,85,249,97,45,22,413
7457512_CosmicEntitiesmarvelComics.txt,1539,6,256,479,222,140,72,913
7457617_PapalMajordomo.txt,857,5,171,284,99,55,33,471
7458498_SixtyMinuteMan.txt,686,11,62,235,111,51,29,426
7458596_PrivateCompanyLimitedByShares.txt,1590,44,36,516,217,112,48,893
7459456_SeitzCanyon.txt,585,9,65,227,58,43,24,352
7459555_LloydChadburn.txt,641,13,49,252,77,28,23,380
7461076_TheHoneydogs.txt,830,11,75,391,75,70,16,552
746231_NasaBudget.txt,1556,27,57,653,147,85,26,911
7462409_MotrMilitia.txt,1970,20,98,659,274,140,115,1188
746240_SauvieIsland.txt,700,6,116,305,76,55,9,445
7462415_OurMims.txt,769,19,40,291,114,34,32,471
746256_AlfredElyBeach.txt,927,20,46,369,132,59,23,583
746260_Mappy.txt,717,11,65,282,105,28,16,431
7466264_BattleForHendersonField.txt,586,13,45,215,74,42,15,346
746627_TalBrooke.txt,1148,15,76,558,98,54,23,733
746636_HmsExpressh61.txt,936,18,52,349,123,42,9,523
7468179_QuotationMarkNonenglishUsage.txt,1668,63,26,563,253,161,80,1057
7469125_BukovinaGermans.txt,904,22,41,311,77,95,20,503
7469138_Jayke.txt,568,17,33,207,85,41,30,363
7469160_ListOfGamesUsingPhysicsEngines.txt,584,11,53,408,22,20,7,457
747324_UsWest.txt,1394,22,63,573,190,100,54,917
747370_BuridansAss.txt,640,7,91,181,102,56,41,380
7476822_AlchemicalStudies.txt,759,8,94,238,114,67,28,447
747726_AlmanachDeGotha.txt,1430,17,84,477,190,144,66,877
747731_GeorgeRussell.txt,1387,21,66,572,166,94,23,855
7477506_DiwalitheOfficeEpisode.txt,849,14,60,304,145,41,28,518
7479425_AnnaDodge.txt,935,6,155,500,9,4,0,513
7480388_YehezkelKaufmann.txt,851,13,65,288,99,67,38,492
7481667_HistoryOfIndianapolis.txt,1891,14,135,695,225,148,68,1136
7482599_WhatIsManking.txt,1097,6,182,275,195,65,47,582
7483269_BobCatley.txt,2239,40,55,907,271,147,101,1426
748409_DrQuinnMedicineWoman.txt,3149,26,121,1179,479,215,130,2003
7485183_ListOfPeopleByNameMoramorq.txt,936,15,62,657,4,70,4,735
748520_SeanYoung.txt,674,10,67,285,84,25,20,414
748818_2ndRingRoadbeijing.txt,1171,42,27,469,153,104,62,788
748820_AlqaedaInIraq.txt,4796,35,137,2038,616,216,68,2938
748861_KermitRoosevelt.txt,2241,31,72,863,299,129,64,1355
748866_ThelmaLouise.txt,1172,22,53,426,184,52,36,698
7489318_CoilLive.txt,681,11,61,291,86,44,30,451
7491241_KirraPhocis.txt,776,12,64,280,122,44,25,471
7495097_RockefellerBrothersFund.txt,1856,24,77,946,140,97,28,1211
7495207_LynneKosky.txt,707,13,54,274,75,38,11,398
7498062_TheLambrettas.txt,731,17,43,278,87,58,25,448
749886_BarrenRealmsElite.txt,1305,29,45,435,195,115,69,814
7499962_ZxSpectrumSoftware.txt,2033,43,47,787,280,151,75,1293
7499977_Rockerbogie.txt,612,10,61,195,85,51,17,348
7500982_VirtualOrchestra.txt,1897,18,105,621,236,226,71,1154
7501612_JulianAndBasilissa.txt,581,10,58,191,76,40,22,329
7502000_ArisFc.txt,1359,28,48,562,154,102,32,850
7503610_CanadaAtThe2004SummerParalympics.txt,743,22,33,496,0,4,1,501
7503909_BetaWavelet.txt,557,42,13,221,70,42,16,349
7505510_PatriciaSun.txt,2002,60,33,710,275,125,48,1158
750603_JudithSheindlin.txt,934,38,24,362,139,46,34,581
750609_NorthShoretvSeries.txt,1041,19,54,419,151,74,22,666
750694_StuartLittle2.txt,791,6,131,289,125,34,34,482
750700_DancePad.txt,1115,14,79,412,164,105,45,726
750710_KarlaHomolka.txt,4379,64,68,1551,689,217,122,2579
7508621_ThePaintedVeil2006Film.txt,578,11,52,237,77,27,19,360
7509365_PostperfusionSyndrome.txt,804,11,73,340,96,93,22,551
7509583_NationalParkServiceRustic.txt,2330,32,72,996,281,183,59,1519
750974_GulstanRopert.txt,1528,9,169,595,175,61,30,861
750986_Behaviouralbum.txt,1185,17,69,421,158,76,54,709
751045_EricSchlosser.txt,651,16,40,318,68,26,10,422
751115_TopographicProminence.txt,2247,40,56,797,273,213,65,1348
7511213_SimeleMassacre.txt,1220,14,87,458,192,72,30,752
7512586_WardrobeSupervisor.txt,623,6,103,218,84,47,24,373
7515426_ChristineNiederbergerBetton.txt,672,8,84,296,59,44,16,415
7515451_RaleighInternationalHongKong.txt,2658,70,37,1046,371,176,62,1655
7516411_NewYorkComptrollerElection2006.txt,987,19,51,453,129,46,19,647
751777_FrancisTurbine.txt,554,19,29,223,80,45,19,367
75178_WhoseLineIsItAnyway.txt,4025,59,68,1498,518,305,178,2499
751799_UnitedStatesDistrictCourtForTheEasternDistrictOfVirginia.txt,645,14,46,408,46,20,7,481
7518888_BrownPeople.txt,1558,23,67,510,206,152,61,929
75193_NaturalSemanticMetalanguage.txt,786,16,49,361,78,61,21,521
75204_AlicePrin.txt,658,14,47,264,87,39,19,409
7520918_BonnieTylerDiscography.txt,2391,46,51,1386,18,25,9,1438
75210_BottomtvSeries.txt,1836,26,70,659,282,101,99,1141
7521201_Compounding.txt,684,13,52,260,112,55,21,448
75215_ElectricChair.txt,2407,33,72,871,372,186,70,1499
7522152_MalontheLegendOfZeldaSeries.txt,2145,31,69,740,309,108,96,1253
7524082_AlvinAileyAmericanDanceTheater.txt,679,11,61,301,74,30,19,424
7525049_TheSoloCollection.txt,1407,19,74,1004,18,31,10,1063
7525154_KirbysMill.txt,712,12,59,243,99,56,27,425
7526009_ManuelLQuezonUniversity.txt,750,28,26,511,23,20,4,558
752793_ListOfVictoriaCrossRecipientsByNameM.txt,921,3,307,740,2,8,5,755
7528028_SecondLifeIssuesAndCriticisms.txt,1165,17,68,417,208,87,52,764
7528033_EcclesiasticalRing.txt,1637,11,148,506,237,140,64,947
752863_UnitedStatesCourtOfAppealsForTheArmedForces.txt,839,13,64,332,82,74,10,498
752871_MacromediaHomesite.txt,952,11,86,405,136,60,28,629
752873_BasilicaDeiSantiGiovanniEPaolovenice.txt,612,13,47,332,40,36,5,413
752879_TsarskoyeSelo.txt,628,11,57,268,69,56,12,405
752889_VickiMorgan.txt,629,8,78,263,90,52,16,421
7528973_ListOfAmarChitraKathaComics.txt,1926,24,80,1008,18,20,3,1049
7529851_TheOneWithRachelsOtherSister.txt,773,20,38,281,120,30,23,454
753225_UsesOfTrigonometry.txt,1395,27,51,458,190,121,58,827
753230_AlternatingTuringMachine.txt,1071,28,38,362,174,82,28,646
7532822_Evoke.txt,586,10,58,184,98,44,27,353
7533456_ZichronMenachem.txt,608,10,60,284,65,46,11,406
7533779_Glusburn.txt,652,14,46,227,103,32,26,388
7533780_LaborNotes.txt,955,21,45,388,112,74,24,598
7534718_LenCasanova.txt,1875,16,117,786,218,96,41,1141
7534761_EnsoQuartet.txt,663,9,73,342,65,31,11,449
7535321_NationalInstituteOfScienceEducationAndResearchBhubaneswar.txt,589,12,49,245,75,29,22,371
7536259_SilkySullivan.txt,5461,53,103,1793,817,306,276,3192
7536754_MirzaHadiRuswa.txt,791,6,131,290,110,50,27,477
753887_ClayAllison.txt,1399,24,58,472,230,59,54,815
7539221_ListOfCanadianPlantsByFamilyF.txt,929,23,40,758,96,43,1,898
753953_Caratpurity.txt,588,14,42,221,56,45,14,336
753961_AllenFieldhouse.txt,708,15,47,302,85,30,19,436
753973_KenJennings.txt,5056,75,67,1792,720,346,165,3023
7542075_WestlakeChaparrals.txt,1683,145,11,713,113,50,35,911
7543037_ThePhoenixPress.txt,648,13,49,250,82,34,17,383
754364_AtlantafultonCountyStadium.txt,612,6,102,215,75,41,19,350
7547832_HurricaneKlaus1984.txt,946,14,67,372,116,74,23,585
7549442_MichaelHPayne.txt,762,9,84,415,38,58,7,518
754970_GreatOrme.txt,1417,31,45,562,176,83,53,874
755067_DniRestorationCouncil.txt,628,9,69,221,97,42,17,377
755073_MadeleineVionnet.txt,783,8,97,287,102,71,17,477
7552315_TheHiddenGem.txt,712,20,35,286,111,30,17,444
7553275_DevilMayCrySoundtrack.txt,493,1,493,242,2,7,0,251
7553279_Paperbackswap.txt,548,7,78,266,52,30,13,361
755454_TerminalTower.txt,594,16,37,265,69,28,4,366
755455_DrBunsenHoneydew.txt,590,12,49,214,98,40,23,375
755516_RepublicanConferenceOfTheUnitedStatesSenate.txt,1456,18,80,624,192,69,34,919
7557115_RussellHayden.txt,877,7,125,476,28,11,5,520
7558077_PeopleWhoUsePeople.txt,834,7,119,274,147,40,48,509
7559048_Siculoarabic.txt,837,29,28,312,102,59,19,492
7560100_ListOfRahxephonMedia.txt,1531,38,40,626,167,106,41,940
756058_HansMagnusEnzensberger.txt,631,8,78,316,45,27,14,402
756067_MeridianBroadcasting.txt,779,15,51,347,92,49,23,511
7561027_RentonFc.txt,1047,20,52,356,141,74,38,609
7561053_ChiropracticSchools.txt,1102,25,44,494,113,107,22,736
7565765_ArchbishopricOfBurgos.txt,641,4,160,216,76,57,25,374
7565836_SocietyForProtectionOfTheHarbour.txt,2822,50,56,1196,287,151,41,1675
7565838_Alcalica.txt,874,12,72,369,102,102,9,582
7565859_Chushiel.txt,754,9,83,342,93,31,12,478
756611_ChaimJosephDavidAzulai.txt,1487,21,70,495,194,101,63,853
7566194_TheDiscoverers.txt,1133,30,37,416,141,105,31,693
7567222_Mizrah.txt,895,11,81,314,112,48,31,505
7568713_TheRangeHomeAndLeisure.txt,527,13,40,200,66,32,20,318
7569676_NicoleKing.txt,573,10,57,226,70,51,15,362
7570666_Haystacksmonet.txt,1187,18,65,404,156,94,45,699
7570667_FsAln772.txt,3159,45,70,973,478,298,109,1858
757134_PresidentOfHarvardUniversity.txt,698,10,69,290,82,51,21,444
757143_GammaRayband.txt,1316,32,41,574,135,86,40,835
757205_Deathdiscworld.txt,2759,33,83,835,439,205,161,1640
757212_MemorialStadiumbaltimore.txt,1365,26,52,546,160,108,57,871
757214_RobHubbard.txt,971,11,88,521,67,46,8,642
7574878_ListOfRegisteredHistoricPlacesInMarionCountyOregon.txt,488,2,244,452,0,7,2,461
7575460_ErnestEverettJust.txt,1131,19,59,436,145,76,42,699
757630_NotAvailable.txt,580,11,52,194,82,41,38,355
7576424_WebOperatingSystem.txt,766,13,58,311,84,51,24,470
7577384_BeatriceVan.txt,536,5,107,248,7,4,3,262
7578436_WilliamBartonheraldist.txt,822,21,39,310,100,32,21,463
7579365_BenJerrysFlavors.txt,1010,13,77,703,28,37,6,774
7580253_Gravewalkaz.txt,649,7,92,196,102,55,41,394
7580257_ALBeattie.txt,671,7,95,280,74,47,11,412
7580342_PoliticomediaComplex.txt,1130,25,45,435,116,101,42,694
7581293_CampaignAgainstSanctionsAndMilitaryInterventionInIran.txt,845,13,65,344,95,69,24,532
7582234_MihailAhmanov.txt,2237,23,97,765,270,172,89,1296
7582561_OppositionToWarAgainstIran.txt,1148,17,67,509,120,92,28,749
758288_Valhallacomic.txt,945,24,39,320,143,65,38,566
7583254_QueenOfTheBlackPuddlecourageTheCowardlyDog.txt,726,6,121,215,121,39,20,395
758407_HaleakalaNationalPark.txt,595,14,42,227,67,48,13,355
7584213_HistoryOfSanBernardinoCalifornia.txt,4420,78,56,1817,568,244,99,2728
7585557_JuanCerezoDeSalamanca.txt,913,17,53,300,149,45,24,518
7586119_SeawayTrail.txt,2365,39,60,1184,179,102,93,1558
7586514_MichaelThonet.txt,592,10,59,288,46,30,9,373
758725_AlonsoDeOjeda.txt,661,10,66,211,90,39,24,364
758763_BrainFreeze.txt,1316,8,164,508,180,79,42,809
7588035_LwwVoivodeship.txt,782,44,17,318,70,64,24,476
7588997_SacredGrove.txt,885,14,63,278,134,31,29,472
7589401_2006CaliforniaGoldenBearsFootballTeam.txt,5833,193,30,2286,690,351,165,3492
7589409_SylvesterTheJester.txt,655,14,46,339,60,33,10,442
7592217_Jaffna.txt,2886,68,42,1183,320,215,69,1787
759372_Dodworth.txt,624,21,29,294,63,48,21,426
759376_1993AtlanticHurricaneSeason.txt,1049,32,32,345,155,93,37,630
759387_CitybuildingGame.txt,708,21,33,318,84,69,24,495
759422_DataModeling.txt,1579,25,63,589,227,143,61,1020
759424_ChinghizAitmatov.txt,799,18,44,307,78,56,15,456
7595807_PeoriaStateHospital.txt,832,15,55,293,120,59,17,489
7596760_OmerHussain.txt,540,7,77,225,74,26,14,339
7597739_PrincipalityOfRuthenia.txt,702,10,70,325,66,42,8,441
7597973_Abl199798.txt,1444,49,29,441,2,138,1,582
759854_DialhomeDevice.txt,1528,22,69,492,260,111,71,934
759856_Norncreatures.txt,694,11,63,207,99,58,45,409
7600598_KaniskaCanace.txt,641,10,64,222,72,89,34,417
7601579_ElizabethOakesprinceSmith.txt,1780,19,93,681,198,112,50,1041
7603419_HistoricalUsCensusTotalsForCaledoniaCountyVermont.txt,1321,83,15,552,109,38,28,727
760513_JoeMercer.txt,680,9,75,231,95,37,11,374
760517_1959AtlanticHurricaneSeason.txt,1122,33,34,362,133,119,32,646
760565_SolarChimney.txt,1569,27,58,642,204,148,41,1035
760573_TerryVenables.txt,1664,31,53,595,216,108,40,959
7608219_Castawaybook.txt,752,9,83,219,141,52,40,452
7612061_TremoloHarmonica.txt,1103,12,91,267,136,94,56,553
7612150_Sparksbandsandbox.txt,2144,30,71,799,277,178,70,1324
7614057_ListOfTorchwoodItems.txt,3854,62,62,1390,569,237,124,2320
761554_OnlineDisputeResolution.txt,823,14,58,409,77,46,21,553
761557_AlfredoOvandoCanda.txt,1157,9,128,397,155,103,46,701
761570_KarlWendlinger.txt,805,15,53,298,95,60,25,478
761605_MahamaneOusmane.txt,567,9,63,188,73,44,19,324
761609_TorontoLynx.txt,668,23,29,307,47,35,14,403
761661_Lechuck.txt,5132,44,116,1577,874,292,240,2983
7618956_BioTyranno.txt,673,12,56,225,94,68,30,417
7619908_DrDerekShepherd.txt,1744,21,83,541,299,109,85,1034
7619909_JuanPantojaDeLaCruz.txt,822,14,58,340,88,48,22,498
762044_ListOfPeopleByNameMosmoz.txt,709,6,118,516,2,43,2,563
762105_Kinvara.txt,655,7,93,245,78,40,18,381
7624742_GotthardDeutsch.txt,1141,8,142,501,110,68,26,705
7625072_FenderVibratone.txt,1059,20,52,371,152,77,38,638
7626574_YeogangHighSchool.txt,683,23,29,314,62,60,8,444
76266_SoftwarePatent.txt,3809,76,50,1405,580,304,140,2429
76267_Shatranj.txt,1447,24,60,507,196,112,61,876
762694_NightRanger.txt,1055,15,70,451,119,68,35,673
762704_TimeToMarket.txt,842,7,120,303,137,63,48,551
76272_GlamisCastle.txt,791,20,39,261,127,46,26,460
762752_LarryObrien.txt,1001,24,41,384,111,84,17,596
7628534_AcAcoustics.txt,558,15,37,247,62,45,15,369
76286_DisneylandResortParis.txt,2052,36,57,835,276,122,41,1274
76293_TemperanceMovement.txt,1847,26,71,755,230,131,50,1166
76296_TypesOfSwords.txt,1904,14,136,929,138,93,38,1198
76297_RedRiverfilm.txt,825,14,58,315,112,28,32,487
7629898_CentralMindanaoUniversity.txt,1994,129,15,945,186,136,38,1305
7629923_Alcatellucent.txt,848,23,36,360,99,60,16,535
76301_RideTheHighCountry.txt,603,12,50,223,93,34,19,369
7630466_1987MiamiHurricanesFootballTeam.txt,1815,28,64,652,258,112,52,1074
7630498_ChordNotation.txt,2614,69,37,911,318,251,138,1618
7630504_WalterBerg.txt,986,12,82,431,97,73,15,616
76310_RomanHoliday.txt,1517,26,58,636,215,65,46,962
763125_Kronstadt.txt,929,19,48,339,112,75,34,560
76312_Bruges.txt,1789,43,41,725,211,147,61,1144
763130_Kqed.txt,1249,16,78,546,138,96,30,810
763138_SonicWeaponry.txt,1148,15,76,440,182,99,33,754
76313_SafetyLast.txt,998,12,83,317,153,63,39,572
7632397_JohnUrry.txt,1109,52,21,571,73,64,15,723
7633368_SevenMinutesToMidnightheroes.txt,1256,11,114,413,230,51,53,747
7635271_CorridorQ.txt,869,14,62,354,67,28,14,463
7636243_HartPerry.txt,1883,54,34,1059,126,108,18,1311
763753_TheSevenYearItch.txt,838,6,139,286,140,40,33,499
763755_LimKitSiang.txt,885,13,68,384,72,41,14,511
763789_ForeignBranding.txt,1211,17,71,428,162,146,63,799
763841_GaiafoundationUniverse.txt,769,16,48,258,114,73,36,481
7638_Consilience.txt,1969,16,123,610,280,186,100,1176
7642108_GreenBin.txt,632,14,45,240,110,44,21,415
7642112_Morys.txt,951,41,23,344,150,64,32,590
7642113_JolietArmyAmmunitionPlant.txt,899,11,81,413,112,46,12,583
7644948_UtopiaNorthernTerritory.txt,1068,15,71,374,134,102,49,659
7645296_ListOfSierraLeonerelatedTopics.txt,741,19,39,534,20,21,9,584
7645962_LochmabenStone.txt,1506,25,60,531,186,75,49,841
7647210_MovingToBlackwater.txt,624,5,124,209,89,69,22,389
7647873_SpongeePolo.txt,636,8,79,204,104,25,27,360
7647_Counter.txt,925,19,48,310,117,92,35,554
764848_AutoregressiveMovingAverageModel.txt,1150,78,14,448,161,78,38,725
764849_LilyPons.txt,650,15,43,279,62,38,17,396
764856_TalesToAstonish.txt,828,16,51,329,86,70,23,508
764857_RosaPonselle.txt,3037,36,84,1170,327,232,110,1839
764882_TarimBasin.txt,644,11,58,305,46,39,10,400
764884_FortClatsop.txt,643,9,71,230,91,36,25,382
764885_TickTickBoom.txt,1809,42,43,683,258,90,55,1086
764925_FranzFreiherrVonDerTrenck.txt,593,7,84,177,92,39,13,321
764927_TurfanDepression.txt,911,9,101,367,84,62,22,535
764950_TheFallOfHyperion.txt,1381,16,86,474,204,81,52,811
7650726_RobertMunrod1633.txt,1787,22,81,586,255,106,84,1031
7650773_NorthCarolinaAquariumAtFortFisher.txt,746,16,46,342,80,63,7,492
7657891_KomatsuAirport.txt,775,33,23,424,69,44,8,545
766007_HaroldRoss.txt,670,12,55,286,72,38,7,403
766019_SaddlebackChurch.txt,570,15,38,281,61,26,12,380
7662281_Aveyond.txt,4925,47,104,1590,772,294,208,2864
7662380_OpMaurice.txt,1308,32,40,486,182,34,44,746
7667793_UssLenaweeapa195.txt,974,13,74,389,114,54,13,570
767082_HistoricalThinking.txt,654,10,65,290,82,65,12,449
767106_GreaterMetropolitanAreaOfPorto.txt,761,17,44,343,82,52,11,488
767123_TheSingularityIsNear.txt,691,7,98,254,69,61,21,405
767125_ListOfEnglishFootballers.txt,1000,27,37,985,3,1,2,991
7673642_FashionClub.txt,1852,47,39,648,264,163,87,1162
7674607_InterchangeFee.txt,720,14,51,300,91,41,18,450
767475_BlackGospel.txt,1200,14,85,492,132,130,48,802
767481_TalesOfSuspense.txt,710,12,59,336,59,42,15,452
7676521_HikingEquipment.txt,1383,10,138,471,174,107,98,850
7677515_ElaminQdrae.txt,847,10,84,340,113,50,15,518
7679418_FedeGalizia.txt,940,14,67,296,153,73,62,584
7681896_GerardusJohannesPetrusJosephusBolland.txt,574,12,47,244,61,44,17,366
768193_GothicLolita.txt,2081,25,83,751,260,205,134,1350
768208_DaveHenderson.txt,911,13,70,313,114,42,25,494
7683283_ShiaViewOfFatimah.txt,1494,30,49,480,250,81,60,871
7685271_GhostStorystraubNovel.txt,1235,12,102,371,221,70,45,707
768545_HermannBalck.txt,691,10,69,252,81,39,16,388
768566_ListOfImportantPublicationsInPhysics.txt,2872,141,20,1412,218,230,63,1923
7687152_StMarysCatholicSecondaryhamilton.txt,756,16,47,324,97,41,21,483
7688114_VictorBussie.txt,891,28,31,345,120,64,40,569
7690572_Emersons.txt,737,30,24,272,130,38,17,457
7691988_AnthropologicalCriminology.txt,811,21,38,317,99,64,34,514
7691989_RoldnberenguArqts.txt,1118,10,111,619,15,86,1,721
769207_CorfeMullen.txt,2248,31,72,900,243,144,79,1366
769295_PridiPhanomyong.txt,1622,29,55,583,223,115,52,973
7693897_JustJordan.txt,795,14,56,269,136,42,35,482
7694860_SabacRed.txt,666,13,51,288,92,37,16,433
7695456_PartitioningOfTheOttomanEmpire.txt,2831,47,60,1106,343,189,55,1693
7695857_CompleteStreets.txt,590,23,25,285,67,37,13,402
7696823_Riftwhoniverse.txt,1303,16,81,477,192,62,49,780
7700_Commodore1571.txt,961,16,60,284,124,85,44,537
770303_EugeneAram.txt,644,9,71,191,111,29,28,359
7704526_LedgewoodCircle.txt,806,13,62,270,113,57,27,467
7706_CartesianCoordinateSystem.txt,1682,35,48,600,232,149,53,1034
7707447_ThemeTimeRadioHour.txt,5923,70,84,4077,149,65,54,4345
7708972_ListOfJamesBondHenchmenInDieAnotherDay.txt,817,23,35,340,133,31,21,525
7709359_NakamuraShinichiro.txt,961,4,240,515,48,18,3,584
7709378_PosterityOfHeaven.txt,930,10,93,307,134,59,22,522
7710_CaliforniaDepartmentOfTransportation.txt,670,15,44,262,85,54,21,422
7712231_AlfredTaylorHoward.txt,1366,22,62,543,165,78,54,840
7714188_DorothyBrown.txt,750,13,57,339,70,39,8,456
771477_SubwayToSally.txt,1451,17,85,524,203,120,60,907
7715205_2005AzoresSubtropicalStorm.txt,638,11,58,177,107,72,35,391
7715707_Ilag.txt,970,19,51,343,148,70,29,590
7717624_UnicornJabu.txt,902,21,42,339,126,48,29,542
7717649_AllianceWrestlingFederation.txt,889,13,68,310,129,57,39,535
771817_AlphabeticalListOfSongsRecordedByFrankSinatra.txt,5200,10,520,3103,170,14,35,3322
7719059_MerryMount.txt,4367,37,118,1499,649,258,161,2567
7720584_UnionProject.txt,1059,18,58,434,135,76,22,667
7721577_UniversityOfTheEastLibrary.txt,1428,54,26,615,159,112,29,915
7723485_Tawjihi.txt,881,6,146,314,112,77,25,528
7723878_Khamti.txt,656,17,38,240,102,44,19,405
7723879_MikePhilbin.txt,581,11,52,325,39,42,6,412
772474_BlakelyVWashington.txt,2070,18,115,690,299,143,99,1231
7724844_InterpersonalChemistry.txt,3809,46,82,1371,463,375,128,2337
7725683_Antiproduct.txt,751,17,44,407,59,34,25,525
7725692_RyuunosukeFujinami.txt,608,11,55,182,97,30,29,338
772572_Cox2Inhibitor.txt,2575,29,88,925,296,276,110,1607
772580_UsBankArena.txt,663,6,110,244,93,54,24,415
772623_FriedrichLudwigJahn.txt,631,14,45,235,70,34,8,347
772624_Eiken.txt,1249,27,46,404,201,78,68,751
772635_UnderAKillingMoon.txt,880,13,67,426,98,46,26,596
7726672_JohnPrincetotnes.txt,625,13,48,230,97,35,18,380
7727636_CityOfColumbus.txt,596,2,298,199,95,27,17,338
7729285_DrHell.txt,610,12,50,232,84,36,31,383
7729640_KimWonyong.txt,704,16,44,307,50,59,13,429
7734444_PiLambdaChi.txt,788,17,46,348,102,36,18,504
77344_Kraken.txt,1055,15,70,350,159,103,49,661
77349_Basilisk.txt,1180,22,53,416,167,75,42,700
773546_NoTaxationWithoutRepresentation.txt,1137,16,71,364,196,63,45,668
773618_EvilGenius.txt,1605,26,61,815,122,80,55,1072
7736330_StratfordUniversity.txt,572,11,52,308,67,34,6,415
77363_Oedipus.txt,2118,19,111,754,324,109,70,1257
77366_WinstonCountyAlabama.txt,612,11,55,237,68,23,7,335
77367_MorganCountyAlabama.txt,541,11,49,208,58,24,6,296
7736921_ForeignPolicyOfTheClintonAdministration.txt,5292,53,99,2035,798,315,136,3284
773714_SoJosDosCampos.txt,4404,137,32,1946,476,328,95,2845
773716_ProjectGenesis.txt,1170,18,65,371,207,85,54,717
773735_Sirmium.txt,890,18,49,350,104,72,31,557
77376_UssS1ss105.txt,630,10,63,223,85,31,7,346
77382_LusDeCames.txt,1139,19,59,410,153,70,23,656
773994_Steamband.txt,1129,13,86,532,127,59,25,743
774001_DonaldCrisp.txt,1272,22,57,448,156,95,44,743
7740223_MbcDynamoMoscow.txt,928,14,66,384,90,72,29,575
7740838_AtanBurhagohain.txt,1557,13,119,540,222,79,48,889
7741818_GeorgeAnyona.txt,809,5,161,273,130,50,40,493
7743736_PortugalAtThe1948SummerOlympics.txt,517,26,19,366,11,28,2,407
7745750_WilliamHEmory.txt,683,10,68,322,58,25,10,415
774795_WilliamAllenEgan.txt,977,14,69,364,125,74,27,590
7747976_RocketEngineTestFacility.txt,685,14,48,301,91,49,28,469
774820_ListOfAzerbaijanis.txt,797,9,88,607,6,38,3,654
774824_Mot.txt,645,7,92,216,98,32,18,364
7749805_ListOfClosedRailwayStationsInBritainC.txt,54,1,54,17,17,1,1,36
7749863_ListOfClosedRailwayStationsInBritainHj.txt,1359,4,339,1019,28,14,2,1063
7749913_ListOfClosedRailwayStationsInBritainMo.txt,2121,6,353,1636,27,12,1,1676
7750776_UssRutlandapa192.txt,817,12,68,324,107,30,10,471
775084_EnPointe.txt,810,10,81,258,142,71,48,519
7752703_Gallosiculo.txt,786,7,112,413,56,41,17,527
7753753_LemuriaAndEasterIsland.txt,1591,11,144,531,226,127,59,943
7754291_TheShowWhereDianeComesBack.txt,1048,12,87,331,187,42,59,619
7754668_InfrastructureOfNoviSad.txt,731,15,48,331,79,46,25,481
775811_UsRoute111.txt,875,8,109,348,86,43,39,516
775839_CombatRubberRaidingCraft.txt,823,10,82,294,109,70,22,495
775887_PandolfoPetrucci.txt,570,4,142,197,88,36,20,341
7759118_SaintPetronilla.txt,1211,20,60,453,163,69,40,725
7759505_IslamInSouthKorea.txt,992,17,58,384,124,72,36,616
7760464_ParalympicSports.txt,960,29,33,423,96,96,22,637
7761399_ChadJohnson.txt,943,21,44,363,124,58,18,563
7763045_MaryAnnCotton.txt,1748,30,58,599,304,90,58,1051
7764297_AngelaKnightauthor.txt,626,14,44,234,108,38,20,400
7764300_285South.txt,2352,31,75,781,417,81,85,1364
7765270_SilverRainRadio.txt,788,7,112,380,54,52,9,495
7765366_IndiaOfficeEcords.txt,1886,77,24,784,203,138,52,1177
7767_CircuitParkZandvoort.txt,585,8,73,205,92,36,23,356
7769161_IndonesianArchitecture.txt,2643,47,56,1023,307,363,92,1785
7769862_HollistonColeman.txt,1090,17,64,440,163,72,32,707
7769_Corporatism.txt,2955,40,73,1107,334,318,116,1875
7770818_ListOfStrongChessTournaments.txt,2405,13,185,1377,46,37,14,1474
7772006_WalterAbrahamtownPlanner.txt,1414,23,61,505,213,104,32,854
77726_Asopus.txt,1449,29,49,565,177,58,67,867
77727_Myrmidons.txt,850,19,44,327,104,59,18,508
7773019_Getamped.txt,1090,16,68,322,213,69,43,647
7773975_Cerrigydrudion.txt,599,9,66,207,87,45,21,360
7775517_Interstate75InFlorida.txt,1530,18,85,944,54,35,10,1043
7775913_FrankMoulaert.txt,1257,35,35,681,63,79,7,830
77776_Allfours.txt,804,19,42,252,130,50,35,467
7778411_WintunomlakiTraditionalNarratives.txt,654,24,27,394,26,16,4,440
7778786_AugustusBrandegee.txt,970,13,74,333,130,39,21,523
77787_JuanAntonioSamaranch.txt,641,10,64,229,89,35,18,371
778028_Stormfrontwebsite.txt,1445,19,76,577,188,117,39,921
778071_MargaretFell.txt,644,10,64,227,80,23,25,355
7781359_QuantumCohomology.txt,953,73,13,332,105,105,25,567
7783293_JohnLafayetteRiker.txt,983,15,65,435,105,42,15,597
7783698_EnergySuperpower.txt,2453,31,79,900,315,270,105,1590
7784675_ListOfMultiplayerVideoGames.txt,886,18,49,555,11,18,3,587
778513_BernardCoard.txt,919,25,36,383,134,30,22,569
7788120_JulianDean.txt,1064,88,12,491,42,64,5,602
7789084_SeasideNaturals.txt,582,12,48,205,85,49,21,360
779078_BattleOfJieqiao.txt,861,9,95,318,134,44,28,524
7791012_YurokTraditionalNarratives.txt,659,27,24,400,24,20,4,448
779111_Xenotransplantation.txt,928,19,48,311,155,109,47,622
7792523_ListOfScientologyRundowns.txt,788,19,41,296,120,62,27,505
7793467_SusquehannaAndNewYorkRailroad.txt,688,14,49,319,91,15,11,436
7798283_HistoryOfTheEpiscopalChurch.txt,2296,35,65,921,246,128,65,1360
7801268_TadStones.txt,592,9,65,231,73,31,12,347
780166_SanitaryNapkin.txt,1284,22,58,396,214,154,69,833
780170_OhioStadium.txt,1513,19,79,539,223,88,46,896
780174_NoeleGordon.txt,1311,18,72,420,206,80,72,778
780180_FelixDraeseke.txt,1275,11,115,539,104,80,28,751
780209_Midleton.txt,907,17,53,387,106,51,20,564
7802241_YourOwnThing.txt,646,18,35,288,80,37,21,426
780630_ShadowOfPhobosOnMars.txt,1038,22,47,358,122,70,38,588
780631_JohannesEwald.txt,597,9,66,200,75,61,24,360
780720_JJamesExon.txt,715,13,55,259,77,46,8,390
7807416_JewishMotorcyclistsAlliance.txt,705,11,64,313,71,28,14,426
781266_1972AtlanticHurricaneSeason.txt,913,24,38,300,121,101,31,553
781339_2004AfcAsianCup.txt,588,52,11,290,52,52,11,405
781345_AntoniaPantoja.txt,1208,25,48,615,81,60,23,779
7815752_HaveANiceDayTour.txt,1255,22,57,687,55,36,17,795
7816625_PackagemergeAlgorithm.txt,680,7,97,233,105,68,23,429
7816713_MexicanJews.txt,846,14,60,309,122,68,29,528
7818540_ListOfFilmsNo.txt,2182,12,181,1150,4,37,4,1195
7818561_ListOfFilmsQr.txt,1896,11,172,998,3,17,1,1019
7819887_TheApprenticetheBatman.txt,650,17,38,251,93,36,27,407
7819894_GeneralArdias.txt,631,12,52,235,93,33,28,389
7823370_SpacePreservationAct.txt,3263,171,19,1360,278,199,37,1874
7823372_GloriaDeoCoop.txt,589,18,32,229,80,50,17,376
7824410_Phosphoramidite.txt,770,7,110,282,135,68,20,505
7825365_ListOfCulturalReferencesToGrandCentralTerminal.txt,766,20,38,359,77,48,18,502
7826344_PublicSectorKnowledgeManagement.txt,1608,50,32,676,182,133,57,1048
7828269_BogeyMansong.txt,711,11,64,202,119,34,39,394
782875_Loudnessband.txt,927,16,57,337,103,68,27,535
7830203_HeavyGauge.txt,625,12,52,346,32,28,13,419
7830239_HannesTrautloft.txt,848,13,65,301,117,49,18,485
7831162_JonathanAndTammy.txt,10512,44,238,2884,2283,402,526,6095
7834089_JadeEstebanEstrada.txt,578,28,20,300,29,31,5,365
7839193_AldoBurrows.txt,607,9,67,217,105,20,28,370
7839875_IsisInModernCulture.txt,990,10,99,390,115,78,25,608
7840840_Govbenefitsgov.txt,705,9,78,369,79,34,9,491
7841111_ClanMacleodOfLewis.txt,1337,26,51,489,173,61,46,769
78427_CarAudio.txt,1448,22,65,568,212,118,45,943
78428_ConferenceUsa.txt,671,23,29,353,69,25,18,465
78436_PhilipIOfFrance.txt,713,10,71,223,111,36,33,403
78438_PhilipIiiOfFrance.txt,708,10,70,274,79,22,17,392
78441_GreekDeitiesAndTheirRomanAndEtruscanCounterparts.txt,445,75,5,300,27,24,5,356
78446_DopplerRadar.txt,776,13,59,297,115,70,27,509
78455_PacificTenConference.txt,1353,50,27,540,110,80,31,761
784618_HasdaiCrescas.txt,633,10,63,237,71,43,12,363
784628_Eyelid.txt,626,15,41,194,96,72,29,391
7846980_FictionalAircraftInDaleBrownNovels.txt,1264,20,63,446,188,133,51,818
7847580_BuckyOneill.txt,1283,28,45,490,185,42,46,763
78481_Evapotranspiration.txt,966,19,50,362,135,89,37,623
78496_NaturalArch.txt,607,16,37,279,72,42,19,412
78497_JeffNoon.txt,1002,16,62,413,100,61,29,603
78504_SalamisCyprus.txt,1664,24,69,593,217,114,42,966
7851786_ZoharZisapel.txt,1456,18,80,622,157,88,31,898
78518_Chihuahuadog.txt,1267,26,48,461,171,123,71,826
7852367_PlayItByEarProductions.txt,888,13,68,376,108,40,15,539
78540_LocalExchangeTradingSystems.txt,1742,33,52,699,245,131,54,1129
78551_TautlineHitch.txt,928,18,51,309,131,61,48,549
7858158_Jagdgeschwader26.txt,2069,25,82,750,250,123,53,1176
7859073_AndalusianSchoolOfPublicHealth.txt,615,15,41,252,75,38,14,379
7860049_IsnaElementarySchool.txt,570,5,114,211,64,48,34,357
7861003_LeonMax.txt,591,14,42,256,73,24,12,365
7861093_PennsylvaniaGeneralAssemblyElection2006.txt,2537,13,195,1691,63,59,1,1814
7866768_BlackberryPearl.txt,706,13,54,280,88,60,26,454
7867155_Interleukin17.txt,1120,11,101,414,152,130,37,733
786716_DicksonExperimentalSoundFilm.txt,1317,9,146,565,156,65,41,827
786790_ListOfRealPeopleAppearingInFictionalContext.txt,5238,377,13,4013,108,111,31,4263
7868191_JawdatSaid.txt,1605,30,53,521,220,84,49,874
7870124_TheLionInWinter1968Film.txt,758,10,75,414,51,36,10,511
7871592_MediaproPictures.txt,1376,24,57,634,119,76,20,849
7871644_LaberintoDeFortuna.txt,1613,13,124,547,228,137,75,987
7874532_LandesForest.txt,703,11,63,222,93,77,28,420
7876468_ListOfSchoolDistrictsInArizona.txt,1142,15,76,929,1,11,0,941
787785_GushKatif.txt,1923,40,48,740,226,145,51,1162
787807_SocialistPartyNewPsi.txt,1114,20,55,409,147,90,37,683
787857_UnionOfChristianAndCentreDemocrats.txt,1252,17,73,471,130,122,35,758
7878812_ListOfJamesBondAlliesInGoldeneye.txt,902,25,36,380,129,45,39,593
787898_Drusilla.txt,764,13,58,256,111,44,33,444
78805_Neustria.txt,1223,20,61,459,136,59,30,684
7881297_5thSignalCommandunitedStates.txt,1385,22,62,622,142,121,15,900
7881310_MarcusFenix.txt,1438,19,75,542,206,61,48,857
78815_Suda.txt,672,11,61,248,75,55,27,405
7881699_DwightdeweyRiley.txt,768,9,85,256,128,34,33,451
788240_FrankStanton.txt,1154,18,64,436,158,61,32,687
788346_GeneralElectricGenx.txt,886,19,46,326,111,70,29,536
78881_Panmythology.txt,1603,26,61,597,210,88,48,943
78882_Chimpanzee.txt,2110,26,81,720,311,196,108,1335
788884_Longleat.txt,1059,16,66,476,127,62,22,687
788950_VilhjalmurStefansson.txt,972,13,74,384,104,59,23,570
788988_BoiseRiver.txt,607,9,67,273,47,42,16,378
7890934_AristopharmaLtd.txt,586,10,58,235,78,43,15,371
7892910_VoxPopulijerichoEpisode.txt,569,10,56,203,97,19,11,330
7894222_ListOfBackyardigansEpisodes.txt,2901,185,15,1581,238,109,66,1994
789435_BattlelordsOfThe23rdCentury.txt,556,14,39,262,74,44,10,390
7895743_ListOfCharactersFromThatsSoRaven.txt,947,21,45,338,171,52,50,611
7895748_SilkStreet.txt,728,7,104,348,68,51,7,474
7895775_Othnielosaurus.txt,1204,14,86,404,181,115,53,753
7895776_SpencerOverton.txt,616,13,47,309,69,14,5,397
7895780_ValparaisoCrusaders.txt,1033,28,36,444,110,42,18,614
7898132_ListOfCountriesByStyleOfNationalFlags.txt,505,112,4,199,15,42,5,261
790041_InstitutoTecnolgicoAutnomoDeMxico.txt,1098,33,33,544,82,82,19,727
7901548_CantesLibres.txt,869,15,57,277,135,80,53,545
7903504_HighbridgeSkirmish.txt,605,7,86,195,104,16,21,336
7906400_ListOfVideoGameConsoleLaunchTitles.txt,1812,86,21,1390,2,44,3,1439
7906754_LeviteTithe.txt,1265,11,115,344,206,109,50,709
7908737_TvbAnniversaryAwards.txt,2124,15,141,1261,18,43,6,1328
7911968_ErnypdBlueEpisode.txt,968,18,53,383,149,27,18,577
791215_HovdProvince.txt,650,14,46,226,76,65,29,396
7912930_EternalReturneliade.txt,2090,29,72,679,263,203,86,1231
7914316_AcharyaRajendrasuri.txt,1186,11,107,553,116,66,28,763
791513_1976AtlanticHurricaneSeason.txt,1246,31,40,413,168,119,32,732
7915275_MakeSomeNoiseAmnestyInternational.txt,819,19,43,339,120,60,26,545
7915326_MonifiethHighSchool.txt,2359,29,81,865,318,164,99,1446
7916285_LangaranCharactersInStargate.txt,2177,56,38,770,363,114,67,1314
7917848_Majesticsbeyblade.txt,910,11,82,280,151,44,40,515
7918205_DynaBladekirby.txt,597,8,74,195,91,37,30,353
7919170_OpenGridForum.txt,617,15,41,274,75,35,16,400
7921089_MikhailAFedonkin.txt,594,11,54,320,30,27,5,382
7921689_NaziArchaeology.txt,2629,30,87,929,374,215,76,1594
792215_LakeSevan.txt,1146,21,54,404,154,78,32,668
792318_NorioWakamoto.txt,839,13,64,671,24,21,4,720
7926490_HipHopEntrepreneurship.txt,1189,19,62,511,163,72,22,768
7927867_MacyAlexanderSharpe.txt,1441,7,205,448,283,60,90,881
793319_ComparisonOfOpenglAndDirect3d.txt,3433,57,60,1197,543,303,180,2223
793409_WallangarraQueensland.txt,642,12,53,259,72,40,13,384
7938449_SeverinoDiGiovanni.txt,870,23,37,318,116,70,26,530
7939415_MariaWolfe.txt,1835,26,70,621,271,155,47,1094
7939466_AirSpace18a.txt,942,11,85,396,126,45,18,585
7941386_MetallicaDemos.txt,1301,34,38,647,148,65,41,901
7941393_ListOfAustralianScatopsidae.txt,618,18,34,497,13,3,2,515
794391_Omnius.txt,641,9,71,218,97,42,23,380
7945189_RosarioBorgio.txt,736,9,81,288,101,56,14,459
7946227_UppsalaUniversityHospital.txt,898,22,40,480,74,55,12,621
7951984_FranzMayerMuseum.txt,1963,51,38,712,238,147,45,1142
7952958_LouisCampagna.txt,600,10,60,272,58,26,14,370
7953929_MonroFamilyphysicians.txt,1318,32,41,549,118,55,27,749
7954422_CornellUniversity.txt,6692,87,76,3056,721,500,122,4399
7954925_LifeWithDerek.txt,997,20,49,420,110,60,30,620
795501_FedericoLuigiConteMenabrea.txt,606,9,67,206,67,31,6,310
795587_JerryOnly.txt,540,10,54,236,44,31,12,323
79572_LemonySnicket.txt,932,16,58,326,136,58,45,565
79575_Orosius.txt,759,16,47,266,112,35,32,445
79581_DanielHandler.txt,1100,35,31,448,143,66,28,685
7958324_HarfordCountyPublicLibrary.txt,914,18,50,490,69,29,7,595
79583_Cimmerians.txt,1868,32,58,721,233,126,55,1135
79584_MineolaNewYork.txt,1537,38,40,617,192,96,27,932
79593_StephinMerritt.txt,723,16,45,298,101,47,25,471
795969_PhiSlammaJamma.txt,987,15,65,423,123,62,27,635
79596_LouisViiiOfFrance.txt,721,13,55,272,88,24,16,400
79598_Priscillian.txt,1456,18,80,459,232,93,48,832
796009_ThePossessednovel.txt,1024,29,35,356,149,87,37,629
79603_GiottoMission.txt,914,26,35,333,129,62,33,557
79605_GiottoDiBondone.txt,530,9,58,197,66,30,20,313
7960665_BenjaminSpeed.txt,1184,26,45,743,46,31,4,824
7962227_DunstanBabyLanguage.txt,868,19,45,317,134,69,21,541
7962592_AkihaTohno.txt,942,9,104,261,154,59,48,522
79626_CentralIntercollegiateAthleticAssociation.txt,645,15,43,366,51,47,11,475
79629_Pontus.txt,955,14,68,380,94,53,37,564
79630_GulfSouthConference.txt,594,17,34,308,65,22,12,407
7963558_JustindesperateHousewives.txt,599,10,59,177,129,16,33,355
7964497_ListOfBabylon5Characters.txt,1294,40,32,513,196,76,26,811
7965500_MountainRescueInEnglandAndWales.txt,909,28,32,598,67,30,9,704
796604_LuciusArtoriusCastus.txt,649,18,36,239,90,41,16,386
7966491_MuhammadQadiri.txt,5045,55,91,2020,639,249,173,3081
796680_ChlorogalumPomeridianum.txt,621,9,69,190,92,53,36,371
7967408_ObservingTheMoon.txt,1095,19,57,354,143,127,65,689
7969333_BellEducationalTrust.txt,774,24,32,322,85,75,23,505
797031_Konjac.txt,564,15,37,191,90,49,35,365
7973164_HallucinationsInTheSane.txt,2213,54,40,679,301,196,103,1279
7973192_RaymondAguerra.txt,697,12,58,258,109,29,23,419
7974145_KentuckyHighSchoolAthleticAssociation.txt,705,11,64,265,89,59,23,436
7974163_Coreanatomy.txt,1050,26,40,344,147,79,46,616
7974829_MapsOfTheUnitedStates.txt,684,32,21,362,54,60,12,488
7975714_LawrenceGordonsaw.txt,768,12,64,218,149,29,33,429
797660_EuropeanColoniesInIndia.txt,976,13,75,377,97,97,42,613
797666_FilippoJuvarra.txt,605,12,50,243,50,49,9,351
797668_TonyMillionaire.txt,859,14,61,322,112,62,20,516
797678_EarlOfRichmond.txt,998,23,43,401,98,37,20,556
797682_NashvilleMunicipalAuditorium.txt,1090,13,83,389,136,99,60,684
797684_IntelligenceBureauindia.txt,818,13,62,353,92,55,28,528
797702_Ingushetia.txt,1238,30,41,522,136,86,21,765
797741_TheSagaOfRyzom.txt,1928,29,66,676,290,161,61,1188
797742_TheHertzCorporation.txt,886,20,44,373,113,65,25,576
797758_SophiesWorld.txt,671,12,55,226,94,44,32,396
797775_WilhelmZaisser.txt,720,5,144,260,89,32,20,401
7979556_FadlShaker.txt,793,13,61,269,94,71,27,461
7979914_WhatIfTheyRun.txt,1566,24,65,561,260,62,37,920
7980577_StrawDogsband.txt,643,23,27,285,63,56,16,420
798120_UniversityOfEvansville.txt,1389,31,44,667,146,74,25,912
798122_ScotsGuards1914.txt,3300,30,110,1160,424,236,110,1930
7984766_Wrvc.txt,610,7,87,284,60,37,24,405
7986720_ArmenianResistance19141918.txt,597,13,45,230,69,46,14,359
7986734_NamgyalRinpoche.txt,681,15,45,295,79,26,16,416
7987684_Plutonium.txt,3981,47,84,1396,525,370,193,2484
798835_WakarusaRiver.txt,649,16,40,334,68,38,16,456
7989588_EconomicDiscrimination.txt,1933,57,33,662,277,216,84,1239
799357_JohnSchneidertelevisionActor.txt,1129,20,56,562,70,35,19,686
7994460_NationalAmateurLightHeavyweightChampions.txt,609,2,304,407,3,0,1,411
799935_DuelistKingdom.txt,2154,16,134,933,286,74,89,1382
799952_VideotapeFormatWar.txt,984,15,65,341,139,85,33,598
7999885_MosesCoulee.txt,919,17,54,392,100,69,27,588
8000217_EinarHkonarson.txt,1604,20,80,625,192,124,38,979
8001169_TheJonbenet.txt,843,14,60,362,94,57,15,528
8001178_SundayMourning.txt,1083,22,49,370,174,57,54,655
8002757_HowTheGarcaGirlsLostTheirAccents.txt,1296,21,61,400,186,87,68,741
8003056_SamuelOughton.txt,1228,19,64,425,172,94,49,740
8003057_JeffReinhart.txt,791,9,87,235,160,38,33,466
8004078_FrankMcnamaramusician.txt,777,18,43,377,70,29,10,486
8004690_GalaxiesInFiction.txt,1342,30,44,573,157,81,30,841
8005996_UssWordencg18.txt,4386,58,75,1879,479,190,50,2598
8006664_FreeApostolicChurchOfPentecost.txt,4203,28,150,1445,494,165,124,2228
8006956_GeneralizationsOfFibonacciNumbers.txt,1043,37,28,375,114,45,31,565
8007920_MountainViewCur.txt,1569,32,49,578,244,126,43,991
8008520_MordechaiYosefLeiner.txt,719,34,21,386,68,32,15,501
8008893_BattleOfArawe.txt,903,19,47,330,120,77,19,546
8011469_2006TongaRiots.txt,944,25,37,335,189,52,32,608
8012721_ListOfMalians.txt,646,22,29,487,12,22,5,526
8013727_PeanutsInPopularCulture.txt,3063,55,55,1220,415,180,82,1897
8015296_1930IsleOfManTt.txt,1026,8,128,488,85,59,15,647
8018226_HazlehurstSons.txt,641,8,80,222,77,45,19,363
8018594_CesarCamargoMariano.txt,849,50,16,505,52,43,14,614
802098_1985AtlanticHurricaneSeason.txt,1705,40,42,594,242,143,62,1041
802103_YohAsakura.txt,1985,31,64,739,276,129,93,1237
802142_Formicarium.txt,570,9,63,206,89,48,18,361
8024324_ListOfSawCharacters.txt,5203,112,46,1665,1007,208,135,3015
8025007_OtterCoop.txt,1119,17,65,368,189,90,41,688
8028220_BobbyMarsino.txt,1383,5,276,478,260,47,62,847
8029172_HistoryOfGeneralHospital19801989.txt,5961,109,54,2099,1184,239,209,3731
8029741_TheMoonByNight.txt,1978,29,68,743,229,148,71,1191
8032099_LewisLeavitt.txt,789,20,39,410,45,42,6,503
803217_DoctrineOfFascism.txt,1299,30,43,519,121,96,27,763
803221_TheScreamers.txt,773,12,64,299,103,68,25,495
803232_PedroSantanaLopes.txt,1193,17,70,436,167,69,37,709
8034555_EtiquetteInAsia.txt,4000,19,210,1181,684,384,232,2481
803590_PaulKlebnikov.txt,1072,16,67,435,143,78,20,676
8036450_CrazyRhythmsong.txt,811,22,36,306,117,52,34,509
803655_SayYoullBeThere.txt,745,19,39,315,85,62,16,478
803660_NationalOrderOfQuebec.txt,755,15,50,384,48,82,11,525
8037082_2005PakistanEarthquake.txt,2762,38,72,1062,387,182,54,1685
8039960_EmissionAwareProgramming.txt,943,15,62,366,132,91,28,617
8039972_AbernethyAndKincardine.txt,662,13,50,244,85,61,24,414
8043242_Concutest.txt,846,26,32,316,120,61,28,525
804356_UssReprisal1776.txt,777,10,77,272,119,32,12,435
8043822_ClevelandRailroadHistory.txt,1171,37,31,442,166,68,42,718
8046179_WeishiRockets.txt,679,20,33,262,87,50,12,411
8047658_19thChessOlympiad.txt,872,30,29,313,127,62,32,534
8048976_TheStoker.txt,588,12,49,170,109,21,23,323
8049617_ListOfBaseballJargons.txt,5075,99,51,1666,733,319,233,2951
8049634_ListOfBaseballJargonw.txt,1157,24,48,408,172,68,43,691
8049646_BattleOfDairAlaqul.txt,1239,18,68,415,179,78,32,704
8050581_ListOfUniversityOfMichiganLawAndGovernmentAlumni.txt,8178,13,629,3971,504,330,55,4860
8050607_ListOfUniversityOfMichiganBusinessAlumni.txt,3901,14,278,2232,208,152,55,2647
8053520_ListOfBoholFestivals.txt,645,14,46,271,63,37,16,387
805354_EwoksTheBattleForEndor.txt,3235,47,68,1192,475,168,91,1926
8055417_MichaelBroggie.txt,667,10,66,335,76,30,6,447
8055418_SilverioFranconetti.txt,780,15,52,275,114,51,38,478
8056378_Highway40ontario.txt,921,13,70,341,104,68,25,538
805831_BreakpointdemoParty.txt,887,10,88,306,114,79,35,534
8058328_MichaelMuldoon.txt,1022,14,73,388,123,71,28,610
805857_InfantrycomputerGame.txt,1169,21,55,526,147,112,37,822
8058644_HistoricAdventist.txt,1107,18,61,391,154,101,38,684
80664_MichaelNyman.txt,2197,22,99,1050,145,108,31,1334
80666_Upanishad.txt,2130,37,57,1044,199,110,47,1400
80669_MiraNair.txt,679,16,42,346,62,25,9,442
8067025_MelakaGeneralHospital.txt,596,10,59,229,81,50,17,377
80674_SanBernardinoCountyCalifornia.txt,1650,38,43,878,117,76,21,1092
80676_Anarchopunk.txt,1315,22,59,554,142,141,34,871
80678_Jeeves.txt,1759,24,73,774,179,99,66,1118
80710_UlsterVolunteerForce.txt,1926,32,60,729,266,108,46,1149
80725_BeyondOurKen.txt,926,29,31,452,113,29,26,620
807597_Astrotrain.txt,1671,33,50,616,251,80,63,1010
807609_MarieOfEdinburgh.txt,1461,25,58,587,181,81,36,885
8077645_ImpactOfRenewableEnergyOnUkPowerTransmissionCosts.txt,2108,16,131,649,329,138,127,1243
8077947_UsMensSoccerRecords19801989.txt,823,96,8,544,14,10,3,571
8078610_DatabaseAdministrationAutomation.txt,591,14,42,271,79,50,29,429
8080493_LandfillircChannel.txt,744,7,106,221,96,77,38,432
808095_Artemidorus.txt,667,9,74,262,85,60,17,424
8081460_Godsendheroes.txt,1032,22,46,357,176,41,41,615
8084427_PhilippaOfToulouse.txt,857,9,95,253,131,40,39,463
8087616_AndrewPinder.txt,743,23,32,260,83,47,22,412
8092389_PopularCultureReferencesToDeepThroat.txt,874,24,36,396,96,37,20,549
8094023_HistoryOfFloridaAtlanticUniversity.txt,1134,8,141,434,150,76,38,698
8094067_RobertBernasconi.txt,865,7,123,444,30,20,8,502
809780_RomiPaku.txt,630,12,52,391,33,13,2,439
8097845_Unman.txt,600,9,66,215,85,40,19,359
8097864_StHelensCombination.txt,1016,60,16,553,109,45,35,742
809814_AbelTasmanship.txt,553,22,25,216,65,26,18,325
8098834_BattleOfSurabaya.txt,1254,24,52,494,156,98,24,772
80990_Gorgon.txt,2610,31,84,972,354,169,89,1584
8099193_GreatestHitandMore.txt,561,9,62,186,90,33,35,344
8099762_RailroadsOfHaiti.txt,2363,50,47,919,282,155,56,1412
8100152_JohannesPsuke.txt,617,15,41,241,66,40,14,361
8100761_GarrardCo.txt,675,11,61,301,73,27,5,406
8100768_CovenantAwards.txt,1232,130,9,937,43,21,7,1008
8101695_SriMuralidharaSwamiji.txt,1687,22,76,769,191,101,40,1101
8102654_BoatsInASeriesOfUnfortunateEvents.txt,1816,36,50,666,282,74,44,1066
8102698_SevdaAlekperzadeh.txt,618,7,88,220,82,59,28,389
810271_RedBullTheatre.txt,1278,12,106,486,185,72,47,790
8103088_1991InMotoring.txt,985,17,57,303,121,114,42,580
8104049_GerPower.txt,757,11,68,242,102,68,34,446
8104112_KanabAmbersnail.txt,633,12,52,230,98,41,25,394
8107490_CongressionalHearing.txt,1096,9,121,439,124,90,35,688
8107880_RobertEKelley.txt,864,17,50,456,74,39,5,574
8108446_StraightWired.txt,1564,52,30,466,280,88,75,909
810865_Berchem.txt,1241,27,45,471,150,84,25,730
810880_FiatStilo.txt,829,17,48,314,95,63,30,502
8109440_DallasTurkeyTrot.txt,574,13,44,234,68,26,18,346
8109445_YuriShchekochikhin.txt,819,14,58,326,92,63,14,495
81107_MarioBros.txt,2001,14,142,714,299,139,72,1224
81118_LuigisMansion.txt,2153,28,76,742,334,116,73,1265
8112790_BulgarianVerbs.txt,2351,41,57,677,332,267,94,1370
8113343_MtvInPopularCulture.txt,1883,5,376,792,222,112,60,1186
8113695_KasamhSe.txt,2789,25,111,1132,507,85,86,1810
8114232_BuckPrivatesComeHome.txt,715,13,55,257,111,31,29,428
8114271_CrimeComics.txt,834,12,69,336,94,77,22,529
8115244_CuretisBulis.txt,1368,10,136,458,124,179,68,829
8116621_FundamentalLawOfTheVatican.txt,1519,68,22,475,136,101,19,731
812017_Bhimbetka.txt,795,14,56,296,126,66,21,509
812350_Taris.txt,1357,19,71,498,217,82,40,837
8123928_TheSkewedView.txt,1238,15,82,399,196,101,63,759
8125246_ThirdPresbyterianChurchBirminghamAlabama.txt,581,9,64,214,69,48,14,345
8126820_Coloplast.txt,1186,43,27,489,154,77,27,747
8127750_1895JapaneseConquestOfTaiwan.txt,1094,16,68,401,132,85,25,643
8130646_TuscaroraValleyRailroad.txt,753,10,75,265,106,55,28,454
8134517_ListOfSpaceRunawayIdeonCharacters.txt,2391,46,51,855,317,123,76,1371
8134523_WickedmusicalCastLists.txt,2844,59,48,1968,99,32,4,2103
8135890_MileyCyrus.txt,682,19,35,327,78,34,18,457
8137791_FrChicoMonteiro.txt,790,12,65,320,98,35,18,471
8139417_WarsteinerBeerAndBrewery.txt,948,28,33,400,148,63,23,634
8140352_LoveDisconnection.txt,726,9,80,262,113,28,30,433
814148_PartialTrace.txt,821,49,16,290,111,80,20,501
814461_BenjaminFranklinWhite.txt,604,11,54,297,54,26,17,394
8147126_ListOfCanadaunitedStatesBorderCrossings.txt,889,35,25,651,4,23,1,679
8148082_AyuTsukimiya.txt,1250,16,78,342,218,68,76,704
8149360_CarrolltonManor.txt,587,9,65,215,93,41,12,361
8149994_Slowking.txt,1081,15,72,414,136,89,28,667
8150348_RegnumOnline.txt,1142,24,47,422,162,97,44,725
8150951_PlantPerceptionparanormal.txt,1672,17,98,611,241,114,60,1026
8150966_ListOfJewishPeruvianBusinesspeople.txt,681,5,136,470,9,29,4,512
8152335_SelinsgroveAreaIntermediateSchool.txt,807,26,31,367,90,50,9,516
8152873_2004InIps.txt,557,35,15,324,62,18,2,406
815329_ReadMyLipsNoNewTaxes.txt,3320,40,83,1202,488,238,151,2079
8153846_LaCitDeLaPeur.txt,2046,25,81,718,335,96,74,1223
8156750_SpiritFromJsuDrumAndBugleCorps.txt,566,14,40,207,81,41,11,340
8157715_NintendoDsBootingTools.txt,601,17,35,207,113,39,26,385
8158367_KolejTeknologiPulau.txt,607,7,86,245,80,54,13,392
8159017_GilliamYeager.txt,779,10,77,308,98,42,20,468
8161915_NotableAttacksAttributedToTheLtte.txt,1258,31,40,502,168,75,24,769
8162275_MatrisDominiMonastery.txt,1575,30,52,587,166,109,62,924
8162836_Tomars.txt,1151,33,34,567,121,42,30,760
816396_EconomyCar.txt,762,13,58,288,96,84,31,499
816434_DiscworldNoir.txt,2771,23,120,1112,333,164,92,1701
8165138_YulupaCreek.txt,768,12,64,335,83,77,22,517
8165717_Whfh.txt,1653,54,30,764,194,105,44,1107
816780_Optimistdinghy.txt,820,15,54,268,106,73,37,484
8169558_TommyWomack.txt,601,15,40,261,73,39,15,388
8170003_BothropsJararaca.txt,595,16,37,188,86,72,26,372
8170908_SoRoqueChurchlisbon.txt,753,10,75,288,74,58,12,432
8174453_UnMundoDeMentiras.txt,662,19,34,264,84,24,18,390
81746_Ziggurat.txt,1490,27,55,614,188,88,27,917
817513_BattleOfCropredyBridge.txt,782,16,48,294,118,36,21,469
817532_AmosRusie.txt,733,11,66,247,97,37,24,405
81756_RochesterInstituteOfTechnology.txt,2333,34,68,1060,236,173,48,1517
81761_Diesel.txt,2091,35,59,779,318,182,85,1364
817811_KonradIOfMasovia.txt,628,11,57,235,79,27,22,363
8178316_OrgreaveColliery.txt,734,11,66,312,100,26,16,454
8178655_TheBoweryBoys.txt,711,16,44,288,82,31,21,422
81795_DavidByrnemusician.txt,1376,30,45,700,99,64,26,889
81798_Solipsism.txt,3954,66,59,1237,555,359,226,2377
8180194_GreatGodOm.txt,1136,14,81,355,167,87,71,680
81803_AlienInvasion.txt,2818,18,156,1046,343,227,88,1704
8188343_TheCompleteStudioRecordingsabba.txt,1206,29,41,780,70,46,15,911
8191189_TananaChiefsConference.txt,1288,23,56,525,143,105,17,790
8191819_LennyWallace.txt,964,10,96,286,195,30,53,564
8193134_LakeSimcoeRegionConservationAuthority.txt,1281,24,53,606,131,73,16,826
8194648_FukoKirisawa.txt,3757,43,87,1084,739,178,220,2221
8197045_TheMuseumOfDisabilityHistory.txt,722,13,55,311,77,54,11,453
820081_MariaSabina.txt,844,15,56,330,116,47,16,509
8200877_FraudAct2006.txt,626,13,48,198,93,24,12,327
8201819_ElianeChantalKarpFernenbug.txt,636,13,48,238,82,44,10,374
8202821_RenFollet.txt,665,12,55,300,57,47,11,415
8202850_Sageallen.txt,640,11,58,267,78,61,23,429
82068_SantaBarbaraCountyCalifornia.txt,1732,33,52,747,171,115,38,1071
820695_UssGanges1794.txt,934,14,66,337,143,50,22,552
82071_SantaClaraCountyCalifornia.txt,1174,31,37,525,127,72,25,749
820757_DuleepSingh.txt,1415,15,94,510,190,63,40,803
8207622_DevonPreparatorySchool.txt,1420,27,52,686,131,109,17,943
8208639_BrendaDervin.txt,740,18,41,358,55,54,9,476
8209565_2007PremierLeagueDarts.txt,662,15,44,463,28,14,1,506
8210533_CarrierStrikingTaskForce.txt,681,16,42,436,25,60,2,523
82130_VenturaCountyCalifornia.txt,1925,38,50,773,258,100,32,1163
82133_YubaCountyCalifornia.txt,569,14,40,219,57,26,3,305
8215354_PierreCot.txt,685,12,57,250,74,38,15,377
8215376_PoliceAct1964.txt,1561,17,91,696,197,82,24,999
8216307_IvaBittov.txt,879,13,67,405,78,62,14,559
821857_CapAndSkull.txt,1566,16,97,720,165,98,31,1014
8218826_FirstSacredWar.txt,641,8,80,220,98,40,20,378
82188_ListOfTexasCounties.txt,3235,27,119,1686,282,27,2,1997
821928_JeffreySinclair.txt,638,12,53,203,98,29,21,351
82193_ChurchOfTheBrethren.txt,3027,73,41,1161,374,218,102,1855
82195_Avianca.txt,3011,96,31,1344,318,191,62,1915
82198_BeloHorizonte.txt,3242,73,44,1182,354,302,103,1941
8224006_PrecolombianGoldworkingOfTheChibchanArea.txt,0,0,0,0,0,0,0,0
8224013_CeremonialMetate.txt,983,23,42,356,126,138,36,656
8225573_UnitedStatesPresidentialElection2000FloridaResults.txt,4122,45,91,1483,610,271,159,2523
8227512_JoseFValdez.txt,847,13,65,353,95,50,20,518
8228822_AlphonsebigBoyCaprice.txt,662,11,60,258,97,40,24,419
8228843_MontedocParker.txt,628,9,69,198,112,36,22,368
8229783_GrandTheftAutoViceCityStoriesEmpireMode.txt,860,17,50,324,123,54,28,529
8230775_TheSpeculativeDinosaurProject.txt,2038,44,46,694,267,220,121,1302
8233327_RuthinSchool.txt,1180,15,78,614,72,62,10,758
8234290_BattleOfCaen1346.txt,1162,11,105,376,177,90,33,676
8234621_AmilkarAriza.txt,679,13,52,351,50,38,10,449
8235287_MontpelierHighSchool.txt,1319,45,29,608,164,86,35,893
8237147_LocationsInTheOrderOfTheStick.txt,1576,14,112,546,225,92,73,936
8237540_Prechristmas2004Snowstorm.txt,678,7,96,288,80,41,12,421
8239429_JohnpaulMcqueen.txt,872,10,87,237,169,71,53,530
8239442_PoniatowskiBridge.txt,582,9,64,211,79,37,15,342
8240072_UniversityOrganizationsannotatedList.txt,2286,22,103,1043,215,214,21,1493
8240396_GeorgeTemplepoole.txt,1511,21,71,602,199,112,43,956
8240414_CapitolineVenus.txt,674,10,67,284,66,28,14,392
8240419_BlancheMcmanus.txt,1524,86,17,964,82,30,20,1096
8241015_GarethWilliamsmusician.txt,1050,39,26,408,123,50,38,619
824108_AlexanderThomson.txt,596,9,66,227,64,40,24,355
8242059_LucMoullet.txt,623,14,44,274,69,58,21,422
8243274_BattleOfBirchCoulee.txt,581,6,96,223,87,27,23,360
8243298_AdenoidHypertrophy.txt,709,11,64,221,103,78,45,447
8243345_DeepFoundation.txt,2107,48,43,770,390,192,74,1426
8247207_LeoAustria.txt,758,10,75,336,78,45,9,468
8250038_DannyIldefonso.txt,929,16,58,392,93,65,18,568
8252032_Edrington.txt,3381,45,75,1409,370,137,83,1999
8252994_VehicleInfrastructureIntegration.txt,2835,40,70,893,464,251,145,1753
8254934_EducationInTheSimpsons.txt,1266,27,46,615,159,71,41,886
8255564_RayThackeray.txt,677,13,52,347,54,30,5,436
8255880_MillersRiver.txt,642,11,58,270,66,31,16,383
8257423_JacksonianIndianPolicy.txt,1220,23,53,414,239,59,41,753
8258723_RaaOfTheCaves.txt,648,13,49,216,99,29,25,369
8260365_PeterKellman.txt,1237,31,39,559,133,81,17,790
826216_GalaxyMorphologicalClassification.txt,1276,25,51,429,188,136,59,812
8262635_Carabosse.txt,947,15,63,315,158,55,41,569
8264187_GlossaryOfCanadianEnglishWords.txt,8469,23,368,3476,865,726,435,5502
8265527_LiamGeorge.txt,575,7,82,267,62,21,10,360
826673_Yut.txt,1337,20,66,374,240,99,66,779
8268432_FootballersWhoDiedWhilePlaying.txt,757,12,63,280,106,46,13,445
8270036_StephenMinotWeldJr.txt,1172,39,30,467,152,67,33,719
8270344_MagalyRuiz.txt,633,8,79,371,39,31,4,445
8270347_HungarianVolunteersInTheWinterWar.txt,1283,23,55,491,153,100,35,779
8272243_TheGeniusClub.txt,871,27,32,368,120,51,15,554
827291_RingRoadsOfBeijing.txt,1332,37,36,545,144,112,62,863
827294_FileExchangeProtocol.txt,421,10,42,210,37,24,14,285
827312_Shadowbabylon5.txt,3109,56,55,949,495,224,138,1806
8274792_GaryWise.txt,600,16,37,234,79,35,17,365
8276776_ChristianityInThePhilippines.txt,590,8,73,222,56,58,20,356
827792_RareEarthHypothesis.txt,8060,70,115,2739,1002,970,395,5106
8280952_FrostyTheSnowmantelevisionSpecial.txt,592,6,98,211,100,29,29,369
8283407_ListOfTheWallflowerCharacters.txt,1356,20,67,374,218,120,95,807
82835_Momus.txt,888,17,52,347,104,57,20,528
8284028_JohnOAgwunobi.txt,665,9,73,327,61,43,8,439
8284072_Voorthuizen.txt,2999,52,57,1157,359,188,87,1791
82841_Naiad.txt,700,12,58,270,92,44,21,427
82842_SexAndTheCity.txt,4914,100,49,2104,549,313,151,3117
82847_GeorgeCScott.txt,1279,24,53,478,165,66,30,739
828484_KiraFord.txt,764,12,63,268,115,43,21,447
82848_Piccolo.txt,610,11,55,198,90,65,40,393
8285001_SibeliusSymphonyNo5firstMovement.txt,2306,18,128,726,266,204,101,1297
8285020_RoadsOfHuntingtonWestVirginia.txt,643,21,30,268,55,41,10,374
82858_MarsObserver.txt,707,11,64,268,100,47,27,442
8285987_JunoAndThePaycock1930Film.txt,665,10,66,241,102,51,27,421
82863_Thasos.txt,947,23,41,366,106,49,18,539
8286923_Helicopter.txt,5540,77,71,1918,801,531,191,3441
8286941_PrioryGreenQuadrilateral.txt,791,10,79,318,119,28,20,485
82872_ClementineMission.txt,2412,17,141,933,268,161,30,1392
82877_OneMinuteSilence.txt,1064,26,40,408,138,92,37,675
82886_Tiberias.txt,610,15,40,231,81,38,15,365
82887_Rickettsia.txt,629,19,33,266,92,59,33,450
8288847_InvasionOfTheBane.txt,2537,22,115,993,404,105,82,1584
8288876_ViralProcessing.txt,1780,21,84,562,270,152,99,1083
82889_Cabeiri.txt,1237,16,77,444,165,94,40,743
8292744_JCAdams.txt,1119,25,44,504,140,72,19,735
8292758_ThirdDayInTheBible.txt,2181,24,90,722,288,164,71,1245
8295042_Kaldunywork.txt,603,9,67,190,100,62,25,377
829515_MoscowInstituteOfPhysicsAndTechnology.txt,2490,49,50,982,283,229,102,1596
8296598_LegalSystemOfBelarus.txt,2445,52,47,919,258,162,40,1379
8298553_MarkReeder.txt,1714,17,100,655,204,132,87,1078
829899_JulienOffrayDeLaMettrie.txt,849,11,77,292,133,56,33,514
829960_DvdShrink.txt,1010,13,77,379,147,82,52,660
8299803_ListOfItalianDocgWines.txt,701,14,50,376,50,7,7,440
8300821_2006MilwaukeeExplosion.txt,1296,15,86,429,230,81,43,783
8304293_Thanksgivingcanada.txt,677,13,52,270,91,51,17,429
8304348_ThanksgivingunitedStates.txt,2977,45,66,1033,392,186,131,1742
8305322_ElioPace.txt,1169,20,58,505,132,75,36,748
8305595_LysakerStation.txt,669,10,66,214,110,35,17,376
8305604_ChuckPriefer.txt,1502,14,107,556,182,104,18,860
830565_KiraYamato.txt,5682,91,62,2201,897,221,204,3523
8306275_PianoPedals.txt,3920,40,98,1406,496,303,154,2359
8308203_JohnMartinireland.txt,1532,18,85,512,217,98,50,877
8308210_ListOfItalianIgtWines.txt,3826,23,166,1889,450,24,3,2366
8310136_ListOfPeopleByNameUneunz.txt,948,12,79,693,6,62,0,761
8310431_QueerMagazine.txt,612,10,61,231,96,43,16,386
8313951_Youros.txt,597,12,49,247,85,35,25,392
8314930_JamesAlfredDavidson.txt,877,15,58,316,114,59,22,511
8315298_VelikoeVMalomIAntikhrist.txt,636,17,37,265,70,39,10,384
831650_Anodising.txt,1467,27,54,486,237,139,57,919
831754_DelegatedLegislation.txt,1974,35,56,654,334,146,88,1222
8318200_AliceEstesDavis.txt,636,12,53,258,71,41,16,386
8320072_NewGuangxiClique.txt,1357,16,84,545,166,75,28,814
83212_Aude.txt,540,10,54,220,63,47,17,347
8321680_BattleOfHaditha.txt,673,7,96,234,102,33,12,381
8322661_TheSagaOfBjorn.txt,2778,32,86,944,456,132,115,1647
8323640_HistoryOfPresqueIsle.txt,926,9,102,333,141,53,25,552
8323991_ElDiamanteHighSchool.txt,610,1,610,237,86,68,21,412
8325592_CalvinCollegehopeCollegeRivalry.txt,622,7,88,241,77,20,9,347
8325919_3dAirDivision.txt,2004,50,40,989,107,66,17,1179
8327486_ListOfMinorGodsInAgeOfMythologyAndTheTitans.txt,1364,43,31,747,113,86,32,978
8327501_GilbertGnarley.txt,707,4,176,264,117,39,24,444
8328749_Fastexport.txt,350,18,19,172,26,13,5,216
8329437_MalaysiaAtThe2006AsianGames.txt,2996,90,33,1109,382,218,111,1820
8329780_GarouTribeswerewolftheApocalypse.txt,5228,88,59,1734,732,387,214,3067
8331346_DmitriyVladimirovichGolitsyn.txt,551,11,50,210,51,31,8,300
8332325_ListOfStrategicSimulationsIncGames.txt,631,21,30,406,7,6,1,420
8333286_OccupationOfIstanbul.txt,3002,42,71,1112,414,200,58,1784
8334280_SusurrusMagazine.txt,644,15,42,202,115,43,24,384
8334599_KarlInderfurth.txt,611,10,61,316,46,37,14,413
8335209_Chunchucmil.txt,3536,60,58,1630,331,313,93,2367
8335499_Boodie.txt,1572,18,87,555,222,183,60,1020
8335556_EverexSystemsInc.txt,547,38,14,257,49,42,8,356
8336187_JuliusGetman.txt,1046,25,41,555,63,40,14,672
8338089_FrederickZiv.txt,616,9,68,257,68,50,17,392
8338131_FederalismInIraq.txt,604,18,33,215,82,32,9,338
8339097_Scona.txt,868,6,144,352,97,73,11,533
8341013_StefanSarkoti.txt,579,10,57,219,66,34,22,341
8341354_FinalWatch.txt,2524,25,100,759,404,189,143,1495
834220_KSRanjitsinhji.txt,787,13,60,293,90,45,33,461
8342260_OlegPantyukhov.txt,649,15,43,240,80,35,18,373
834280_AugustusAgar.txt,5209,84,62,1869,756,319,141,3085
8343343_TropicalStormDean1995.txt,654,14,46,207,85,62,19,373
8344244_PrincessHelenOfSerbia.txt,792,10,79,357,95,32,21,505
8344850_EugenePidgeon.txt,1131,19,59,474,139,45,29,687
8346771_HammwestfalenRailwayStation.txt,1150,24,47,392,159,76,45,672
8354505_PoemRocket.txt,1053,11,95,482,133,73,33,721
8355829_DerekRhodes.txt,658,17,38,271,106,38,18,433
8357370_BonnieStern.txt,608,10,60,329,69,31,7,436
8359283_ThomasOrdelees.txt,719,15,47,240,121,32,16,409
8360275_GordonHSato.txt,1780,22,80,797,165,122,28,1112
8360_December26.txt,2369,7,338,1258,112,123,6,1499
8361_DefinableRealNumber.txt,859,19,45,224,110,143,55,532
8362_DiegoDeAlmagro.txt,3183,38,83,1114,465,144,113,1836
8363142_ComfortdelgroCabcharge.txt,693,16,43,355,69,31,6,461
8363605_OperationPirateoperationCowgirl.txt,1742,18,96,557,263,74,87,981
8363_Divinity.txt,2050,34,60,741,252,192,71,1256
8364143_VenturiScrubber.txt,1921,48,40,739,263,165,83,1250
8366493_NavalAirStationKeyWest.txt,1051,21,50,479,141,57,22,699
8368991_ChristopherHobbs.txt,664,7,94,274,78,59,17,428
8370300_RobertAmselLgbtHistory.txt,699,12,58,265,93,47,21,426
8370869_OccamsRazorhouseEpisode.txt,1323,26,50,454,214,81,80,829
8370904_Mugglewump.txt,909,10,90,236,111,78,55,480
837092_KoshienStadium.txt,684,21,32,267,86,43,17,413
837282_PetreDumitrescu.txt,709,14,50,264,90,43,15,412
8372_DeclarationOfIndependence.txt,1770,12,147,683,183,118,50,1034
8373762_UssPortertb6.txt,772,14,55,334,91,20,7,452
8373_DragRacing.txt,4955,49,101,1681,725,497,213,3116
837483_VincenzoMonti.txt,598,11,54,236,57,50,15,358
8375_Draugr.txt,959,26,36,289,156,73,37,555
8376667_WildlifeOfStHelena.txt,1457,29,50,741,151,99,45,1036
8376_Day.txt,1723,26,66,579,196,140,59,974
8377_Database.txt,3707,47,78,1215,600,339,137,2291
8378_Dipole.txt,1979,68,29,676,221,236,58,1191
8379595_DragonRaja.txt,1871,57,32,701,248,109,57,1115
8379942_Tanguito.txt,1239,20,61,429,187,108,50,774
838213_PaulFierlinger.txt,1108,15,73,492,117,61,19,689
8382465_SportsWorldInternational.txt,589,13,45,235,83,37,17,372
8382511_JohnStigall.txt,600,8,75,300,54,29,11,394
838266_Kampfgeschwader200.txt,771,16,48,288,117,72,13,490
838271_2005InVideoGaming.txt,1668,15,111,927,135,71,26,1159
838362_Systemantics.txt,762,8,95,287,123,57,30,497
838637_ThodoreRousseau.txt,939,11,85,302,123,51,53,529
838658_SandringhamRailwayLineMelbourne.txt,1033,23,44,426,123,51,40,640
8387289_TheWorlds100MostPowerfulWomen.txt,987,5,197,667,5,7,1,680
8387_DraughtBeer.txt,846,14,60,292,161,42,35,530
8388294_TarynSimon.txt,815,12,67,350,108,65,18,541
8389232_BritishFlatRacingChampionOwner.txt,607,6,101,317,5,17,2,341
8389587_826Michigan.txt,714,15,47,261,90,51,27,429
8389_ClinicalDepression.txt,9007,133,67,3209,1259,1067,393,5928
8391145_CaliforniaPunkScene.txt,1015,23,44,457,112,76,28,673
83931_TheChroniclesOfAmber.txt,2952,42,70,1101,392,170,91,1754
83932_FictionalUniverse.txt,1162,14,83,427,117,145,53,742
83933_ResistanceMovement.txt,958,21,45,560,74,67,19,720
839358_EffDesCracker.txt,587,10,58,210,79,52,22,363
83938_FrenchResistance.txt,4822,61,79,1920,584,354,137,2995
8394040_SteelDesign.txt,589,24,24,285,42,42,4,373
83942_Courtyard.txt,1009,17,59,363,157,81,42,643
83943_IndonesiaRaya.txt,663,33,20,422,36,46,9,513
8394411_ListOfPeopleByNameBenfbenz.txt,1115,14,79,805,5,68,3,881
83965_AbdullahOfSaudiArabia.txt,1043,21,49,471,123,51,22,667
8396972_DartWars.txt,1495,18,83,497,262,68,51,878
8396_December11.txt,1937,6,322,1049,79,89,6,1223
839748_VladimirVoinovich.txt,598,10,59,224,64,33,15,336
839750_Gurgaon.txt,1588,34,46,733,185,103,49,1070
8397_DannyElfman.txt,1815,20,90,811,183,105,44,1143
839804_Squier.txt,988,26,38,488,92,88,34,702
83986_UsListOfStateSponsorsOfInternationalTerrorism.txt,712,11,64,298,99,36,11,444
8398913_DravidianSubstratumInSanskrit.txt,639,8,79,218,74,69,34,395
8398_Dimension.txt,1847,30,61,651,231,189,54,1125
8399856_ByronHill.txt,1590,13,122,1007,81,57,20,1165
8399861_GuqinInPopularCulture.txt,777,5,155,313,76,46,28,463
8400809_TheWAltonJonesCellScienceCenter.txt,1072,15,71,528,93,53,15,689
8400_Duodecimal.txt,1799,25,71,475,221,184,93,973
8401803_Opiny.txt,588,10,58,214,68,48,16,346
8402_Diving.txt,3410,70,48,1193,467,292,152,2104
840451_Jscriptnet.txt,1007,37,27,374,147,76,57,654
8405066_SpanishGibraltarians.txt,739,8,92,255,86,49,32,422
840544_CodenameEagle.txt,1289,19,67,431,186,77,49,743
840551_Kodungallur.txt,1264,28,45,478,159,75,37,749
8406830_WilliamEBennett.txt,805,20,40,371,74,46,13,504
8406840_MarEliasEducationalInstitutions.txt,574,15,38,234,61,36,10,341
840769_DeLessepsStoryMorrison.txt,2409,32,75,1012,304,169,42,1527
840830_AlliedIrishBanks.txt,2375,52,45,950,301,132,67,1450
840894_ComputationalTreeLogic.txt,715,34,21,220,97,64,41,422
840895_Apokolips.txt,679,11,61,238,100,60,29,427
840896_HolotropicBreathwork.txt,2901,44,65,1048,374,263,87,1772
8409020_RachelNickell.txt,1454,28,51,474,262,91,56,883
8409463_BattleAssembly.txt,741,14,52,290,93,54,34,471
8410075_MindFactory.txt,609,8,76,254,76,39,29,398
8411212_QuantumCellularAutomata.txt,3926,45,87,1438,489,389,148,2464
8411218_PaulBikle.txt,627,12,52,284,57,33,7,381
8411248_MostafaSidAhmed.txt,737,7,105,376,73,39,19,507
8412339_Eserverorg.txt,702,16,43,281,86,62,22,451
8413407_MarineAviationTrainingSupportGroup22.txt,636,14,45,313,67,18,11,409
8413421_ValidityOfCatholicChurchAuthority.txt,1077,8,134,315,181,77,61,634
8413_DragonBallZ.txt,3679,49,75,1502,434,272,123,2331
8414896_CauseMarketing.txt,925,16,57,364,129,84,27,604
841524_BlohmVossBv222.txt,891,22,40,352,119,43,27,541
841560_GordonBennettaustralianSoldier.txt,1673,31,53,585,249,103,35,972
841643_CaribanaFestivalcanada.txt,684,10,68,303,73,44,18,438
8418879_WesternUseOfTheSwastikaInTheEarly20thCentury.txt,4639,96,48,1842,590,283,105,2820
8418906_CharlesFane1stViscountFane.txt,582,10,58,263,53,21,2,339
841917_Pervertedjusticecom.txt,2366,31,76,746,416,154,95,1411
8419251_PenleighAndEssendonGrammarSchool.txt,869,12,72,456,74,37,12,579
842001_ChoHakkaisaiyuki.txt,3088,32,96,940,502,170,155,1767
8421493_FiveHandReel.txt,650,19,34,297,65,53,16,431
8425417_DannySorenson.txt,625,9,69,207,104,42,19,372
842640_AntipopeClementIii.txt,1556,33,47,558,219,62,48,887
8426981_ColdSweat.txt,591,11,53,240,65,46,20,371
842728_AngelesCity.txt,847,19,44,347,104,48,21,520
8427582_JoseAbueva.txt,1171,17,68,543,108,64,27,742
8428136_TheBrewingNetwork.txt,572,22,26,274,49,39,17,379
8428757_KilmoreRecFc.txt,1037,23,45,418,125,55,17,615
843013_ThousandCharacterClassic.txt,881,17,51,362,107,53,17,539
843093_TonyToniTon.txt,685,13,52,315,73,39,13,440
8433072_PedigreeOfSwedishMonarchs.txt,1963,146,13,1081,165,86,49,1381
8433110_ChapterViiiOfTheAustralianConstitution.txt,939,16,58,279,147,56,37,519
8434151_DonaldShankweiler.txt,1001,4,250,577,59,55,11,702
8434154_GeorgeCharlesHawker.txt,644,7,92,214,81,34,18,347
8435233_Indian23rdInfantryDivision.txt,721,22,32,306,98,69,8,481
8435317_ThomasGreenSon.txt,1384,26,53,561,200,74,37,872
84358_ClimateOfTheUnitedKingdom.txt,3770,70,53,1234,407,410,196,2247
84359_Tomatina.txt,696,12,58,233,98,43,27,401
8436779_OasisSoaReferenceModel.txt,1314,29,45,487,188,84,28,787
84369_Underworld.txt,802,97,8,623,27,38,13,701
843708_NapoleonInPopularCulture.txt,1170,32,36,447,164,78,34,723
8437510_BerthaMahoney.txt,893,16,55,367,113,36,33,549
8439064_DuquandukieWeems.txt,796,9,88,279,117,37,30,463
8439066_RandyWagstaff.txt,1112,14,79,420,194,28,35,677
8439678_HilbertsArithmeticOfEnds.txt,675,18,37,222,66,43,19,350
8440770_ListOfNavalGuns.txt,669,12,55,389,6,19,2,416
844127_MoreFm.txt,1898,56,33,791,198,107,44,1140
844178_Ikky.txt,893,17,52,315,132,66,34,547
8441871_Ias19EmployeeBenefits.txt,1068,24,44,357,190,66,26,639
8442261_BleedingSouls.txt,11371,93,122,3942,1795,703,521,6961
8442266_PerryKivolowitz.txt,630,8,78,219,84,49,25,377
8444092_Pactionegima.txt,7271,58,125,2477,1091,483,295,4346
8447308_SurvivoroctaviaButlerNovel.txt,1792,32,56,578,230,140,68,1016
844800_OspreysrugbyTeam.txt,579,21,27,251,59,49,17,376
844812_Mccormick.txt,956,25,38,619,40,54,9,722
844813_M14michiganHighway.txt,1155,23,50,444,152,65,26,687
8449933_PerryVanDerBeck.txt,611,12,50,241,64,30,13,348
8451701_Golija.txt,619,16,38,267,55,56,11,389
8451767_RobertZLawrence.txt,625,11,56,384,21,16,3,424
8453265_MarionFoale.txt,673,17,39,242,109,31,26,408
8456069_Rbezahl.txt,593,16,37,228,62,63,22,375
845890_FranoisSimiand.txt,853,11,77,419,59,63,14,555
845893_SimonCarmiggelt.txt,853,12,71,354,85,42,18,499
845903_SendMoreParamedics.txt,745,18,41,327,66,43,10,446
845904_Project86.txt,1055,27,39,455,114,63,30,662
845910_MormonPioneers.txt,3071,26,118,1222,416,201,77,1916
8459328_NicholasJohnVinehall.txt,620,17,36,240,69,48,14,371
845933_UsAcres.txt,2328,15,155,783,319,152,123,1377
845943_RobertGates.txt,2683,40,67,1184,305,105,55,1649
845947_DoverCollege.txt,704,13,54,303,73,48,14,438
845960_PrehistoricScotland.txt,1799,28,64,705,241,135,57,1138
846004_FieldHockeyAtThe2004SummerOlympics.txt,751,36,20,496,49,19,4,568
8461578_December2006PacificNorthwestStorms.txt,676,19,35,249,103,49,20,421
846389_JosephBatesadventist.txt,723,11,65,278,85,44,11,418
8469636_LonglistsFor79thAcademyAwards.txt,1307,26,50,751,63,65,16,895
8470367_ListOfAngAirRefuelingWingsAssignedToStrategicAirCommand.txt,973,26,37,533,51,64,6,654
8470400_GoRoyalFamily.txt,635,6,105,251,80,29,14,374
847078_Taxman.txt,1116,19,58,377,167,72,51,667
8474730_FacultiesAndDepartmentsOfTheUniversityOfAlberta.txt,659,25,26,422,1,3,0,426
847478_BondDuration.txt,1475,44,33,530,198,98,51,877
8474821_Tmstevens.txt,935,29,32,534,50,42,15,641
8476940_ForestsOfTheIberianPeninsulatranslation.txt,4049,72,56,1873,450,320,149,2792
8479151_TheHeraldaustralia.txt,671,18,37,247,79,34,21,381
8479487_Tongkonan.txt,1895,29,65,633,309,207,88,1237
848067_Reductioncomplexity.txt,1291,20,64,439,212,87,64,802
848163_Claimpatent.txt,2449,56,43,787,356,220,91,1454
848171_ConsultationOnChurchUnion.txt,592,11,53,305,58,21,10,394
8484604_JackTafari.txt,1574,32,49,587,213,107,42,949
848569_EhudOlmert.txt,2754,51,54,1020,383,171,71,1645
848618_RylandsLibraryPapyrusP52.txt,1285,13,98,421,145,117,61,744
8488304_MillenniumManor.txt,738,5,147,224,136,43,28,431
8490042_AbcDaytime.txt,1357,45,30,782,23,5,1,811
8491176_ListOfMrMenAndLittleMissEpisodes.txt,732,7,104,508,28,20,10,566
8491222_SamoneTurnbull.txt,661,8,82,210,116,57,36,419
849158_TamiamiTrail.txt,1740,29,60,664,230,79,48,1021
8492307_BukuHarianNayla.txt,820,19,43,250,164,47,57,518
849237_Contiki.txt,657,21,31,370,67,51,11,499
849241_Oviraptoridae.txt,746,8,93,252,127,73,45,497
849630_ValeryGergiev.txt,786,17,46,312,76,45,20,453
8496628_ArgumentFromLove.txt,587,9,65,184,80,61,24,349
8497703_LickingRiverkentucky.txt,582,11,52,238,57,49,15,359
8499912_1996InMotoring.txt,855,16,53,278,106,100,31,515
8499973_Zekistan.txt,1032,17,60,418,142,90,30,680
85018_ListOfBattles14011800.txt,9495,11,863,5046,460,421,54,5981
85019_ListOfBattles18011900.txt,12135,6,2022,6679,644,555,72,7950
85020_ListOfBattlesBefore601.txt,5807,14,414,3126,425,164,70,3785
8502106_Jaymod.txt,675,16,42,246,114,37,17,414
85036_MaximGorky.txt,1993,24,83,711,233,140,64,1148
85062_Krsone.txt,1771,24,73,753,195,100,51,1099
850743_TimelineOfChristianity.txt,8324,32,260,4273,761,402,107,5543
850744_AYJackson.txt,630,17,37,246,91,35,13,385
8507539_Gelf.txt,3256,51,63,1031,532,242,164,1969
8507654_KimVoss.txt,1151,25,46,603,60,54,14,731
8508724_JackFrosttvSpecial.txt,900,6,150,323,137,44,45,549
8509804_ListOfNotableBridges.txt,747,3,249,389,37,74,11,511
8512001_Stumpgame.txt,1449,10,144,399,245,90,71,805
8512401_Reflectortransformers.txt,633,15,42,226,92,41,29,388
851414_Abbywinterscom.txt,806,18,44,252,117,92,43,504
851429_2ndCavalryRegimentunitedStates.txt,1381,21,65,605,131,83,26,845
8515221_BreakfastTelevisioncitytvToronto.txt,840,20,42,397,97,58,25,577
8515223_BrookeHillsPlayhouse.txt,411,9,45,165,54,25,16,260
8515226_ManuelGonzalesPrada.txt,661,7,94,320,61,46,12,439
8515602_Files2u.txt,611,9,67,274,82,48,21,425
8516384_Newsregistermcminnville.txt,808,21,38,323,90,57,11,481
8517456_kofjaLoka.txt,2022,26,77,725,255,142,60,1182
851834_Tulkarm.txt,2249,31,72,787,252,209,50,1298
851897_ToysWentBerserk.txt,658,6,109,263,73,60,10,406
8519647_Evi.txt,614,13,47,259,72,62,17,410
8522257_PhillipsBrooksHouseAssociation.txt,1447,27,53,683,157,98,33,971
8522903_AlexanderMacklin.txt,645,12,53,218,109,28,14,369
8524376_LoantakaBrook.txt,649,8,81,292,63,42,15,412
8524427_ListOfSignatureCharactersInUrbaniacs.txt,2129,66,32,793,268,194,96,1351
852500_GuinnessBookOfBritishHitSingles.txt,625,14,44,275,65,45,11,396
8525123_ListOfSudaneseSingers.txt,870,4,217,787,10,36,16,849
852514_JuliusPeppers.txt,720,8,90,284,79,44,12,419
852529_MarkEatonbasketball.txt,833,9,92,322,102,55,16,495
8526605_TheWarOfTheWorlds.txt,3310,52,63,1244,427,237,92,2000
8527299_TheGrooveband.txt,387,7,55,197,31,13,4,245
852978_HectorfireEmblem.txt,727,12,60,256,96,57,38,447
8531441_NiclaVassallo.txt,1995,9,221,1383,59,37,16,1495
8533247_MediaResponsesToTheQuranOathControversyOfThe110thUnitedStatesCongress.txt,4492,24,187,1510,688,294,169,2661
8533312_ZadeDirani.txt,791,8,98,348,81,44,9,482
8534694_ListOfQueensAndEmpressesOfFrance.txt,672,18,37,280,59,29,20,388
8534733_MillerSchool.txt,1234,33,37,493,153,105,34,785
8535819_Knoxmusician.txt,599,10,59,255,69,37,14,375
8536948_NationalOrganizationForWomen.txt,1023,28,36,421,128,67,25,641
853697_AlbertOfSaxonyphilosopher.txt,603,13,46,235,65,31,16,347
8538755_MitchellCommunityCollege.txt,853,30,28,440,66,84,2,592
853900_ClaremontMckennaCollege.txt,2462,48,51,1154,243,168,54,1619
853964_StNorbertCollege.txt,594,14,42,289,60,45,10,404
8540212_NkcellDraft.txt,883,15,58,363,121,87,27,598
8540225_Mashpia.txt,632,10,63,357,44,48,19,468
8541302_SirJamesLowther4thBaronet.txt,801,14,57,261,120,45,27,453
8542390_RobertFMurphyanthropologist.txt,988,10,98,469,74,60,15,618
8543160_FsnNorth.txt,907,19,47,410,102,63,28,603
8543439_FullyDifferentialAmplifier.txt,1023,19,53,381,135,118,60,694
8543441_ElvenStar.txt,691,6,115,200,113,54,45,412
8543444_FireSea.txt,861,6,143,242,147,62,52,503
8543472_TheSeventhGate.txt,1150,10,115,344,189,47,56,636
8543497_TransportOnTheGoldCoastQueensland.txt,1020,23,44,471,119,66,28,684
8543543_DenverPoliceOfficerShooting2005.txt,677,11,61,251,116,37,17,421
85441_EnglishLaw.txt,1829,37,49,732,197,154,62,1145
8544532_ContextualDesign.txt,928,24,38,358,146,63,19,586
8544656_20062007MalaysianFloods.txt,892,24,37,342,138,60,22,562
854606_SocietyOfMerchantVenturers.txt,664,9,73,243,79,61,20,403
854611_JacquesGaillot.txt,1493,28,53,494,210,100,45,849
854616_BarclayJamesHarvest.txt,644,14,46,344,54,25,14,437
854777_Lexmark.txt,535,19,28,286,59,27,12,384
854781_EugneAtget.txt,739,12,61,282,82,55,20,439
854992_CasketMatch.txt,610,5,122,210,80,31,17,338
8550032_ListOfAsteroids137301137400.txt,1351,1,1351,345,0,3,0,348
8550050_ListOfAsteroids137401137500.txt,1328,1,1328,325,0,0,0,325
8550063_ListOfAsteroids137501137600.txt,1339,1,1339,333,0,5,0,338
8550754_ListOfAsteroids140401140500.txt,1315,1,1315,314,0,0,0,314
8550774_ListOfAsteroids140601140700.txt,1393,1,1393,391,0,0,0,391
8552206_ListOfAsteroids143601143700.txt,1373,1,1373,370,0,1,0,371
8552217_ListOfAsteroids143701143800.txt,1336,1,1336,335,0,0,0,335
8552252_ListOfAsteroids143901144000.txt,1320,1,1320,318,0,0,0,318
8553360_ListOfAsteroids145701145800.txt,1483,1,1483,464,0,0,0,464
855757_Wsmfm.txt,665,9,73,232,76,62,30,400
855762_WilliamDalrymplehistorian.txt,1737,13,133,660,187,141,58,1046
855764_MassDeathsAndAtrocitiesOfTheTwentiethCentury.txt,982,46,21,354,96,61,17,528
8557697_ListOfGaroCharacters.txt,6997,84,83,2362,1247,372,255,4236
855776_EinsteinhilbertAction.txt,714,50,14,214,116,74,24,428
8559908_NewEnglandPatriotsStrategy.txt,1051,27,38,409,139,69,32,649
8561724_Yashra.txt,1045,32,32,359,168,40,22,589
8563889_PineyGroveAtSouthallsPlantation.txt,631,8,78,322,59,33,7,421
8564309_RaleighSpeedway.txt,911,8,113,335,121,57,23,536
8565031_ListOfAsteroids6460164700.txt,1303,1,1303,302,0,0,0,302
8566056_ChainRuleForKolmogorovComplexity.txt,560,27,20,125,79,46,25,275
8566110_ListOfAsteroids6270162800.txt,1340,1,1340,335,0,4,0,339
8566120_ListOfAsteroids6260162700.txt,1354,1,1354,351,0,0,0,351
8566435_ListOfAsteroids6100161100.txt,1351,1,1351,349,0,0,0,349
8567569_ChampionsForChrist.txt,612,20,30,279,75,31,18,403
856850_OwenFigureskatingFamily.txt,728,16,45,321,77,30,15,443
856852_RichardKruspebernstein.txt,1140,25,45,347,204,59,54,664
856871_TillLindemann.txt,1561,31,50,526,256,93,60,935
856962_BoyanaChurch.txt,434,8,54,148,44,32,16,240
8570841_ListOfAsteroids5780157900.txt,1315,1,1315,313,0,0,0,313
8570870_ListOfAsteroids5750157600.txt,1385,1,1385,376,0,7,0,383
8570882_ListOfAsteroids5740157500.txt,1361,1,1361,357,0,1,0,358
8570886_ListOfAsteroids5730157400.txt,1343,1,1343,340,0,1,0,341
8570896_ListOfAsteroids5720157300.txt,1329,1,1329,328,0,0,0,328
8571533_TheBlueBelt.txt,693,9,77,159,140,29,21,349
8571619_ListOfAsteroids5440154500.txt,1352,1,1352,351,0,0,0,351
857170_CardiacActionPotential.txt,1630,27,60,614,189,151,56,1010
8571972_ListOfAsteroids5290153000.txt,1393,1,1393,381,0,9,0,390
8571983_ListOfAsteroids5280152900.txt,1385,1,1385,383,0,1,0,384
8572642_ListOfAsteroids5090151000.txt,1301,1,1301,300,0,0,0,300
8572705_29thUnitedStatesCongressPoliticalParties.txt,2425,13,186,1438,119,28,13,1598
8574166_2ndConnecticutHeavyArtillery.txt,578,16,36,220,105,32,6,363
8574885_WillHDaly.txt,968,13,74,340,118,76,34,568
8576284_19thUnitedStatesCongressPoliticalParties.txt,2305,15,153,1330,127,30,5,1492
8579235_StThomasCollege.txt,739,21,35,274,86,56,16,432
857973_ContactElectrification.txt,765,8,95,230,115,86,32,463
8584706_ScheduleOnUseYourIllusionTour.txt,1348,9,149,937,0,12,0,949
8586205_WorldWarINavalShipsOfTurkey.txt,651,27,24,266,83,40,13,402
8587310_VariationsOfDodgeball.txt,5146,14,367,1461,919,205,216,2801
8589137_GpaInSingapore.txt,966,22,43,356,106,61,26,549
8589470_TheDirtyJerseyPodcast.txt,1307,28,46,479,171,83,44,777
8589476_WanLaiming.txt,802,13,61,281,122,54,24,481
8590139_2ndDivisionimperialJapaneseArmy.txt,746,20,37,342,62,66,8,478
859022_MorrisWaterMaze.txt,652,10,65,248,87,58,15,408
859051_FordWindsorEngine.txt,2462,45,54,839,297,205,60,1401
8591320_RobertHatton.txt,575,9,63,200,78,15,12,305
859140_UnBufferZoneInCyprus.txt,924,15,61,375,101,44,28,548
8591761_PropagandaDueListOfMembers.txt,619,2,309,398,31,35,8,472
8592384_ZionistFreedomAlliance.txt,750,12,62,301,88,59,16,464
8594567_TheElectricLightOrchestraalbum.txt,724,20,36,411,55,24,8,498
8595037_FictionalSettingOfMadlax.txt,1417,14,101,429,213,119,77,838
8600449_MariaValtorta.txt,719,9,79,238,88,52,20,398
8600489_ErosDay.txt,1897,29,65,800,198,153,64,1215
8600541_DavidKwangshinKim.txt,1112,13,85,404,165,68,49,686
860124_DukesOfMedinaSidonia.txt,646,9,71,309,49,46,8,412
860127_KevinLowe.txt,573,12,47,243,65,37,12,357
860136_TheHonourableSchoolboy.txt,1914,23,83,880,241,74,54,1249
860152_GmFPlatform.txt,668,6,111,203,87,77,24,391
8603740_Paniccomic.txt,861,16,53,346,118,58,31,553
8603793_BurdiehouseParishChurch.txt,1123,17,66,401,160,53,31,645
8608840_Kozzmitude.txt,809,22,36,358,71,46,10,485
86092_Bile.txt,757,11,68,266,98,81,20,465
86100_Brigid.txt,793,17,46,330,103,47,26,506
8610322_EdwardBEvans.txt,589,11,53,270,55,21,5,351
8612031_BishopOfClogherromanCatholic.txt,417,5,83,182,13,17,4,216
861203_MazzyStar.txt,698,16,43,308,72,49,25,454
861224_StarWarsDarkForces.txt,3663,44,83,1507,453,271,139,2370
861238_ListOfNorthCarolinaCountyNameEtymologies.txt,1783,4,445,990,251,59,11,1311
861243_IllinoiswabashCompany.txt,1019,10,101,386,123,75,22,606
8612505_RestaurantsInJordan.txt,1002,11,91,888,3,8,5,904
8615768_NiradNMohapatra.txt,735,10,73,288,102,48,16,454
8615799_IdaCraddock.txt,710,18,39,294,77,48,15,434
861669_Narn.txt,1810,29,62,555,255,181,100,1091
861670_SuperMario64Ds.txt,1630,17,95,559,249,105,65,978
8616946_HavocInHeaven.txt,563,13,43,209,67,56,13,345
8616949_TacomaGuitars.txt,896,27,33,354,123,87,25,589
8617598_PeruvianRetablos.txt,1237,24,51,473,153,100,33,759
8619063_JosAsuncinFlores.txt,565,10,56,209,76,30,15,330
8620156_BostonNeck.txt,655,13,50,265,80,41,18,404
8620177_ForeignPolicyOfTheReaganAdministration.txt,2391,27,88,925,312,171,79,1487
86205_MaelgwnHirApCadwallon.txt,1195,16,74,365,190,82,44,681
8620784_DioceseOfClonfertromanCatholic.txt,888,16,55,319,100,69,16,504
86207_Taliesin.txt,2769,34,81,990,397,168,95,1650
86215_SuspenseradioProgram.txt,1084,13,83,460,127,70,29,686
8621935_MyBoyfriendsJacksonTheresGonnaBeTrouble.txt,626,8,78,224,96,26,24,370
862311_AgeOfMajority.txt,1217,13,93,422,90,59,48,619
862340_LightSwitch.txt,2350,33,71,658,365,243,142,1408
862363_Timotheusgeneral.txt,645,12,53,229,98,27,18,372
862380_UniversityOfAlabamaInHuntsville.txt,972,20,48,452,109,60,14,635
862394_ChryslerLebaron.txt,810,12,67,285,116,73,14,488
862758_NorthAntrimukParliamentConstituency.txt,1296,41,31,630,142,56,34,862
8628528_MermaidTheatreOfNovaScotia.txt,794,15,52,361,93,60,21,535
8631842_ListOfAsteroids4250142600.txt,1489,1,1489,472,0,3,0,475
8631850_ListOfAsteroids4240142500.txt,2040,1,2040,909,0,9,0,918
8632166_ListOfAsteroids4090141000.txt,1325,1,1325,318,0,5,0,323
8632198_EugenRozvan.txt,812,13,62,362,94,31,11,498
8632209_ListOfAsteroids4070140800.txt,1434,1,1434,400,0,18,0,418
8633263_MegiddoRegionalCouncil.txt,576,20,28,254,54,39,9,356
863469_PlymouthVoyager.txt,1801,34,52,683,217,147,54,1101
863470_ChryslerConcorde.txt,719,8,89,274,98,63,16,451
863472_ChryslerVoyager.txt,648,13,49,259,76,47,24,406
863475_EaglePremier.txt,674,8,84,248,98,42,25,413
863483_RafAbingdon.txt,637,21,30,269,79,17,14,379
863491_AtlantaBotanicalGarden.txt,572,10,57,244,60,47,14,365
863505_PlymouthSundance.txt,822,11,74,279,111,77,22,489
8635097_JosIturbiInternationalPianoCompetition.txt,559,22,25,414,12,21,0,447
8635524_ClubObiwanTriad.txt,811,16,50,326,113,47,22,508
8636623_Nakum.txt,608,8,76,219,74,64,11,368
8637667_ListOfAsteroids3710137200.txt,1331,1,1331,331,0,0,0,331
8637675_ListOfAsteroids3700137100.txt,1317,1,1317,316,0,2,0,318
8637711_IHearTheWoodsRustling.txt,257,17,15,54,37,16,12,119
863874_LiberalPartyphilippines.txt,709,11,64,375,65,28,7,475
8638805_LouisCRabaut.txt,599,13,46,202,79,37,9,327
863930_BelfastNorthukParliamentConstituency.txt,1583,41,38,702,160,98,45,1005
8639392_WaterSupplyAndSanitationInElSalvador.txt,1440,40,36,543,166,134,54,897
8639823_RachelShermansociologist.txt,905,18,50,462,63,57,15,597
8639839_CharactersInResidentEvil2.txt,1636,28,58,610,233,87,40,970
8640944_TamilPlaceNamesInMalaysia.txt,575,19,30,228,76,36,11,351
8640947_MissWorld1978.txt,756,168,4,528,45,34,7,614
8641016_WinkTechnologies.txt,685,18,38,279,104,50,18,451
8643843_SpanishenglishTranslationProblems.txt,1098,15,73,392,151,95,50,688
8644937_ListOfAsteroids3340133500.txt,1371,1,1371,358,0,6,0,364
8644955_ListOfAsteroids3310133200.txt,1443,1,1443,437,0,2,0,439
8644959_ListOfAsteroids3300133100.txt,1510,1,1510,490,0,6,0,496
8645378_ListOfAsteroids3190132000.txt,1322,1,1322,323,0,1,0,324
8645379_HeShikai.txt,1950,15,130,699,303,95,90,1187
864558_ZumwaltClassDestroyer.txt,4351,47,92,1571,570,354,193,2688
864567_CubanHipHop.txt,822,19,43,351,109,55,24,539
864578_BatmanSupportingCharacters.txt,4602,36,127,1746,672,335,171,2924
864583_RoyalFlushGang.txt,1343,17,79,535,194,87,36,852
864587_HansLeoHassler.txt,598,13,46,233,64,57,17,371
8645983_ListOfAsteroids3090131000.txt,1524,1,1524,516,0,1,0,517
8646053_ListOfAsteroids3070130800.txt,1716,1,1716,679,0,3,0,682
86475_tan.txt,771,10,77,234,127,27,24,412
8648169_ListOfAsteroids2830128400.txt,1340,1,1340,336,0,4,0,340
8648592_ListOfAsteroids2770127800.txt,1561,1,1561,555,0,1,0,556
8648609_ListOfAsteroids2780127900.txt,1536,1,1536,520,0,2,0,522
8648629_ListOfAsteroids2790128000.txt,1502,1,1502,503,0,2,0,505
8648650_ListOfAsteroids2750127600.txt,1345,1,1345,345,0,1,0,346
8649683_DixieCooneyMartin.txt,1509,16,94,609,240,66,62,977
865032_KannurDistrict.txt,6478,90,71,2676,765,457,164,4062
8653305_ListOfPersonificationsOfDeathInFiction.txt,1199,1,1199,581,112,67,24,784
8653381_Hyperoffice.txt,729,15,48,245,111,67,26,449
865452_SessioncomputerScience.txt,776,16,48,267,111,58,30,466
865466_AdamGoldberg.txt,905,9,100,365,123,67,25,580
865496_Klik.txt,1291,14,92,463,185,115,61,824
8656638_MariekeWijsman.txt,934,9,103,293,109,69,24,495
8658141_VoyagerProjectband.txt,646,10,64,268,70,51,22,411
8658800_ListOfMilitaryAircraftOfTheUnitedStatesnaval.txt,2405,63,38,1457,112,40,23,1632
8659280_AlinMagic.txt,3069,38,80,1023,475,211,163,1872
866118_ReynoldsPrice.txt,778,13,59,358,71,40,13,482
866174_Buckheadatlanta.txt,757,18,42,357,84,46,24,511
866562_TommieAgee.txt,1506,19,79,426,75,43,11,555
866579_TongjiUniversity.txt,871,15,58,425,78,48,19,570
8666487_RalphBacerra.txt,631,15,42,322,55,45,15,437
8666503_ListOfAsteroids2490125000.txt,1471,1,1471,475,0,1,0,476
8669793_SevereTorture.txt,720,13,55,305,80,38,13,436
8670865_2006MadridBarajasInternationalAirportBombing.txt,704,14,50,268,98,30,19,415
8671998_Type021ClassMissileBoat.txt,660,7,94,261,71,65,27,424
867200_GeorgeGee.txt,578,11,52,181,109,25,18,333
867207_GeologyOfHertfordshire.txt,729,17,42,272,84,47,29,432
8674180_AwardsOfChembai.txt,644,16,40,244,77,39,11,371
8675237_LeonCountySheriffsOffice.txt,1106,6,184,553,118,94,17,782
8675661_JimHulton.txt,661,11,60,224,76,23,22,345
867647_BarrickGold.txt,1213,20,60,503,154,61,34,752
867648_ListOfUniversitiesInMexico.txt,640,6,106,515,2,7,0,524
867651_Katherine.txt,674,19,35,420,29,38,6,493
867660_ExterminationOrder.txt,924,14,66,360,132,52,25,569
867671_ImportanceSampling.txt,1346,53,25,501,208,110,44,863
8677790_EnricoElisi.txt,576,10,57,281,51,33,15,380
8678545_TheaWray.txt,585,5,117,217,82,33,11,343
8680091_KarazenpoGoShinjutsu.txt,3243,37,87,1328,425,239,98,2090
8680096_NeighborhoodsOfKalamazoo.txt,2762,70,39,1083,233,168,16,1500
8681811_ListOfCharactersInSeriousSamIi.txt,1499,15,99,525,204,125,96,950
8683972_RichardMique.txt,844,10,84,322,84,52,12,470
8685132_EmpressHugaoWei.txt,631,5,126,242,114,22,23,401
8685505_FeminismInIndia.txt,1016,9,112,449,105,111,21,686
8686201_TheStonesOfNomuru.txt,595,9,66,216,81,52,24,373
8686213_ListOfItemsInKyaDarkLineage.txt,634,33,19,248,101,53,12,414
8686239_EmpressLiuJingyan.txt,1081,9,120,442,157,40,40,679
868654_KarelKoeluh.txt,919,12,76,274,117,95,32,518
868738_BurgundianSchool.txt,1741,26,66,636,192,159,74,1061
8688412_SpanishTranslationInTheGoldenAge.txt,798,7,114,317,98,43,20,478
8689476_TheFrozenDeep.txt,931,6,155,363,107,55,27,552
8691684_TheThingspongebobSquarepants.txt,889,10,88,330,127,54,48,559
8692117_ArchitectureOfMetropolitanDetroit.txt,2305,32,72,1206,208,158,30,1602
8693836_ByronMCutcheon.txt,957,13,73,381,120,34,10,545
8693867_EdwardSchroederPrior.txt,3704,114,32,1536,419,195,109,2259
869391_WilliamFairbairn.txt,604,13,46,243,71,27,11,352
8697115_DaveEdler.txt,606,18,33,238,69,44,12,363
869744_QueenSofaOfSpain.txt,901,22,40,407,85,42,21,555
8697644_DucksOfTheWest.txt,1047,13,80,378,159,32,55,624
8698173_ListOfAsteroids2010120200.txt,1516,1,1516,509,0,4,0,513
8698177_ListOfAsteroids2000120100.txt,1574,1,1574,559,0,3,0,562
8698183_OperationCatsoperationPop.txt,1669,16,104,541,270,46,74,931
8698253_StephenJaffe.txt,555,5,111,306,34,15,2,357
869833_Kcaltv.txt,3166,44,71,1318,362,197,104,1981
8699302_ListOfAsteroids1600116100.txt,1359,1,1359,384,0,10,0,394
8700368_2007AustralianIncumbents.txt,640,15,42,446,0,9,1,456
8700412_HinduConstellation.txt,16630,78,213,4898,2093,1103,708,8802
8701544_Lydbrook.txt,8099,69,117,3042,1064,417,213,4736
8701568_LydbrookChurchGuide.txt,1368,20,68,514,185,64,30,793
8703668_ListOfLollywoodFilms.txt,473,61,7,214,3,3,1,221
870493_SpaceAce.txt,1180,19,62,486,163,58,50,757
8705885_HeavyWeathertv.txt,2016,20,100,797,217,124,78,1216
870619_HalHolbrook.txt,609,15,40,258,69,22,13,362
8706317_HayleyVaughan.txt,2343,26,90,848,440,97,78,1463
8707438_RobertR.txt,668,7,95,219,110,47,35,411
870847_KageraRegion.txt,773,12,64,341,94,42,14,491
870935_WashingtonJournal.txt,712,11,64,259,102,65,31,457
870946_TheBourneSupremacyfilm.txt,2623,30,87,950,441,116,112,1619
870949_GeneMauch.txt,753,11,68,293,87,40,21,441
8710270_JapaneseRegionalCuisine.txt,1443,14,103,601,186,130,55,972
8711384_AkonDiscography.txt,889,10,88,628,38,18,13,697
8713532_Tekufah.txt,637,6,106,243,86,34,13,376
8713546_GeneralMotorsProvingGrounds.txt,900,22,40,387,130,60,21,598
8713989_CascataDelleMarmore.txt,749,13,57,257,99,43,17,416
8714030_ReverandRobertCertain.txt,1015,9,112,419,112,53,11,595
8714658_Guidefilm.txt,828,7,118,252,135,44,46,477
8714702_MariaVullo.txt,625,9,69,301,61,28,7,397
871575_Avalon2001Film.txt,1176,29,40,466,153,116,34,769
871639_AvenueOfTheSaints.txt,952,19,50,440,87,36,9,572
8716834_StorylinesOfShortlandStreet1996.txt,1023,23,44,521,148,24,44,737
8717214_DouglasDarby.txt,963,7,137,470,93,44,9,616
8717999_DeAmoreandreasCapellanus.txt,1216,19,64,423,164,89,51,727
87179_ClosedcircuitTelevision.txt,2396,39,61,865,379,174,105,1523
8718042_StorylinesOfShortlandStreet2001.txt,1950,32,60,752,375,71,85,1283
87187_EuropeanCourtOfJustice.txt,2636,40,65,883,320,183,85,1471
87188_CourtOfFirstInstance.txt,795,21,37,293,91,56,14,454
8719092_GildersleeveMountain.txt,2756,41,67,1046,423,234,102,1805
871923_Kismetmusical.txt,2344,33,71,786,370,99,61,1316
8719518_IanParkerpsychologist.txt,1943,47,41,854,191,127,44,1216
87198_JudicialFunctionsOfTheHouseOfLords.txt,4977,52,95,1728,672,276,205,2881
87200_WilliamPerryamericanFootball.txt,837,13,64,337,102,57,13,509
87201_Boggle.txt,1075,15,71,391,153,82,52,678
8722324_SethraLavode.txt,824,11,74,320,114,46,36,516
8723434_JillMarieLandis.txt,811,13,62,507,33,27,10,577
8723772_AudreLordeProject.txt,1400,46,30,690,144,95,25,954
8723835_BatmanEmblem.txt,578,9,64,215,61,33,21,330
8725592_Moonsound.txt,715,18,39,323,90,46,14,473
87258_Gsg9.txt,1654,24,68,638,200,106,51,995
87275_Sigurd.txt,1547,30,51,611,220,71,41,943
872793_EdgarBroughtonBand.txt,1014,17,59,416,121,67,26,630
872798_TrueCrimeStreetsOfLa.txt,2862,43,66,1183,401,154,84,1822
87284_Ingsoc.txt,1107,21,52,350,156,96,52,654
8728931_IchikawaDanjrI.txt,727,13,55,277,80,48,34,439
8729275_LotsWife.txt,634,19,33,297,87,36,16,436
8729302_StorylinesOfShortlandStreet2004.txt,1755,27,65,755,297,70,66,1188
873007_DeathsheadHawkmoth.txt,688,17,40,249,78,67,23,417
873021_Presenttime.txt,634,14,45,195,99,45,39,378
873028_DissolutionOfCzechoslovakia.txt,1296,23,56,426,168,116,68,778
873029_ToWongFooThanksForEverythingJulieNewmar.txt,873,13,67,362,106,42,30,540
8733299_TheMaskcourageTheCowardlyDog.txt,801,9,89,262,132,40,25,459
8734349_SleafordCastle.txt,865,13,66,339,84,50,29,502
8734358_ZoidsGenesisCharacters.txt,1747,31,56,590,279,142,71,1082
8734771_Mockingbird1980Novel.txt,651,11,59,217,109,38,26,390
8735496_QuinnLife.txt,1227,51,24,509,149,106,28,792
8736584_FrankWortman.txt,692,14,49,285,89,36,18,428
8736604_PawnlessChessEndgames.txt,1569,36,43,500,202,111,71,884
873719_AxelHeibergIsland.txt,1405,22,63,470,194,143,59,866
8740932_VickiLewisThompson.txt,935,7,133,574,17,12,3,606
874101_ColvilleIndianReservation.txt,1619,31,52,656,197,107,47,1007
874109_ListOfZipCodesInConnecticut.txt,1429,1,1429,525,0,31,0,556
874169_CharlotteDundas.txt,591,9,65,216,77,47,14,354
874171_Rosedisambiguation.txt,1150,12,95,619,76,79,13,787
874178_ListOfZipCodesInMaryland.txt,2882,18,160,1443,8,33,2,1486
874182_AustraliaunitedStatesFreeTradeAgreement.txt,4184,111,37,1565,504,341,109,2519
8742098_OrffsCarminaBuranaInPopularCulture.txt,1320,6,220,650,113,81,24,868
8743192_SugarBlue.txt,706,11,64,286,96,35,14,431
8744271_VidalMTrevio.txt,1043,23,45,436,120,62,26,644
8744272_CanalsInCheshire.txt,1070,27,39,492,96,63,27,678
8744285_ListOfRevocationsOfAppointmentsToTheOrderOfTheBritishEmpire.txt,1506,2,753,494,362,19,0,875
8745307_DioceseOfLinz.txt,2513,11,228,873,240,193,73,1379
8745352_Wing.txt,1320,17,77,568,127,105,46,846
8746854_DaiPersonalComputer.txt,608,8,76,247,56,58,26,387
874810_ListOfPeopleByNameSaosau.txt,608,6,101,425,6,48,2,481
8748620_Conocybe.txt,720,7,102,535,87,23,6,651
8748632_TurnerSuspensionBicycles.txt,1336,60,22,594,178,81,21,874
8749685_AlczarOfSegovia.txt,681,11,61,226,78,55,26,385
875260_HowDemocraticIsTheAmericanConstitution.txt,1697,38,44,602,214,201,53,1070
8755230_CharactersInDevilMayCry.txt,2072,66,31,693,322,121,82,1218
8757356_EdwardAIrving.txt,668,11,60,250,95,35,8,388
8757363_BernardTaylorBaronTaylorOfMansfield.txt,635,11,57,260,73,26,13,372
87577_Jas39Gripen.txt,1348,22,61,492,201,89,43,825
8758450_ArtInstituteOfChicago.txt,846,14,60,366,88,60,18,532
8758454_SimeonLord.txt,612,7,87,209,86,38,18,351
8758514_FloridaAflcio.txt,650,13,50,392,36,32,3,463
875897_JustinWilson.txt,764,16,47,311,89,39,17,456
875898_JumpStartcomic.txt,1665,48,34,572,266,113,80,1031
8761118_FreeAssociationOfGermanTradeUnions.txt,971,9,107,314,131,70,38,553
8762164_CollgeSaintjosephDeHull.txt,676,14,48,203,91,73,25,392
87624_MickeyRooney.txt,2208,25,88,1144,115,62,23,1344
8762849_PolyvalenteDeLrablire.txt,580,17,34,213,76,46,16,351
876344_NapoleonSymphony.txt,1561,24,65,464,235,119,61,879
876348_StoreBrand.txt,582,6,97,352,40,32,9,433
876351_AleksandrDanilovichAleksandrov.txt,895,15,59,414,71,45,22,552
87635_ThirdAnglodutchWar.txt,575,7,82,196,81,45,18,340
876383_JeanVianney.txt,1046,21,49,319,160,79,49,607
876456_ImmanuelJakobovits.txt,790,14,56,308,96,54,16,474
8767180_HowardPayneUniversitySchoolOfMusicAndFineArts.txt,879,69,12,435,76,84,12,607
877041_GideonJohnsonPillow.txt,1204,15,80,466,152,61,32,711
8771649_GasCheck.txt,694,8,86,263,102,67,34,466
8772692_4ColorRebellion.txt,885,13,68,344,122,69,25,560
877431_JoaqunAndjar.txt,1298,10,129,297,108,42,21,468
877440_ListOfIndonesianMonarchies.txt,9598,22,436,4518,356,296,117,5287
877441_GmLsEngine.txt,2068,39,53,808,276,140,54,1278
8774903_JamieWhite.txt,696,12,58,273,94,25,23,415
8776828_FundaoGetlioVargas.txt,922,17,54,537,42,61,18,658
8776837_WorldHeritageSitesInScotland.txt,671,16,41,300,68,57,7,432
8776885_MckenzieWark.txt,839,16,52,358,83,77,17,535
8777992_ZhangJigang.txt,667,22,30,254,84,54,16,408
8778629_GpsModernization.txt,1162,29,40,457,158,120,32,767
8782353_Velocitycomics.txt,1237,14,88,432,180,76,49,737
8783397_PippaCross.txt,777,13,59,240,130,57,51,478
8783456_ReferencesToPolycephalyInPopularCulture.txt,632,10,63,264,66,65,11,406
8783_DylanThomas.txt,1666,34,49,667,188,105,46,1006
878523_MantoTshabalalamsimang.txt,758,11,68,270,105,51,19,445
878533_Notetab.txt,590,19,31,244,74,53,23,394
878537_Carrack.txt,861,16,53,295,109,70,29,503
878544_CentennialOlympicPark.txt,709,9,78,292,86,49,14,441
8785576_ListOfGermanGivenNames.txt,5266,56,94,5259,1,0,0,5260
8785697_ClanSpens.txt,750,15,50,289,96,33,12,430
8786784_BurraKatha.txt,625,14,44,263,94,46,24,427
8787_MarquisDeSade.txt,2712,36,75,963,377,160,81,1581
8788462_BarnacleBillsong.txt,458,18,25,212,40,17,14,283
8788933_RobOliphant.txt,649,16,40,329,63,29,7,428
8789616_FragileyesAlbum.txt,890,21,42,409,102,44,18,573
879184_HorizonsEmpireOfIstaria.txt,2818,59,47,1014,462,179,109,1764
8791_DennisHopper.txt,1704,22,77,781,128,104,45,1058
8792154_Rautalanka.txt,861,20,43,326,116,109,42,593
8794419_ListOfOpenAccessProjects.txt,1193,25,47,704,66,110,12,892
8794432_Trappednovel.txt,938,9,104,347,120,88,28,583
8795_DetroitRedWings.txt,4917,97,50,2070,508,265,110,2953
879606_StonesRiver.txt,698,7,99,269,69,55,33,426
879611_NormanDavies.txt,1389,17,81,612,101,89,33,835
8796187_WilliamSledd.txt,1545,24,64,527,262,89,70,948
879631_NetherEdge.txt,636,11,57,281,60,47,17,405
879635_Banyancompany.txt,1910,25,76,702,292,157,90,1241
879650_Gm60degreeV6Engine.txt,2099,56,37,848,233,131,35,1247
8796_Demiurge.txt,3969,64,62,1357,503,282,157,2299
8797640_Logrosn.txt,848,13,65,297,81,76,20,474
8797641_TammyCochran.txt,941,12,78,273,152,74,41,540
8798777_WefunkRadio.txt,605,11,55,214,87,45,31,377
8802752_MohammadKarami.txt,744,3,248,202,105,52,38,397
8803094_InversionInPostcolonialTheory.txt,635,14,45,238,67,70,15,390
880313_CellarDoor.txt,1312,22,59,490,165,113,55,823
880336_BobbysWorld.txt,1190,18,66,742,64,46,19,871
880401_ElginCityFc.txt,1454,34,42,561,144,72,32,809
8805379_HarvardArmyAirfield.txt,589,16,36,280,57,38,10,385
8806025_Botnang.txt,1242,39,31,463,141,85,46,735
880702_GeelyAutomobile.txt,609,20,30,265,61,36,25,387
880716_VolkswagenGroupChina.txt,1134,33,34,505,110,96,24,735
880721_Expedition9.txt,811,23,35,422,67,31,9,529
8807510_DeVirisIllustribuspetrarch.txt,834,11,75,421,64,45,14,544
8814052_WhiteHouseConferenceOnAging.txt,622,10,62,252,73,47,10,382
881405_Cheburashka.txt,927,19,48,345,109,74,23,551
8814061_StPaulsPresbyterianChurchGlaceBay.txt,888,19,46,361,116,55,16,548
881408_SommeRiver.txt,695,14,49,242,73,56,24,395
8815184_TheScorpioKiller.txt,735,9,81,229,130,30,34,423
8815987_Kikoku.txt,597,4,149,254,81,18,18,371
881793_ChteauDeMarly.txt,883,15,58,302,129,62,29,522
881837_GeorgeSudarshan.txt,607,15,40,274,57,36,16,383
881866_JaguarAjv8Engine.txt,1012,37,27,420,105,76,17,618
881897_TheWesternStar.txt,1428,18,79,610,162,49,28,849
881901_CeilingFan.txt,2297,32,71,811,307,217,110,1445
881905_JimEdmonds.txt,771,13,59,297,91,58,27,473
8822840_DownHolly.txt,752,16,47,349,67,83,22,521
8824747_RobertKeyes.txt,796,10,79,249,134,24,30,437
882510_DannyBlanchflower.txt,876,7,125,261,131,48,35,475
882574_AnakTombNo3.txt,558,9,62,218,78,28,16,340
8825751_StPetersBoysSchoolPanchganiMaharastra.txt,945,106,8,501,98,20,8,627
882947_Attachmate.txt,1019,27,37,434,138,43,21,636
882971_KordellStewart.txt,1856,22,84,679,259,94,63,1095
882974_Chambry.txt,741,21,35,278,76,74,21,449
8831230_FremontBoundaryLineRedrawingControversy.txt,664,8,83,235,100,51,25,411
88325_ListOfTowns.txt,971,96,10,857,13,13,7,890
88326_FerrisBuellersDayOff.txt,3127,32,97,1302,413,136,97,1948
88335_Gullveig.txt,1217,24,50,415,151,93,59,718
88344_LuigiGalvani.txt,648,14,46,244,92,40,20,396
883599_Icehouseband.txt,1021,29,35,454,86,61,27,628
8836029_HurricaneIgnacio2003.txt,1386,16,86,517,173,111,39,840
8837068_IsUnderground.txt,661,3,220,200,109,45,24,378
8837120_CapitalAreaMetropolitanPlanningOrganization.txt,1557,38,40,717,176,82,31,1006
88374_Flensburg.txt,4054,74,54,1707,426,340,140,2613
88375_VideoArcade.txt,1047,17,61,350,164,94,72,680
88380_BoardingSchool.txt,3580,43,83,1466,427,279,118,2290
88382_InstitutionalRevolutionaryParty.txt,1368,17,80,507,157,121,47,832
88384_CologneCathedral.txt,1090,19,57,367,141,108,28,644
8840378_HarmonicGeneration.txt,786,14,56,259,135,86,33,513
8840384_WiederauTransmitter.txt,785,3,261,288,103,43,23,457
884058_LandRoverDiscovery.txt,2928,30,97,1017,424,326,101,1868
884068_RangeRover.txt,2201,30,73,828,295,214,83,1420
884080_LandRoverseriesdefender.txt,8959,96,93,2909,1293,952,344,5498
8841124_ThamesdownTransport.txt,678,22,30,298,86,37,18,439
8841503_Artymiw.txt,931,6,155,458,86,42,17,603
8842165_SubaruImprezaRb5.txt,940,27,34,396,101,96,32,625
8842227_AksuDeresi.txt,641,11,58,250,84,47,19,400
8842553_AdolescentSexuality.txt,2914,37,78,860,444,338,157,1799
8844284_BattleOfMontevideo1807.txt,1012,14,72,377,120,77,22,596
8845940_WardChurchillMisconductIssues.txt,4189,71,59,1588,629,231,153,2601
8846536_LordFamilyoneLifeToLive.txt,2053,22,93,688,413,104,74,1279
8848653_Termon.txt,672,16,42,320,83,39,11,453
8850233_DardHunter.txt,598,13,46,241,82,25,7,355
885066_BlackstoneGroup.txt,1057,25,42,529,111,65,14,719
885071_UrsinusCollege.txt,1584,22,72,721,159,100,24,1004
8850_December21.txt,1820,6,303,983,67,68,11,1129
885126_SafewayInc.txt,1932,34,56,841,218,116,43,1218
885151_WashingtonNationals.txt,3733,49,76,1605,374,232,78,2289
885152_SeaSlugMissile.txt,884,15,58,363,130,58,25,576
885179_StevePeregrinTook.txt,760,14,54,324,91,38,24,477
8852016_1993Topps.txt,653,14,46,283,65,30,3,381
8852_December13.txt,2236,6,372,1238,85,92,8,1423
8853149_PatrickNee.txt,692,13,53,240,102,35,17,394
8854194_AmateurRadioHistory.txt,1268,22,57,557,161,66,24,808
8854246_OrangeStreetMusicClub.txt,799,18,44,329,106,58,26,519
8854661_JudahBenBathyra.txt,586,5,117,225,80,33,34,372
8854662_PoreFormingToxins.txt,895,23,38,314,112,95,31,552
8855_DrSeuss.txt,5376,70,76,2500,467,346,137,3450
8856308_GeorgeAMalcolm.txt,1077,20,53,385,133,49,30,597
8856810_AlanHarperarchbishop.txt,913,13,70,333,113,47,35,528
885804_PsMaidOfTheLoch.txt,589,7,84,190,82,42,19,333
885805_SynodOfPistoia.txt,656,6,109,219,78,43,22,362
8862328_AllEyezOnMe.txt,645,13,49,360,37,30,9,436
8865126_ProfessionalMurderMusic.txt,654,9,72,289,75,45,27,436
8866722_NorthwoodsBand.txt,707,11,64,422,66,40,5,533
8867794_NewYorkCityTransitFares.txt,675,10,67,254,66,37,19,376
8867838_AliciaKozameh.txt,999,8,124,482,86,75,15,658
8869555_ListOfDoughnutVarieties.txt,1080,10,108,518,119,99,53,789
887241_UnitedForPeaceAndJustice.txt,1648,24,68,650,186,137,48,1021
887343_AustralianAntiterrorismLegislation2004.txt,1420,29,48,499,207,77,31,814
887351_FloydLaughren.txt,617,12,51,235,87,32,22,376
8875029_JanetKuypers.txt,639,5,127,290,61,34,18,403
88768_PentatonicScale.txt,1313,21,62,439,147,190,51,827
8877150_SocietalAttitudesTowardsAbortion.txt,818,8,102,218,117,50,68,453
88772_Improvisation.txt,1464,33,44,568,195,125,61,949
88779_VernicaCastro.txt,804,16,50,401,60,26,10,497
887989_TurtlecreekTownshipWarrenCountyOhio.txt,735,12,61,313,71,35,8,427
8882014_MissUsa2001.txt,732,15,48,445,46,21,5,517
888413_Szombathely.txt,1794,35,51,640,258,118,47,1063
8884242_WhenYouGonnaLearn.txt,1343,55,24,679,79,83,31,872
889153_Bouncerdoorman.txt,988,16,61,333,134,96,77,640
8891802_Musicplustvcom.txt,713,15,47,373,74,54,8,509
889446_GilbyClarke.txt,681,15,45,315,76,33,13,437
889449_78thInfantryDivisionunitedStates.txt,2453,52,47,1142,202,166,21,1531
8895197_HighSchoolWrestlingRules.txt,962,43,22,353,142,45,23,563
8899472_NationalSecurityLeague.txt,1721,20,86,794,153,124,38,1109
8899688_JubeiYamada.txt,1009,13,77,332,164,51,63,610
8900371_ReligiousViewsOnMasturbation.txt,3311,51,64,1063,468,317,137,1985
8902654_HistoryOfWellsFargo.txt,5243,56,93,2094,652,361,148,3255
890509_Matins.txt,3712,44,84,1212,469,256,147,2084
890518_HalifaxMetroCentre.txt,566,11,51,330,45,35,7,417
890528_Slidebaseball.txt,842,10,84,205,149,72,58,484
890593_LittleMiamiRailroad.txt,773,12,64,325,83,29,17,454
890669_WeimarTimeline.txt,2017,21,96,1060,162,54,30,1306
890674_MaryBaldwinCollege.txt,1045,24,43,488,110,70,16,684
8909530_Pokolgp.txt,802,15,53,292,89,101,18,500
8910629_LaheyClinicHospital.txt,624,9,69,291,67,42,16,416
8911297_RabbleOfDevilkin.txt,1437,21,68,477,212,130,86,905
891400_StephenHawes.txt,589,4,147,210,75,25,18,328
891682_GavvyCravath.txt,1332,12,111,428,167,86,47,728
891686_JensenInterceptor.txt,841,14,60,316,102,61,31,510
891688_Nakedbook.txt,684,20,34,264,82,47,15,408
891789_MikeMalloy.txt,1586,28,56,751,175,98,54,1078
8917918_LondonBusesRoute109.txt,1408,23,61,585,140,64,21,810
8919436_PseudsCorner.txt,566,19,29,193,77,29,21,320
8920127_MarvBreeding.txt,594,10,59,249,75,20,11,355
8926668_Chionea.txt,859,17,50,423,113,30,29,595
892771_BriarPatchstarTrek.txt,611,7,87,214,85,58,21,378
892775_MilesFranklinAward.txt,1341,29,46,833,41,19,6,899
8927793_FortEustisMilitaryRailroad.txt,2639,47,56,1002,336,192,57,1587
892783_FinalFantasyUnlimited.txt,1376,28,49,492,207,82,50,831
8928251_600am700am24Season6.txt,1259,13,96,429,224,50,46,749
892876_WarOfTheLeagueOfCambrai.txt,3657,38,96,1263,561,215,127,2166
8930001_SchroonLake.txt,1151,19,60,512,118,58,15,703
8930317_DjNoodles.txt,909,5,181,625,32,48,8,713
8931001_MaximumOverdrive.txt,1652,33,50,637,229,109,47,1022
8933286_ActorsAnalects.txt,1185,15,79,385,146,83,64,678
8934260_Virtualbox.txt,595,21,28,228,83,51,21,383
8934358_AugustineHerrman.txt,1512,16,94,594,186,74,48,902
8934365_YolandaOfVianden.txt,710,7,101,252,89,43,28,412
893509_PitStop.txt,1144,12,95,429,144,71,47,691
893512_ServetteFc.txt,658,18,36,218,80,51,15,364
8935813_TheAirAdventuresOfJimmieAllen.txt,1745,17,102,676,234,105,51,1066
8939132_MauriceLevytheWire.txt,586,8,73,211,110,27,21,369
8940953_OperationFlavoroperationKiss.txt,776,12,64,274,114,20,33,441
8941956_SvenCoop.txt,1539,42,36,560,227,131,67,985
8941958_1100am1200pm24Season6.txt,629,8,78,218,113,17,33,381
8941995_HampshireAndHampdenCanal.txt,632,7,90,244,67,49,15,375
8942452_TheCaseIsAltered.txt,717,12,59,281,91,34,21,427
8942515_LeeLorch.txt,808,18,44,301,103,48,21,473
89425_ArrowsImpossibilityTheorem.txt,2198,38,57,713,311,197,109,1330
89444_FiddlerOnTheRoof.txt,3387,49,69,1316,473,145,101,2035
894495_HolyDoor.txt,870,6,145,238,145,45,46,474
8945317_Dancelife.txt,972,22,44,339,147,58,31,575
89466_TheBroads.txt,1674,42,39,812,170,98,38,1118
8947498_BrandonDeshazer.txt,606,22,27,301,72,35,8,416
8948502_TheSwooseb17.txt,1006,15,67,401,118,66,22,607
8948605_Sterlingband.txt,693,19,36,235,85,51,26,397
894966_Boybook.txt,860,16,53,299,106,66,26,497
894970_JamesAndTheGiantPeach.txt,747,7,106,268,88,53,20,429
894975_Malal.txt,891,15,59,333,119,53,30,535
895046_ListOfChristmasNumberOneSingles.txt,641,4,160,323,26,26,12,387
895051_JohnJayHooker.txt,2359,20,117,878,305,180,90,1453
895060_Khorne.txt,838,14,59,302,117,62,42,523
8951926_WillyPuchner.txt,695,15,46,367,40,30,8,445
8953380_AuditorySceneAnalysis.txt,726,12,60,227,118,86,20,451
895690_MichelleWilliamsactress.txt,663,10,66,304,64,30,15,413
895693_BuickRendezvous.txt,941,24,39,363,119,103,30,615
8957275_WillemAdriaanVanDerStel.txt,649,19,34,263,92,26,8,389
895752_EysteinnBeli.txt,1032,19,54,363,184,54,33,634
895763_KaseyKeller.txt,880,11,80,333,93,57,16,499
8958419_TexasAmUniversityLibraries.txt,888,13,68,427,83,61,13,584
8958422_LarinParaske.txt,601,10,60,211,92,38,17,358
896034_SkSlaviaPraha.txt,627,20,31,258,57,51,20,386
896046_CoffinAffair.txt,623,15,41,246,87,37,8,378
896061_DawnStaley.txt,741,16,46,327,76,29,6,438
8960624_FantasticChildrenCharacters.txt,2781,33,84,743,480,154,160,1537
896063_NamekSaga.txt,2119,26,81,793,295,83,117,1288
896082_AlrekAndEirk.txt,1333,11,121,515,191,69,55,830
8962885_SamuelFSnively.txt,751,12,62,263,97,36,31,427
8965074_TerenceMOsullivanJr.txt,1718,26,66,762,194,119,45,1120
8967165_MultibodySystem.txt,1517,34,44,572,186,151,44,953
8967316_ListOfSongsProducedByJimmyJamTerryLewis.txt,2039,26,78,1415,31,5,21,1472
8969401_ListOfLawFirms.txt,685,3,228,423,2,1,0,426
8969452_ListOfCharactersInKevinAndKell.txt,8683,78,111,2552,1476,502,466,4996
8970852_WinnersAndRunnerupsInTheLegislativeElectionsOfNepal1994And1999.txt,25,4,6,10,2,1,0,13
897118_Switchgrass.txt,658,14,47,289,73,48,17,427
897145_Guqin.txt,8421,98,85,3397,956,635,346,5334
897148_Guzheng.txt,1058,20,52,470,117,89,27,703
8971585_CathedralOfStPeterAndStPaulNantes.txt,975,21,46,340,94,79,17,530
897229_DeanJonescricketer.txt,623,13,47,212,84,43,21,360
8978138_CLFranklin.txt,590,9,65,263,62,25,14,364
8978142_595thSpaceGroup.txt,610,13,46,330,62,45,7,444
8978514_DentistryThroughoutTheWorld.txt,2368,46,51,957,289,218,51,1515
897895_TheAmazingRace3.txt,2523,45,56,1227,288,90,42,1647
8979301_RichardECavazos.txt,1273,22,57,539,152,81,22,794
897937_GreatJubilee.txt,2457,31,79,950,248,129,62,1389
89794_TomDenningBaronDenning.txt,2563,24,106,866,351,167,90,1474
89801_SucculentPlant.txt,910,8,113,722,39,35,15,811
89807_BoyScout.txt,2159,33,65,881,266,181,75,1403
8981483_MinorCharactersOnTheRedGreenShow.txt,1662,44,37,569,259,113,98,1039
898237_Siryn.txt,1271,22,57,450,182,92,52,776
898240_KarakuwaMiyagi.txt,1221,25,48,448,125,98,17,688
898259_AsafaPowell.txt,640,23,27,234,86,32,20,372
898319_Scylding.txt,667,9,74,229,86,68,25,408
898330_Copplia.txt,839,19,44,333,101,61,20,515
8984838_Infinitygame.txt,2892,34,85,943,399,330,111,1783
89857_AreYouBeingServed.txt,1250,22,56,567,128,76,43,814
8986134_SportInThePublicSchoolsAssociation.txt,2861,65,44,1360,138,58,26,1582
89862_Corinthiancomics.txt,1482,16,92,469,222,111,64,866
89869_CircularSaw.txt,659,16,41,235,121,63,35,454
8987340_VariationalMonteCarlo.txt,782,12,65,295,89,73,36,493
8988421_RobertFox19thcenturyAfricanamericanCivilRightsActivist.txt,619,10,61,201,107,47,22,377
8989137_StandardVanguard.txt,813,24,33,290,121,70,15,496
8991278_BattlestarGalacticaTerminology.txt,811,9,90,340,99,67,28,534
899360_KarlBlossfeldt.txt,632,9,70,222,84,43,18,367
899361_RichardMSherman.txt,1669,34,49,808,145,83,45,1081
899362_RobertBSherman.txt,2229,44,50,1056,219,100,53,1428
899386_Prosumer.txt,1089,16,68,403,145,106,43,697
899387_Afro.txt,1301,17,76,539,145,87,51,822
899405_ListOfZipCodesInTheMilitary.txt,1960,10,196,1322,18,12,1,1353
899406_StrongArmsOfTheMa.txt,1537,13,118,488,255,79,68,890
899407_ImperialRegaliaOfJapan.txt,1006,17,59,373,121,57,25,576
899410_MiamiConservancyDistrict.txt,584,15,38,240,61,36,9,346
8994603_JapaneseAircraftCarrierRyuho.txt,792,13,60,307,91,35,12,445
8994950_RoadsOfMiddleearth.txt,860,18,47,348,85,53,20,506
8996096_7thOhioInfantry.txt,1923,25,76,703,244,97,52,1096
8997808_JianLi.txt,780,8,97,311,91,56,27,485
8997864_Vigilantnovel.txt,958,12,79,330,131,79,34,574
8997867_HensolCastle.txt,1328,15,88,540,174,57,21,792
900089_BirdsOpening.txt,668,13,51,255,75,47,34,411
9001149_FokkerFviii.txt,628,13,48,231,103,33,11,378
9002342_ReisnerPapyrus.txt,926,27,34,312,109,82,24,527
9002564_KellerBreland.txt,997,14,71,421,122,69,20,632
9003375_PortRoadPubCrawl.txt,1079,14,77,475,139,55,32,701
9004511_ListOfAsteroids1410114200.txt,1415,1,1415,430,0,15,0,445
900453_GeneralOrder111862.txt,792,19,41,276,122,46,15,459
900454_FiscalImbalanceInCanada.txt,646,9,71,216,83,77,22,398
900466_ListOfAmphibiousWarfareShips.txt,851,24,35,641,13,44,1,699
9005519_BureauOfEntomology.txt,994,16,62,360,159,60,14,593
9007724_AleksisDreimanis.txt,582,8,72,271,45,17,2,335
9008058_ChanceFry.txt,559,7,79,208,67,20,9,304
9008774_ListOfAsteroids1090111000.txt,1841,1,1841,790,0,22,0,812
9008784_ListOfAsteroids1080110900.txt,1502,1,1502,526,0,10,0,536
9008795_ListOfAsteroids1070110800.txt,1591,1,1591,612,0,5,0,617
9008812_ListOfAsteroids1050110600.txt,1583,1,1583,595,0,4,0,599
9008825_ListOfAsteroids1030110400.txt,1588,1,1588,625,0,7,0,632
9008832_ListOfAsteroids1020110300.txt,1659,1,1659,662,0,16,0,678
9008840_ListOfAsteroids1010110200.txt,1551,1,1551,587,0,4,0,591
9008846_ListOfAsteroids1000110100.txt,1580,1,1580,608,0,5,0,613
9009212_ListOfAsteroids80018100.txt,1659,1,1659,667,0,8,0,675
9009959_BigDismal.txt,861,20,43,277,122,73,40,512
9009961_IkPegasi.txt,804,15,53,297,88,79,19,483
901091_SodiumTripolyphosphate.txt,605,10,60,221,88,64,34,407
9011018_ListOfAsteroids20012100.txt,1670,1,1670,676,0,12,0,688
9014240_ListOfSongsProducedByDallasAustin.txt,689,45,15,500,8,2,13,523
9015427_TheAntlers.txt,897,13,69,304,133,59,22,518
901543_PetriaThomas.txt,613,11,55,214,70,24,28,336
901562_CharlesWilliamFerdinandDukeOfBrunswick.txt,1310,22,59,437,166,91,31,725
901578_SomeoneToWatchOverMevoyagerEpisode.txt,773,7,110,217,131,55,22,425
9016877_SapanDesai.txt,1024,17,60,514,87,62,10,673
9018743_ListOfProgramsBroadcastByPublicBroadcastingService.txt,614,11,55,364,17,19,16,416
9021926_KenKalmusky.txt,638,14,45,325,69,16,4,414
9021937_DonaldTrumpInTheMedia.txt,697,16,43,275,81,39,16,411
9022379_CircleellipseProblem.txt,1422,37,38,464,208,117,69,858
902272_ExclusiveBrethren.txt,5601,82,68,2107,742,364,192,3405
9024997_Jska.txt,760,18,42,321,82,89,35,527
9026138_BiancabellaAndTheSnake.txt,843,11,76,225,162,41,28,456
902643_Pipeweed.txt,731,10,73,210,115,49,42,416
902659_MuscularDystrophyAssociation.txt,553,10,55,260,68,47,12,387
9029454_EvelioPerez.txt,571,6,95,213,84,31,19,347
9031558_AnanianCulture.txt,573,10,57,244,67,46,13,370
9032725_MckeoughSupply.txt,533,19,28,252,61,16,11,340
903297_Foxfire1996Film.txt,1126,16,70,390,180,52,35,657
9033433_GaspareMutolo.txt,2008,27,74,746,296,108,38,1188
9033822_TemplarsParkScoutCampsite.txt,793,12,66,299,98,49,19,465
903427_StarTrekPlanetClassifications.txt,1787,49,36,704,254,181,80,1219
9034521_DonaldWadeBaronWade.txt,1303,17,76,461,198,66,26,751
9035904_StMarysluton.txt,808,19,42,272,125,56,20,473
9036618_ListOfNicknamesForSportsClubsAndStadiums.txt,2285,31,73,1571,38,93,23,1725
903751_MegaManZero2.txt,1889,35,53,692,258,101,60,1111
903755_AdvanceWars2BlackHoleRising.txt,2207,31,71,787,297,167,83,1334
903772_ScandalsOfThe2004SummerOlympics.txt,2910,32,90,1012,526,210,108,1856
9040418_TolkienStudies.txt,751,9,83,443,9,28,0,480
9042075_ZhenyaKurashovaWine.txt,938,14,67,422,97,58,11,588
9043600_TheNewBelievers.txt,612,8,76,240,69,45,23,377
904443_ListOfHumancomputerInteractionTopics.txt,533,15,35,381,20,41,3,445
9044718_NewApproachToAppraisal.txt,777,21,37,364,93,36,16,509
904507_Altan.txt,641,14,45,268,67,50,15,400
9046961_ListOfNinjaGaidenCharacters.txt,1080,13,83,406,159,41,34,640
904771_SealOfThePresidentOfTheUnitedStates.txt,729,9,81,265,98,41,33,437
904851_TaiwanesePeoplesParty.txt,769,7,109,262,101,76,34,473
9048657_Werv.txt,658,9,73,258,63,65,21,407
9050887_TheHardestLogicPuzzleEver.txt,659,16,41,195,99,40,33,367
90510_Ardche.txt,2847,30,94,1003,282,244,76,1605
9052330_Significs.txt,1685,29,58,550,214,141,90,995
9053117_RaginiShetty.txt,595,9,66,200,105,39,28,372
9053396_CisteDhubh.txt,627,6,104,234,73,39,25,371
90554_Suppletion.txt,653,13,50,185,93,104,25,407
9055668_Takkanah.txt,4556,62,73,1560,541,202,141,2444
9055736_TheZootCat.txt,1110,15,74,369,181,43,62,655
90558_CornLaws.txt,770,13,59,284,105,54,25,468
905598_CoastStarlight.txt,965,21,45,495,115,42,13,665
905600_EspGuitars.txt,1976,39,50,1052,181,105,40,1378
9056756_ListOfUnionCouncilsOfKarachi.txt,1280,25,51,643,18,52,5,718
9056786_Jakakaeta.txt,7221,17,424,3393,1067,446,277,5183
905838_AnambraState.txt,740,15,49,385,69,52,19,525
905851_CarlyPatterson.txt,1238,20,61,416,179,82,42,719
905858_FordLtd.txt,1662,28,59,582,211,153,54,1000
905861_MalvinaHoffman.txt,677,11,61,330,66,29,10,435
9058630_WorldEnergyResourcesAndConsumption.txt,2515,58,43,880,334,240,79,1533
9059641_TaliaBettcher.txt,2474,121,20,1550,66,92,9,1717
9060014_RobertStrassburg.txt,562,10,56,245,48,41,11,345
9061174_TheConstitarianParty.txt,1333,9,148,425,250,95,59,829
9061182_ArthurChadwick.txt,613,22,27,211,81,35,17,344
9061192_ManseibashiStation.txt,801,19,42,325,114,33,17,489
9062245_Tcriterion.txt,942,2,471,315,119,110,18,562
9062284_AnriSala.txt,887,117,7,577,29,27,1,634
906643_Bhadrachalam.txt,1846,22,83,687,273,71,52,1083
906648_NovgorodRepublic.txt,1588,23,69,565,216,119,40,940
906941_IvanHlinka.txt,1319,28,47,438,174,81,56,749
907007_Litter.txt,952,20,47,312,180,76,48,616
907017_ListOfGeLocomotives.txt,822,35,23,406,78,57,13,554
9070994_HeidelbergCenterForAmericanStudies.txt,629,21,29,261,49,67,10,387
907108_AlfvnWave.txt,843,7,120,425,45,69,2,541
907729_PlacentaPraevia.txt,851,17,50,274,128,72,28,502
9077506_LoveIsTheOnlyMasterIllServe.txt,588,14,42,252,67,40,21,380
9077519_BangerRally.txt,561,21,26,197,76,51,27,351
9079402_GreenCrag.txt,676,9,75,279,85,37,17,418
9079809_WhereInTheFuckIsRandysBarbeque.txt,811,10,81,250,137,39,27,453
9080874_CymbalManufacturers.txt,1637,44,37,565,235,175,99,1074
9080897_JefferyWMckelroy.txt,0,0,0,0,0,0,0,0
908118_AntonovAn12.txt,562,15,37,222,62,49,13,346
908119_TheConnells.txt,2813,36,78,1128,327,239,92,1786
908121_HighHolyDays.txt,733,17,43,295,90,49,22,456
9083075_LincolnTheatrewashingtonDc.txt,742,10,74,303,112,39,9,463
9083753_ListOfAsteroids147101147200.txt,1316,1,1316,315,0,0,0,315
9084168_ListOfHaruhiSuzumiyaAlbums.txt,634,32,19,315,59,38,5,417
9085369_Ranger29.txt,564,10,56,162,93,48,22,325
9085376_NikolaKavaja.txt,657,10,65,241,110,24,23,398
9087501_Geruder.txt,600,6,100,217,89,50,24,380
9088115_ChatinSarachi.txt,1030,20,51,319,140,80,41,580
908823_LouisWu.txt,734,10,73,264,110,42,30,446
908826_BroadwayLimited.txt,597,10,59,318,48,32,8,406
9090747_Gossage.txt,1378,20,68,509,197,96,36,838
909210_SwimmingAtThe2004SummerOlympicsMens200MetreBackstroke.txt,669,18,37,429,20,11,2,462
909270_Agencymormonism.txt,1663,23,72,530,270,111,57,968
9096905_OtherPracticesOfFgc.txt,643,8,80,229,95,39,28,391
910261_1965InComics.txt,1198,15,79,684,12,19,1,716
9103517_CommitteeOf300.txt,672,9,74,248,89,47,20,404
9105054_UermmmcCollegeOfMedicine.txt,602,12,50,254,68,54,10,386
9106049_The200GreatestSongsOfThe1960s.txt,1440,3,480,856,36,29,20,941
9106701_MountainPineRidgeForestReserve.txt,767,13,59,289,101,54,16,460
9107170_SaudiArabianDiplomaticMissions.txt,440,11,40,360,12,12,6,390
911127_CitizensElectoralCouncil.txt,1252,18,69,519,123,103,22,767
911131_RacialIntegration.txt,988,14,70,357,109,91,49,606
9111614_KamakuragiJoe.txt,694,19,36,252,118,46,21,437
911356_LennyMclean.txt,781,13,60,264,119,41,31,455
911378_GiantsCitizenKabuto.txt,1409,16,88,482,204,114,62,862
911385_EgyptAtThe2004SummerOlympics.txt,670,46,14,369,33,26,3,431
911396_Forcefeeding.txt,1156,14,82,337,190,110,45,682
9116611_FreshfordIreland.txt,795,17,46,281,123,38,20,462
9119240_UnitedStatesBillOfRights.txt,4683,71,65,1608,632,278,136,2654
9119290_UnitedStatesCoastGuardEnlistedRateInsignia.txt,710,10,71,297,92,40,15,444
912096_JohnArchibaldCampbell.txt,555,11,50,220,86,16,6,328
9121033_DonnieDavies.txt,672,11,61,256,86,58,26,426
912174_TonyMeola.txt,969,15,64,368,119,40,26,553
9122129_OlgaPavlova.txt,595,44,13,367,18,39,0,424
912242_ToyotaSoarer.txt,1287,21,61,483,122,110,36,751
9123600_KillOrCaptureStrategy.txt,673,15,44,256,103,49,18,426
912444_SkyboxvideoGames.txt,739,11,67,209,104,68,49,430
912454_PhilipMurray.txt,2719,43,63,1163,336,139,62,1700
912465_GapCreationism.txt,1820,30,60,627,241,116,79,1063
9130108_PiraeusLion.txt,597,12,49,199,71,41,15,326
9130215_ListOfViscountciesInPortugal.txt,2646,3,882,1874,70,14,1,1959
913264_AthleticsAtThe2004SummerOlympicsMens200Metres.txt,884,20,44,597,32,21,5,655
913541_ListOfZipCodesInMissouri.txt,3563,22,161,1754,51,27,156,1988
913556_PuertoRicoAtThe2004SummerOlympics.txt,579,42,13,324,29,18,13,384
9135633_DonaldGBloesch.txt,902,10,90,393,60,60,13,526
913570_IRobotarcadeGame.txt,629,16,39,231,88,49,16,384
913572_BaltimorePolytechnicInstitute.txt,714,10,71,333,64,55,15,467
913589_TheSubterraneans.txt,616,9,68,246,74,51,22,393
9142174_ListOfYearsInTheKingdomOfEngland.txt,1631,4,407,15,2,0,1,18
9142203_TurkishCypriotFolkDances.txt,815,10,81,294,129,47,39,509
9142213_MaradenPanggabean.txt,966,20,48,386,128,54,20,588
914413_FootballInRussia.txt,849,10,84,393,81,69,28,571
9144443_ReadingLikeAWriter.txt,784,16,49,268,133,43,29,473
914640_SmoothleavedElm.txt,696,8,87,389,63,45,26,523
914662_NissanAlmera.txt,1309,31,42,498,172,124,49,843
914687_SwimmingAtThe2004SummerOlympicsWomens50MetreFreestyle.txt,933,10,93,652,4,10,4,670
9153842_CelluloseInsulation.txt,642,12,53,254,84,42,21,401
915502_BreakfastTelevision.txt,1266,30,42,592,119,107,30,848
915818_GrardSouzay.txt,1147,18,63,367,142,104,36,649
915830_UsherSyndrome.txt,1104,16,69,404,160,85,39,688
91587_FortBendCountyTexas.txt,617,19,32,282,54,21,3,360
91591_Linear.txt,1165,30,38,397,144,119,46,706
91598_ElPasoCountyTexas.txt,561,15,37,216,55,20,5,296
91605_DimmitCountyTexas.txt,569,11,51,217,62,25,5,309
91607_DentonCountyTexas.txt,700,15,46,299,74,40,6,419
91609_Sark.txt,1401,32,43,497,198,85,48,828
9161165_MilpitasChristianSchool.txt,831,16,51,400,101,52,22,575
9161542_WarrenChisum.txt,906,21,43,355,107,67,34,563
9162651_ValerieTryon.txt,586,17,34,318,38,27,8,391
91627_CollinCountyTexas.txt,642,15,42,274,59,29,3,365
91639_CameronCountyTexas.txt,599,16,37,269,53,29,3,354
91648_BrewsterCountyTexas.txt,559,13,43,220,56,26,5,307
916883_Sevendust.txt,1630,23,70,645,238,115,58,1056
916896_CollegeOfStHildAndStBede.txt,608,9,67,260,73,45,13,391
916906_SwedenAtThe2004SummerOlympics.txt,904,43,21,603,35,43,11,692
9169936_NutanaSuburbanCentreSaskatoonSaskatchewan.txt,727,22,33,372,75,53,10,510
9170403_ListOfFictionalMagazines.txt,834,9,92,492,28,53,6,579
9176508_OsuCastle.txt,968,11,88,329,153,68,32,582
9177644_BenNeedham.txt,850,15,56,275,161,38,24,498
917974_DragonBallfranchise.txt,3400,56,60,1388,377,226,135,2126
9179825_AustralianCoalitionAgainstDeathPenalty.txt,3350,71,47,1137,496,263,137,2033
917982_SocraticProblem.txt,576,5,115,202,73,39,29,343
917985_BohemianForest.txt,809,11,73,318,83,85,30,516
918711_PortugueseCuisine.txt,2222,18,123,741,355,225,129,1450
919082_DuaneReade.txt,742,11,67,274,97,62,25,458
91976_BucksCountyPennsylvania.txt,2583,56,46,1225,302,173,62,1762
91979_WestlandWhirlwindfighter.txt,1625,26,62,542,218,148,82,990
9199422_RohoncCodexTmp.txt,1795,30,59,710,181,155,67,1113
9199877_EveryoneWorthKnowing.txt,1212,17,71,422,154,108,74,758
920075_SoiCowboy.txt,651,18,36,269,78,38,26,411
9201635_LincolnDFaurer.txt,661,11,60,355,54,18,7,434
920174_ListOfPassengersOnTheMayflower.txt,916,15,61,573,57,30,21,681
920197_ThomasMannGymnasium.txt,1398,37,37,518,151,138,65,872
92022_DouglasCountyOregon.txt,713,13,54,283,74,36,10,403
92023_Interstate44.txt,718,15,47,296,85,31,23,435
9202710_FunnyFarmwebcomic.txt,5374,47,114,1733,930,290,268,3221
92029_CurryCountyOregon.txt,676,13,52,240,82,31,14,367
92030_CrookCountyOregon.txt,720,13,55,259,88,43,3,393
92031_Interstate49.txt,600,15,40,223,77,41,23,364
92032_CoosCountyOregon.txt,894,18,49,334,113,41,10,498
92033_ColumbiaCountyOregon.txt,563,12,46,198,61,35,6,300
92034_ClatsopCountyOregon.txt,801,14,57,320,85,41,9,455
92035_ClackamasCountyOregon.txt,1033,25,41,401,117,62,16,596
9203888_JohnPerlman.txt,737,13,56,297,102,35,22,456
9210405_MasaruKonuma.txt,730,5,146,301,76,36,20,433
9211974_JaKonrath.txt,774,15,51,441,68,40,6,555
921278_LenderOfLastResort.txt,644,15,42,201,93,65,31,390
9213738_TheGodfathersandbox.txt,3304,36,91,1340,473,185,116,2114
9214042_ColoradoCounties.txt,602,7,86,243,67,35,14,359
9215894_PaulRaphaelMontford.txt,590,8,73,228,69,33,11,341
9220257_CupidsRevenge.txt,737,10,73,307,73,49,13,442
922368_QuarkgluonPlasma.txt,1248,22,56,454,187,110,47,798
922371_Burping.txt,719,14,51,223,120,53,38,434
922430_AkiraKamiya.txt,1555,27,57,1097,87,45,15,1244
922431_ImplosiveConsonant.txt,608,15,40,177,92,88,38,395
9224615_CsivaramaMurti.txt,1182,10,118,566,118,59,25,768
9225079_TheMillstonenovel.txt,765,7,109,192,120,61,43,416
9226193_DieulacresAbbey.txt,600,15,40,175,98,34,22,329
9226952_EvanSiegel.txt,775,44,17,498,21,20,1,540
9227261_HenrySimms.txt,1262,15,84,326,251,44,46,667
923028_DeclarationOfRightsOfPeoplesOfRussia.txt,625,16,39,221,85,48,24,378
923091_Enna.txt,1091,14,77,416,130,98,32,676
923102_FalconbridgeLtd.txt,1460,31,47,620,172,109,27,928
923342_LiberalDemocratFrontbenchTeam.txt,1025,18,56,613,57,30,22,722
923414_JohnnyChanpokerPlayer.txt,750,16,46,303,94,43,21,461
923416_ListOfSpacewalksAndMoonwalks.txt,8964,8,1120,3343,94,54,26,3517
924131_CaliforniaStateRoute125.txt,606,11,55,227,73,33,25,358
924204_ArthurH.txt,603,15,40,248,62,53,12,375
9243389_OldChiefVUnitedStates.txt,1239,9,137,365,203,88,55,711
925290_WorldRevolution.txt,674,8,84,215,72,61,52,400
9253173_CharlesStevens.txt,918,12,76,353,126,41,43,563
9254255_EffectsOfHurricaneIsabelInCanada.txt,790,13,60,300,92,67,23,482
925710_Borsod.txt,1230,24,51,446,135,120,31,732
9257454_TrevorShort.txt,1761,20,88,540,293,127,81,1041
9258647_ChapusWu.txt,834,11,75,273,132,52,40,497
9260780_AerospaceDefenseCommandFighterSquadrons.txt,1706,105,16,1124,26,224,13,1387
926378_GravisUltrasound.txt,3115,49,63,1257,435,225,112,2029
926381_MichiganStadium.txt,844,14,60,340,123,51,25,539
926689_BobbyDodd.txt,737,14,52,283,102,26,16,427
9267333_LearnToTalkTheCountryOfBlinds.txt,690,7,98,365,46,37,8,456
92679_SouthYorkshire.txt,633,21,30,321,60,34,6,421
92684_AnatomyOfAMurder.txt,675,13,51,316,77,30,19,442
9268513_BillieDavis.txt,589,10,58,206,81,39,20,346
92688_RoomAtTheTopfilm.txt,778,17,45,396,76,35,14,521
92689_NausicaOfTheValleyOfTheWind.txt,1384,28,49,552,177,109,43,881
92691_CiudadJurez.txt,727,12,60,317,71,57,18,463
92693_CommonCold.txt,4313,59,73,1438,599,463,193,2693
92699_SonsAndLovers.txt,1103,27,40,411,138,59,38,646
9270121_NeedForSpeedSeriesCharacters.txt,656,30,21,263,79,28,13,383
9271609_VasilashkiLakes.txt,646,3,215,212,79,44,24,359
92728_LewesDelaware.txt,609,17,35,205,77,36,17,335
92729_MatchPlay.txt,755,8,94,242,116,54,31,443
92733_AlbertAbrahamMichelson.txt,1420,23,61,536,154,82,32,804
927403_LloydMBucher.txt,1086,14,77,389,181,51,37,658
9275574_NationalBuildingTradesCouncil.txt,1079,14,77,426,126,108,44,704
927830_GoMotion.txt,587,6,97,188,110,37,30,365
927845_BoavistaFc.txt,1117,41,27,516,121,70,31,738
9284334_CheatingDeathStealingLifeTheEddieGuerreroStorydvd.txt,569,33,17,328,40,15,5,388
9284335_LiveSoundMixing.txt,1066,12,88,343,149,91,49,632
9285428_SikhKhalsaArmy.txt,569,20,28,231,57,68,19,375
9286431_TrackRacing.txt,833,26,32,296,118,64,29,507
9286814_PaddybaltyAhern.txt,652,12,54,220,92,74,27,413
9286847_McneillsRangers.txt,607,8,75,246,72,37,14,369
9287597_YahyaKemalBeyatl.txt,1253,9,139,448,134,93,23,698
928959_AdrianaLima.txt,975,17,57,395,128,53,28,604
928966_KurtStudent.txt,577,12,48,212,72,33,13,330
9290182_ArthurMelbournecooper.txt,2790,30,93,1190,292,157,57,1696
9294158_CarlEckart.txt,1582,30,52,693,132,87,23,935
929522_AlessandraAmbrosio.txt,599,10,59,262,78,46,21,407
929526_CharlevoixelectoralDistrict.txt,721,155,4,214,28,43,4,289
9295559_CliffordLindseyAlderman.txt,664,34,19,281,50,33,16,380
929598_TheCourierjournal.txt,671,16,41,261,92,38,13,404
929640_JosieMaran.txt,962,26,37,370,123,62,35,590
929661_EugenBarbu.txt,1165,16,72,481,133,86,34,734
930043_DanielleDax.txt,621,13,47,267,73,46,14,400
9300737_RashtrakutaLiterature.txt,842,12,70,373,106,64,17,560
930091_Periglacial.txt,595,12,49,211,90,74,25,400
930109_FloatingProductionStorageAndOffloading.txt,731,9,81,372,81,26,13,492
930115_ColombiaAtThe2004SummerOlympics.txt,649,46,14,369,46,25,12,452
930136_JournalismSourcing.txt,2607,56,46,833,466,174,124,1597
9303304_Karmasong.txt,616,16,38,147,140,20,44,351
9308451_GeophysicalTomographyGroupthe.txt,1593,57,27,880,89,119,17,1105
931184_MinorRavenclaws.txt,2563,58,44,959,403,112,113,1587
9312053_ElmaDeVries.txt,976,4,244,379,35,61,7,482
931205_StarOcean.txt,820,14,58,326,121,63,37,547
931214_ShaakTi.txt,1254,15,83,466,202,53,22,743
931216_MyChemicalRomance.txt,2543,47,54,1033,346,137,84,1600
93126_DarkeCountyOhio.txt,568,16,35,240,54,28,5,327
93127_NavajoMythology.txt,1734,18,96,594,236,127,56,1013
93128_CuyahogaCountyOhio.txt,560,14,40,210,66,29,10,315
93141_AshtabulaCountyOhio.txt,718,14,51,319,68,38,10,435
9314235_Glonn.txt,957,24,39,349,112,94,34,589
9316047_InternationalTourneOfAnimation.txt,639,9,71,228,82,41,12,363
9317467_HoncharenkoBrothers.txt,641,21,30,262,83,41,20,406
932271_GusJohnsonbasketball.txt,912,9,101,358,107,66,14,545
932278_WoodLanecentralLineTubeStation.txt,765,22,34,306,111,34,15,466
932297_TheRoadToElDorado.txt,1927,20,96,596,323,109,53,1081
9324111_EdwardHartwick.txt,668,11,60,289,84,28,19,420
9325864_Imagination.txt,712,11,64,226,92,74,39,431
9329157_HistoryOfNigeriaBefore1500.txt,1442,14,103,501,195,136,36,868
932931_MinorGryffindors.txt,1658,43,38,617,259,92,65,1033
932933_CanadianLaborParty.txt,819,14,58,264,114,84,23,485
932935_FalseAdvertising.txt,922,14,65,283,157,78,64,582
933294_WickedWitchOfTheWest.txt,908,12,75,338,124,48,21,531
933377_HistoryOfIraqiInsurgency.txt,6350,72,88,2221,982,446,227,3876
933386_FranoisvincentToussaint.txt,583,13,44,216,76,40,16,348
933389_JoachimOfFiore.txt,1186,21,56,422,146,55,37,660
9334623_Interstate95InBaltimoreMaryland.txt,1702,22,77,629,211,109,46,995
9335142_SanFranciscoGayMensChorus.txt,1307,11,118,656,127,87,23,893
934496_TerryButcher.txt,920,15,61,314,123,61,29,527
9347120_DontGoNearTheWaterbook.txt,1141,19,60,458,160,60,31,709
9347673_VedetteSs.txt,607,11,55,244,82,40,16,382
9348197_LuciousSelmon.txt,659,22,29,269,65,45,3,382
9348826_WilliambillyDixon.txt,621,20,31,224,84,21,19,348
9350400_WindPowerInSpain.txt,2538,30,84,1086,279,199,50,1614
9354354_ListOfSongsByKreator.txt,596,22,27,450,3,3,1,457
935466_FatFreddysCat.txt,564,11,51,234,55,29,12,330
935567_RobsonGreen.txt,681,15,45,270,79,48,16,413
935582_LoysetCompre.txt,1622,35,46,763,130,144,36,1073
9359261_SoManyDynamos.txt,1458,31,47,796,129,75,20,1020
9359819_FifeHighSchool.txt,752,14,53,398,75,47,22,542
9361335_CarlzeissgymnasiumJena.txt,1275,17,75,385,189,128,77,779
936205_GillianMckeith.txt,2365,33,71,818,382,143,89,1432
936572_TerrorismInCanada.txt,675,10,67,301,81,32,8,422
936666_Abc1.txt,1087,21,51,485,111,56,34,686
9367992_ArgynnisHyperbius.txt,1225,13,94,453,79,182,44,758
9368506_Title20OfTheUnitedStatesCode.txt,490,3,163,435,1,3,0,439
9369047_CultureOfMinnesota.txt,1020,17,60,465,111,72,19,667
9371234_LaborFederationCompetitionInTheUs.txt,1404,23,61,547,189,79,35,850
9372330_VilniusConference.txt,638,15,42,237,87,38,16,378
937304_BowlingForSoup.txt,1147,14,81,509,108,65,35,717
9374043_PaulMaddrell.txt,562,18,31,304,24,16,5,349
93760_Showgirls.txt,1839,24,76,649,283,127,86,1145
937643_DickGaughan.txt,1086,15,72,383,129,73,35,620
937648_Santoor.txt,695,14,49,236,110,59,26,431
93764_Quetta.txt,1523,30,50,621,190,113,44,968
937652_MurrueRamius.txt,1011,14,72,416,124,48,30,618
93765_VirginAtlanticAirways.txt,3937,62,63,1651,481,282,106,2520
93767_VirginRecords.txt,840,12,70,406,92,49,20,567
93768_GovernmentBond.txt,615,19,32,299,69,50,18,436
93769_Pkzip.txt,761,13,58,275,125,59,26,485
9377383_CatamountSkiArea.txt,1486,39,38,542,178,124,61,905
937744_KingdomOfLoathing.txt,3915,60,65,1414,543,348,124,2429
937745_LiberalismInSouthKorea.txt,628,8,78,290,69,46,11,416
937753_WordAttachments.txt,960,15,64,325,138,78,48,589
937756_UnitedStatesNavyFighterWeaponsSchool.txt,998,14,71,467,109,65,20,661
937766_Gliese570.txt,597,11,54,215,61,49,16,341
9378842_SnydermanAndRothmanstudy.txt,1462,16,91,494,209,137,72,912
93801_RoseannetvSeries.txt,6540,64,102,2233,978,439,310,3960
93807_Sdram.txt,660,12,55,234,116,48,33,431
9381027_GraingerTown.txt,926,21,44,350,124,65,20,559
93810_BroadGauge.txt,1396,23,60,494,189,141,50,874
93813_CsarVallejo.txt,1315,32,41,538,144,91,30,803
93815_AthanasiusKircher.txt,2869,31,92,1110,364,189,75,1738
93821_ChineseConstellation.txt,597,19,31,227,67,46,26,366
938396_BattleOfLangVei.txt,835,14,59,337,118,46,21,522
938406_PharoaheMonch.txt,637,14,45,269,83,50,19,421
938465_NicolaeMalaxa.txt,743,13,57,325,83,37,17,462
938757_CruisnUsa.txt,1001,19,52,346,136,56,41,579
938807_SteveBull.txt,905,17,53,314,109,58,23,504
938832_ResidentEvil2.txt,2093,27,77,773,284,176,65,1298
938833_MultiagentSystem.txt,4141,44,94,1513,592,421,152,2678
9388743_ArtisticPerspectiveEntertainment.txt,792,15,52,391,86,57,23,557
9389829_DeathOfAMonk.txt,672,16,42,219,91,47,20,377
9390437_MinuteWomenOfTheUsa.txt,878,10,87,311,130,71,30,542
9390506_NortheastFreeway.txt,635,11,57,256,81,25,17,379
9392020_TsubasaReservoirChronicleCharacters.txt,1989,17,117,654,328,101,82,1165
939491_IvanAralica.txt,579,5,115,213,62,71,16,362
9395483_MauriceDavisrabbi.txt,663,15,44,275,92,22,14,403
9395552_BenJonsonFolios.txt,777,16,48,379,65,43,11,498
9397685_TacnazoInsurrection.txt,871,11,79,335,110,63,14,522
939909_SonyPicturesEntertainment.txt,1266,8,158,743,90,62,17,912
940525_JeffTweedy.txt,2848,32,89,1139,452,157,72,1820
940583_EdwardFrankland.txt,888,9,98,261,110,79,26,476
941079_SwordAndSorceressSeries.txt,1903,19,100,1330,61,64,11,1466
94153_Knightsbridge.txt,828,13,63,336,106,81,25,548
94157_Leyton.txt,826,23,35,371,110,49,24,554
94217_Ak74.txt,1493,21,71,501,217,121,71,910
94218_Peckham.txt,1948,30,64,840,232,146,37,1255
94222_Penge.txt,1666,18,92,731,192,78,47,1048
94223_MuzzleBrake.txt,901,8,112,285,145,79,59,568
943202_ThamesNewZealand.txt,627,10,62,249,84,33,22,388
943281_AlbertJacka.txt,1325,29,45,474,202,79,23,778
943809_CroatiaAtThe2004SummerOlympics.txt,1284,78,16,719,45,73,28,865
944247_UssHopewelldd681.txt,1268,19,66,525,161,54,19,759
944836_ListOfBroadcastStationClasses.txt,1283,19,67,523,125,81,51,780
944837_VitalyScherbo.txt,822,10,82,268,118,65,40,491
9450_ElectricalTelegraph.txt,2182,27,80,777,272,194,59,1302
945347_WinnipegNorth.txt,423,20,21,237,26,45,8,316
945362_TrothorseGait.txt,3679,56,65,972,592,274,225,2063
945386_ListOfBritishArmyRegiments1881.txt,1355,8,169,946,9,87,0,1042
945923_AmericanNationalMensHockeyTeam.txt,939,17,55,392,40,132,9,573
9459_Enniskillen.txt,732,21,34,355,73,32,26,486
946060_CaveDwellers.txt,943,16,58,319,161,58,32,570
946425_SadeghHedayat.txt,952,19,50,488,74,68,17,647
946426_AmplitudeshiftKeying.txt,1067,46,23,338,184,73,27,622
946449_ScarboroughFc.txt,1371,40,34,583,139,71,32,825
946460_Pulicat.txt,650,15,43,221,100,39,32,392
946468_DiscoveryOne.txt,1964,32,61,889,237,136,42,1304
946500_TheBlindOwl.txt,1061,19,55,304,149,81,45,579
946504_SibeliusAcademy.txt,648,7,92,292,60,64,20,436
946521_WoodvilleRailwayStationAdelaide.txt,958,23,41,388,123,46,24,581
946522_Nityananda.txt,689,12,57,280,89,43,19,431
9467_LongestWordInEnglish.txt,2080,36,57,726,295,209,96,1326
9468_EnglishWordsWithUncommonProperties.txt,5002,112,44,1832,638,578,207,3255
9469_EricSRaymond.txt,1322,25,52,519,174,95,40,828
947088_Michaelhouse.txt,1154,31,37,529,114,66,17,726
947146_NationalbolshevikParty.txt,1084,15,72,389,149,89,30,657
9472_Euro.txt,5575,86,64,1902,718,508,203,3331
9474_EuropeanCentralBank.txt,1449,40,36,567,172,146,26,911
947521_vitrigaila.txt,979,17,57,362,92,36,13,503
9475_ElectronShell.txt,594,12,49,203,80,50,15,348
947602_WisokaDbica.txt,2118,72,29,851,235,167,89,1342
947625_Schiebefehl.txt,642,11,58,222,121,50,32,425
947626_AboriginalPeoplesInQuebec.txt,714,43,16,385,45,33,16,479
947631_EnzaiFalselyAccused.txt,3685,86,42,1101,640,269,198,2208
9476_Electron.txt,1954,33,59,626,296,178,64,1164
9477_Europium.txt,641,15,42,226,96,59,32,413
9478_Erbium.txt,804,12,67,264,120,93,33,510
9480_EdmundStoiber.txt,1180,20,59,402,140,86,42,670
948177_TimelineOfTrendsInMusicFromTheUnitedStatesTo1930.txt,1234,45,27,595,123,117,20,855
9481_Erfurt.txt,715,21,34,289,77,48,17,431
948247_PipeCreekSinkhole.txt,665,21,31,359,49,43,19,470
9482_Enya.txt,2379,33,72,890,322,162,72,1446
94857_FnFal.txt,5597,48,116,2160,738,477,186,3561
948685_Tres1.txt,595,15,39,210,84,60,18,372
948726_MaleOralContraceptive.txt,1098,10,109,447,127,136,29,739
9487_Epsilon.txt,627,9,69,266,68,38,21,393
94882_Brolga.txt,915,14,65,299,129,90,53,571
94889_WasecaCountyMinnesota.txt,579,11,52,256,50,23,5,334
94903_SibleyCountyMinnesota.txt,586,10,58,262,55,26,3,346
94906_ScottCountyMinnesota.txt,765,11,69,373,65,37,5,480
94907_StLouisCountyMinnesota.txt,621,12,51,241,69,31,9,350
94908_LugerPistol.txt,1381,24,57,523,182,112,49,866
94910_RoseauCountyMinnesota.txt,1099,20,54,373,153,53,16,595
94912_RiceCountyMinnesota.txt,695,14,49,318,57,35,7,417
94944_MartinCountyMinnesota.txt,768,10,76,396,60,30,6,492
94957_LeSueurCountyMinnesota.txt,858,10,85,430,67,36,9,542
94966_JacksonCountyMinnesota.txt,639,9,71,282,56,31,9,378
949780_HorusHeresy.txt,6451,67,96,2268,1006,333,253,3860
949813_Singlish.txt,7106,218,32,2037,1140,700,503,4380
9499_Ethernet.txt,4972,61,81,1703,756,457,206,3122
950354_CaraDillon.txt,1821,23,79,779,219,110,38,1146
950881_RingTransporter.txt,1169,19,61,359,202,68,48,677
950883_JapaneseIdol.txt,1216,12,101,366,191,123,83,763
951965_KenningtonPark.txt,3215,28,114,1323,413,189,67,1992
951969_BaltimoreRiotOf1861.txt,793,8,99,300,117,39,19,475
951978_AustraliaNationalRugbyLeagueTeam.txt,2044,45,45,871,227,112,48,1258
95236_Presidentgame.txt,5345,79,67,1500,835,416,232,2983
952677_Backlight.txt,650,8,81,207,104,73,36,420
952974_SteveSax.txt,699,20,34,254,100,49,24,427
953092_TourismInMexico.txt,1644,22,74,727,144,178,40,1089
954222_IsabeauOfBavaria.txt,1012,18,56,427,110,75,19,631
954793_EmperorsChildren.txt,2109,32,65,754,296,146,68,1264
955166_Lemora.txt,744,15,49,266,104,54,34,458
955309_1939InComics.txt,878,16,54,578,5,20,5,608
955959_Knex.txt,1858,38,48,698,259,208,46,1211
955969_Moloko.txt,754,19,39,325,83,47,21,476
956310_Encorealbum.txt,1025,21,48,426,127,59,38,650
956317_IsleOfWightRadio.txt,619,6,103,254,72,32,15,373
956326_BoagsBrewery.txt,866,23,37,380,117,36,21,554
956418_ConstantPermeke.txt,658,9,73,215,102,29,20,366
956982_SpaceWarfare.txt,1076,18,59,397,131,118,53,699
957421_Badui.txt,931,13,71,329,131,77,42,579
957422_Keep.txt,834,11,75,257,100,94,43,494
958085_97thUnitedStatesCongress.txt,2812,59,47,2179,5,6,4,2194
958151_RmsLaconia1921.txt,829,16,51,271,136,49,25,481
958508_ScienceNorth.txt,777,23,33,345,68,64,19,496
958525_LegendarySaga.txt,731,9,81,282,80,82,24,468
959237_TomKellybaseball.txt,574,9,63,201,62,39,28,330
96007_DubuqueCountyIowa.txt,1541,43,35,679,163,98,42,982
96009_EmotionalIntelligence.txt,2666,35,76,1208,280,205,62,1755
960265_ShanLanguage.txt,727,14,51,266,91,51,32,440
960403_TaxExemption.txt,842,16,52,303,111,62,24,500
96044_WilliamSmith.txt,718,9,79,439,6,31,4,480
96049_Proofalcohol.txt,867,15,57,241,138,55,46,480
960664_ArgentineTango.txt,2785,53,52,975,415,206,140,1736
960702_AlekhinesDefence.txt,834,16,52,299,102,65,35,501
960705_MarpleGreaterManchester.txt,662,20,33,319,59,34,15,427
960782_CarokannDefence.txt,1106,28,39,371,125,98,45,639
960787_C86music.txt,1875,29,64,827,220,108,59,1214
961428_AthabascaUniversityStudentsUnion.txt,671,20,33,289,73,42,16,420
961429_Shikijitsu.txt,724,16,45,244,113,57,36,450
961805_AlgebraOfSets.txt,1126,51,22,404,120,94,31,649
962858_RaciDiagram.txt,580,22,26,194,80,37,24,335
962894_PovaskBystrica.txt,608,11,55,223,73,57,26,379
962925_BlueAndGreenLinescleveland.txt,1283,19,67,595,125,83,33,836
96396_Kahai.txt,790,10,79,282,105,40,25,452
964045_SolomonPOrtiz.txt,788,16,49,293,123,33,22,471
964053_AjdaPekkan.txt,1067,19,56,477,95,76,26,674
964057_TheFabulousMoolah.txt,911,22,41,372,120,52,29,573
964646_ListOfRobertAHeinleinCharacters.txt,1033,13,79,748,11,1,3,763
964650_MazdaFEngine.txt,962,34,28,381,102,65,24,572
964652_TorontoComputerLeasingInquiry.txt,1183,23,51,448,167,73,39,727
965027_LucyDawidowicz.txt,1555,15,103,649,174,78,31,932
965101_SheMovedThroughTheFair.txt,764,18,42,312,94,54,30,490
965131_HopeOfTheStates.txt,789,18,43,362,75,48,21,506
966193_JademortalKombat.txt,1489,22,67,550,233,84,59,926
966200_Jarek.txt,767,12,63,294,114,46,27,481
966202_FnFiveseven.txt,1054,20,52,369,146,123,56,694
966753_FactortameCase.txt,602,12,50,206,85,28,29,348
966755_BillAndTedsExcellentAdventures.txt,1011,7,144,830,39,26,2,897
966831_Kuvempu.txt,908,24,37,423,83,45,15,566
967282_MemorySorrowAndThorn.txt,909,20,45,356,84,92,31,563
967309_NeutralStripoklahoma.txt,661,19,34,259,78,25,22,384
968409_CraigParker.txt,521,52,10,275,31,42,9,357
969397_TheWrongWarAtTheWrongPlaceAtTheWrongTimeAndWithTheWrongEnemy.txt,979,11,89,336,126,77,32,571
969495_FordRanger.txt,1050,21,50,386,142,101,18,647
970595_BonfiresOfSaintJohn.txt,1594,34,46,626,184,101,48,959
970632_InigoMontoya.txt,976,7,139,308,167,60,37,572
970633_BlackJewelsTrilogy.txt,6708,60,111,2521,882,436,222,4061
970642_PortuguesePeople.txt,779,23,33,313,63,98,35,509
97078_Twistergame.txt,709,8,88,279,94,38,18,429
97079_Shango.txt,1722,16,107,660,243,102,37,1042
97080_Callimachus.txt,801,13,61,338,90,58,22,508
97086_Signalsalbum.txt,623,19,32,262,72,46,14,394
97092_Quintilian.txt,3554,41,86,1154,472,334,158,2118
97104_RobertConquest.txt,2505,25,100,930,304,179,63,1476
97112_PrimaryNutritionalGroups.txt,593,10,59,196,81,79,28,384
97115_HistoryOf.txt,924,34,27,295,115,70,16,496
971207_Ardrossan.txt,1089,19,57,442,134,62,33,671
97120_Sekhmet.txt,693,10,69,232,116,36,30,414
971582_BoRaiCho.txt,726,8,90,320,110,38,23,491
971654_Boffer.txt,870,19,45,261,153,70,46,530
971731_ScreenScraping.txt,1281,31,41,487,196,126,56,865
971736_IceCube.txt,591,14,42,191,117,52,39,399
972823_MarkosMoulitsasZniga.txt,1029,19,54,445,118,78,42,683
972830_ZackieAchmat.txt,900,12,75,341,114,54,19,528
973458_Domainkeys.txt,1408,29,48,500,232,115,67,914
973819_RoyalArmyChaplainsDepartment.txt,614,19,32,244,74,45,29,392
973851_Kenshi.txt,1195,13,91,444,191,63,41,739
974543_RescueMetvSeries.txt,2518,36,69,1028,308,132,59,1527
97471_GreeneCountyArkansas.txt,563,12,46,189,74,26,4,293
974899_PhilipVian.txt,698,16,43,275,87,46,12,420
974927_Magic1054Fm.txt,827,17,48,369,91,58,20,538
97550_BeckenhamukParliamentConstituency.txt,574,17,33,228,59,33,23,343
975635_DandelionWine.txt,6476,93,69,2068,975,378,293,3714
975640_Wanamakers.txt,1895,24,78,792,245,128,53,1218
976662_MarshallFields.txt,5928,74,80,2641,728,297,133,3799
976663_IndustrialAndMultiphasePowerPlugsAndSockets.txt,2024,40,50,602,287,235,108,1232
976796_FaustoPaoloSozzini.txt,2085,19,109,727,266,153,51,1197
976801_AutonomousAreasOfChina.txt,946,20,47,292,138,113,40,583
976802_PenguinPoetryAnthologies.txt,2547,27,94,1707,20,20,1,1748
977090_ExhibitionGame.txt,870,16,54,372,104,63,34,573
978170_BritishRailClass86.txt,3701,50,74,1093,630,352,137,2212
978203_FlagOfIndia.txt,4600,61,75,1477,654,303,141,2575
978925_JensOttoKrag.txt,642,9,71,194,86,46,31,357
978991_StampAct.txt,917,17,53,347,148,56,28,579
979287_Euromyth.txt,850,16,53,276,160,49,26,511
979298_NickTheGreek.txt,582,14,41,191,88,25,21,325
979343_HeyYa.txt,999,17,58,364,111,92,28,595
980439_ItHappenedHere.txt,1753,22,79,743,199,86,49,1077
980450_UnitedStatesCricketTeam.txt,1681,42,40,601,206,128,69,1004
981105_StateOfGracefilm.txt,856,24,35,370,96,62,29,557
981533_CharlesClifford.txt,839,7,119,349,99,36,14,498
981540_ShadowfinalFantasyVi.txt,1419,20,70,456,216,81,61,814
981551_DigitalAudioStationaryHead.txt,609,9,67,202,63,61,32,358
98192_ChildCustodyLawsInTheUnitedStates.txt,1316,22,59,464,170,119,43,796
98215_FloraBrovina.txt,707,7,101,254,89,42,20,405
98217_ShelSilverstein.txt,2232,35,63,776,334,113,122,1345
98221_UnitedStatesMarshalsService.txt,2961,38,77,1370,298,198,50,1916
982257_Challenge1930.txt,1681,26,64,683,167,149,42,1041
98229_FarocardGame.txt,1483,23,64,550,216,78,41,885
982626_Agentlaw.txt,866,6,144,261,150,55,30,496
982630_ManitobaGeneralElection1988.txt,1792,138,12,1124,104,52,31,1311
983356_ListOfPeopleFromBangalore.txt,787,16,49,573,19,44,8,644
984799_PaulJenningsukAuthor.txt,594,14,42,252,53,31,22,358
984805_AvenhamPark.txt,697,12,58,276,87,58,12,433
984822_PaulJenningsaustralianAuthor.txt,1646,40,41,854,128,79,24,1085
985418_VenetianGhetto.txt,979,18,54,406,118,59,37,620
98553_RedSkull.txt,3756,41,91,1315,578,246,137,2276
985802_DsgInternationalretailer.txt,4959,123,40,2008,592,399,116,3115
985921_TheGreekPassion.txt,1276,16,79,408,210,63,38,719
985924_UlsterRugby.txt,1101,26,42,557,86,65,31,739
98624_Sighioara.txt,626,15,41,265,64,43,8,380
98626_HamiltonSouthLanarkshire.txt,860,22,39,370,104,71,17,562
986441_Dynamism.txt,617,13,47,229,65,79,25,398
986893_TribalClassDestroyer1905.txt,622,7,88,246,87,25,21,379
986896_TribalClassDestroyer1936.txt,1439,23,62,612,189,78,26,905
9869_EpistleToTheEphesians.txt,1240,24,51,403,148,59,54,664
987013_MusicOfArubaAndTheNetherlandsAntilles.txt,879,20,43,323,128,78,40,569
987608_WestAntarcticIceSheet.txt,875,13,67,326,134,63,28,551
988048_CopShootCop.txt,963,15,64,401,126,70,39,636
988054_LennyKrayzelburg.txt,708,11,64,241,95,38,26,400
988055_BritishRailClass404.txt,765,14,54,268,115,48,14,445
988168_BritishRailClass156.txt,995,19,52,362,149,91,30,632
989981_GrandDukeCyrilVladimirovichOfRussia.txt,697,14,49,308,68,39,11,426
990534_Normmathematics.txt,1402,44,31,539,158,102,44,843
991057_ListOfFamousUsMarines.txt,1583,30,52,1222,45,53,6,1326
991059_CreditCardFraud.txt,1711,27,63,674,262,96,70,1102
991073_SteveWright.txt,886,17,52,359,100,50,30,539
991130_CrystalPower.txt,670,10,67,254,96,61,22,433
991143_FrankSinatraJr.txt,740,13,56,260,130,40,22,452
991235_DaytonGems.txt,740,13,56,305,79,44,10,438
991239_UnitedStatesPenitentiaryLeavenworth.txt,765,29,26,340,69,59,12,480
991242_SirJohnGell1stBaronet.txt,1225,17,72,447,172,66,23,708
991546_JohnRCommons.txt,745,13,57,367,62,56,12,497
992332_BobLarson.txt,1329,18,73,582,147,88,41,858
992338_Battingbaseball.txt,627,9,69,175,110,32,22,339
99293_ShapeOfTheUniverse.txt,1596,25,63,448,216,206,77,947
99302_StocktonCalifornia.txt,3578,58,61,1713,348,231,75,2367
99303_CongregationForTheDoctrineOfTheFaith.txt,757,15,50,311,75,45,20,451
99304_PearlHarborfilm.txt,3760,28,134,1419,518,238,146,2321
99305_MightyMouse.txt,1406,28,50,546,185,86,55,872
99308_EnglishHeritage.txt,585,13,45,258,68,49,11,386
99312_WorcesterMassachusetts.txt,4194,71,59,1705,471,308,126,2610
993304_ShtokavianDialect.txt,2836,41,69,939,366,365,139,1809
993313_KajkavianDialect.txt,1195,20,59,440,136,137,51,764
993331_ChakavianDialect.txt,905,23,39,319,103,141,40,603
9942_ErwinSchrdinger.txt,1601,26,61,604,182,114,45,945
994394_NissanQrEngine.txt,972,21,46,414,101,78,21,614
994407_JesusWept.txt,816,19,42,294,135,39,30,498
994411_ZidaneTribal.txt,1134,14,81,374,170,74,61,679
994417_TheChicagoTransitAuthorityalbum.txt,574,12,47,246,73,31,15,365
994438_Wiglaf.txt,833,20,41,289,120,41,31,481
994780_TheresaSokyrka.txt,697,17,41,351,75,43,15,484
995498_UkrainianCuisine.txt,1027,17,60,416,149,129,52,746
995520_EvilUnderTheSun.txt,1296,27,48,431,224,74,47,776
99647_VladimirKramnik.txt,2047,31,66,807,267,139,38,1251
996590_OntarioProgressiveConservativeLeadershipConventions.txt,791,83,9,430,47,25,12,514
996597_GianFrancescoPoggioBracciolini.txt,1402,19,73,503,160,96,35,794
996610_Manorhamilton.txt,787,8,98,272,107,77,32,488
996964_Pacifier.txt,937,22,42,303,153,79,30,565
996965_AmericanCenterForLawAndJustice.txt,882,17,51,376,116,52,14,558
99721_Wallonia.txt,790,18,43,283,93,80,29,485
99722_TheCallband.txt,706,29,24,281,90,42,20,433
997698_Jdeveloper.txt,575,20,28,282,56,42,9,389
997709_DemonDiary.txt,653,10,65,207,105,41,24,377
997711_DeltaStatetvSeries.txt,2449,18,136,866,384,140,58,1448
998763_AirSouthwest.txt,603,22,27,266,69,27,11,373
998777_ShroudOfTurin.txt,11611,122,95,3960,1668,762,394,6784
998780_SevenDaysBattles.txt,2883,22,131,1228,382,136,83,1829
998803_Graustark.txt,945,20,47,360,128,60,28,576
998823_PfcCskaSofia.txt,841,32,26,381,76,54,16,527
999843_TheNeutroniumAlchemist.txt,2426,27,89,849,374,129,77,1429
999957_OneTreeHilltvSeries.txt,7407,80,92,2717,1193,282,249,4441
